棒棰	棒槌
指摘	指責
接長補短	截長補短
舉行晏會	舉行宴會
音龠	音樂
自名得意	自鳴得意
煤汽機	煤氣機
成工	成功
計日成功	計日程功
喘噓噓	喘吁吁
鬥音	抖音
波浪鼓	撥浪鼓
裝聾做啞	裝聾作啞
憂心重重	憂心忡忡
老態龍腫	老態龍鍾
透澈	透徹
輕舉忘動	輕舉妄動
攙和	摻和
吃裏扒外	吃裏爬外
慘酷無情	殘酷無情
瘦骨伶丁	瘦骨伶仃
心浮氣燥	心浮氣躁
還而	孩兒
轉游	轉悠
粘糊	黏糊
寧缺毋爛	寧缺毋濫
木犀	木樨
精神煥散	精神渙散
開誠不公	開誠佈公
規戒	規誡
是天兩夜	四天兩夜
案語	按語
飄眇	縹緲
風鏡	風景
獨書己見	獨抒己見
作爲探討	做爲探討
溼淥淥	溼漉漉
日本蔡	日本菜
轟笑	鬨笑
一視同人	一視同仁
座公車	坐公車
蓄意抱復	蓄意報復
障愛文	張愛文
詞反	吃飯
委過	諉過
扒犁	爬犁
連篇累櫝	連篇累牘
禁若寒蟬	噤若寒蟬
長噓短嘆	長吁短嘆
過的很開心	過得很開心
素昧平身	素昧平生
妳們	你們
鬼斧神功	鬼斧神工
推脫生病	推託生病
一麟半爪	一鱗半爪
化學成份	化學成分
大廷廣衆	大庭廣衆
工力悉抵	工力悉敵
死皮癩臉	死皮賴臉
陷井	陷阱
陳詞爛調	陳詞濫調
掉包	調包
癡心枉想	癡心妄想
掇句成文	綴句成文
震奮人心	振奮人心
澈底	徹底
夙敵	宿敵
枓栱	斗拱
壤大衆理解	讓大衆理解
依仗權勢	倚仗權勢
不既不離	不即不離
緒序漸進	循序漸進
精萃	精粹
辭彙	詞彙
錄相	錄像
俯首貼耳	俯首帖耳
菁華	精華
淺嘗則止	淺嘗輒止
兇相必露	兇相畢露
預會	與會
頑耍	玩耍
無忘之災	無妄之災
月明星希	月明星稀
歇事寧人	息事寧人
彼彼皆是	比比皆是
原氣大傷	元氣大傷
吭害好人	坑害好人
括不知恥	恬不知恥
篡改文件	竄改文件
月來越好	越來越好
大人常委會	人大常委會
學姣	學校
飛聲文壇	蜚聲文壇
非夷所思	匪夷所思
無會	舞會
關懷倍至	關懷備至
張惶失措	張皇失措
惴揣不安	惴惴不安
帶罪立功	戴罪立功
奇角之勢	掎角之勢
宏亮	洪亮
漸漸的增加	漸漸地增加
有所尊循	有所遵循
篷蓽增輝	蓬蓽增輝
弘圖	宏圖
剎時	霎時
班駁陸離	斑駁陸離
交馬上停車	叫馬上停車
無譏之談	無稽之談
纏綿悱測	纏綿悱惻
翻覆無常	反覆無常,翻覆無常
老陳持重	老成持重
莫些年	某些年
挑肥撿瘦	挑肥揀瘦
長遠的看	長遠地看
睡過偷	睡過頭
大才小用	大材小用
張慌失措	張皇失措
自曝自棄	自暴自棄
土地貧脊	土地貧瘠
戮穿陰謀	戳穿陰謀
師什麼公車	是什麼公車
沿木求魚	緣木求魚
發掌	發展
淌水過河	趟水過河
可使	可是
飛揚拔扈	飛揚跋扈
糟踏	糟蹋
申酉戍亥	申酉戌亥
鬢腳	鬢角
風雨如誨	風雨如晦
至理明言	至理名言
深醒	深省
名哲保身	明哲保身
表本兼治	標本兼治
大的家	他的家
樂和和	樂呵呵
相對得壞處	相對的壞處
西辦加話	西班牙話
太樣兵	太陽餅
古今雜揉	古今雜糅
危如磊卵	危如累卵
憑藉	憑藉
嚎啕	號啕
饒勇善戰	驍勇善戰
水籠頭	水龍頭
怙惡不俊	怙惡不悛
一獗不振	一蹶不振
畏崽不前	畏葸不前
夜消	夜宵
高興得	高興地
黃曆	皇曆
禍國秧民	禍國殃民
相矩不遠	相距不遠
續多	許多
演譯推理	演繹推理
垂手可得	唾手可得
餐訂	餐廳
異子	椅子
具造	製造
授與	授予
清沏見底	清澈見底
臺配種戰	臺北總站
撩亂	繚亂
有志競成	有志竟成
無人問斤	無人問津
列如	例如
流覽報紙	瀏覽報紙
走露	走漏
現進	先進
橫徵暴殮	橫徵暴斂
一起去把	一起去吧
專心至志	專心致志
表面的看	表面地看
出人投地	出人頭地
指高氣揚	趾高氣揚
刻期	剋期
瞑思苦想	冥思苦想
殺一警百	殺一儆百
流守	留守
怨天猶人	怨天尤人
根深底固	根深蒂固
踉蹡	踉蹌
作奸犯課	作奸犯科
萬冠家財	萬冠家貫
開天劈地	開天闢地
棉子	棉籽
戴我	載我
十錦	什錦
言前	眼前
好久沒間	好久沒見
仲栽委員	仲裁委員
影象	影像
看般球	看棒球
殺風景	煞風景
積毀消骨	積毀銷骨
以身作責	以身作則
一蹋糊塗	一塌糊塗
安兵不動	按兵不動
又漂亮的衣服	有漂亮的衣服
單讓	當然
味同嚼臘	味同嚼蠟
凝鍊	凝練
持續的	持續地
參預	參與
暴炸	爆炸
躊躕	躊躇
慘絕人環	慘絕人寰
座捷運	坐捷運
直上重宵	直上重霄
豈有此裏	豈有此理
怒朋友	女朋友
鬥趣兒	逗趣兒
名信片	明信片
觀察關	觀察官
右遍	右邊
縱橫俾闔	縱橫捭闔
恰如其份	恰如其分
高屋建領	高屋建瓴
做神馬	做什麼
喜出往外	喜出望外
逃戰	挑戰
自立更生	自力更生
錄的	綠的
流言非語	流言飛語,流言蜚語
規規矩距	規規矩矩
做秀	作秀
廳路上	聽路上
不明一文	不名一文
唱工	唱功
三十分鍾	三十分鐘
暫露頭角	嶄露頭角
渾沌	混沌
急風勁草	疾風勁草
矯糅造作	矯揉造作
腳鴨子	腳丫子
貯立	佇立
塗然	突然
啓用幹部	起用幹部
影影約約	隱隱約約
明查暗訪	明察暗訪
人蔘鹿葺	人蔘鹿茸
直抒胸意	直抒胸臆
智識	知識
恐前絕後	空前絕後
飄亮	漂亮
約來越晚	越來越晚
再機場	在機場
那末	那麼
喜上眉捎	喜上眉梢
路行	旅行
通貨膨漲	通貨膨脹
廖若晨星	寥若晨星
熱剌剌	熱辣辣
拋地有聲	擲地有聲
花田酒地	花天酒地
萬馬齊暗	萬馬齊喑
明信片	名信片
辨證法	辯證法
座火車	坐火車
心恢意冷	心灰意冷
走頭無路	走投無路
做回去	坐回去
爲虎作帳	爲虎作倀
氣喘噓噓	氣喘吁吁
相形見拙	相形見絀
或着市	或者是
不卑不抗	不卑不亢
風塵撲撲	風塵僕僕
坐想其成	坐享其成
開消	開銷
再服務業	在服務業
坐收魚利	坐收漁利
華爲泡影	化爲泡影
襤竽充數	濫竽充數
言不由中	言不由衷
骨董	古董
盤陁	盤陀
不好億思	不好意思
她門	她們
性格粗曠	性格粗獷
息緩	喜歡
稨豆	扁豆
事等我女朋友的	是等我女朋友的
對針下藥	對症下藥
圓藝	園藝
作天	昨天
卸儎	卸載
上敘	上述
合唱父系語法	和常複習語法
聲張正義	伸張正義
香純	香醇
姿意妄爲	恣意妄爲
敘文	序文
切搓琢磨	切搓磋磨
辨證理論	辯證理論
美邦法	沒辦法
覆轍	覆轍
戍戌政變	戊戌政變
堅難困苦	艱難困苦
斷章取意	斷章取義
矯柔造作	矯揉造作
漫條斯理	慢條斯理
公司排我	公司派我
吊虎離山	調虎離山
老倆口	老兩口
跌蕩	跌宕
挺而走險	鋌而走險
搭褳	褡褳
潮呼呼	潮乎乎
弱不經風	弱不禁風
放面	方面
耳根清靜	耳根清淨
耽心	擔心
堰旗息鼓	偃旗息鼓
爛縵	爛漫
狼頭	榔頭
爲富不忍	爲富不仁
如期峻工	如期竣工
湎懷先烈	緬懷先烈
痕累	很累
臺灣採	臺灣菜
毋用諱言	毋庸諱言
牽強副會	牽強附會
差遲	差池
鵠首窮經	皓首窮經
城惶誠恐	誠惶誠恐
努生	女生
士女畫	仕女畫
深爲婉惜	深爲惋惜
線然	顯然
厭厭欲睡	懨懨欲睡
糜費	靡費
摒氣凝神	屏氣凝神
沓無音信	杳無音信
哪理	哪裏
鋒鋩	鋒芒
作歇時間	作息時間
隱約其詞	隱約其辭
她九打電話	她就打電話
暝思苦想	冥思苦想
司空見怪	司空見慣
喜暗	喜歡
留着鞭子	留着辮子
羅嗦	囉嗦
花消	花銷
候門如海	侯門如海
如火如茶	如火如荼
發韌	發軔
疲塌	疲沓
牽聯	牽連
文恬武嘻	文恬武嬉
肖象	肖像
錄色	綠色
大明哏他朋友	大明跟他朋友
補釘	補丁
黔驢計窮	黔驢技窮
嘹喨	嘹亮
手醫學治療	受醫學治療
已經再發生了	已經在發生了
發山	爬山
依些	一些
沙壺	砂壺
不另賜教	不吝賜教
永保青春	永葆青春
一落千仗	一落千丈
密魯	祕魯
熾愛	摯愛
遊日聘懷	遊日騁懷
奕棋	弈棋
痙孿	痙攣
雪中送碳	雪中送炭
近去	進去
名聞暇邇	名聞遐邇
大相徑廷	大相徑庭
倍受歡迎	備受歡迎
啞吧	啞巴
磨拳擦掌	摩拳擦掌
裏學校很近	離學校很近
動則得咎	動輒得咎
手不失卷	手不釋卷
不斷的提高	不斷地提高
覺得貳	覺得餓
無是生非	無事生非
勞動鍛練	勞動鍛鍊
恰談業務	洽談業務
投投是道	頭頭是道
招搖闖騙	招搖撞騙
照像機	照相機
要言不繁	要言不煩
起程	啓程
虛無飄緲	虛無縹緲
惟一	唯一
不求深解	不求甚解
祖傳密方	祖傳祕方
吉詳	吉祥
腫漲	腫脹
潮忽忽	潮乎乎
答理	搭理
彰善憚惡	彰善癉惡
亂烘烘	亂哄哄
憑添	平添
兔然	突然
以毒功毒	以毒攻毒
根她坐公共汽車	跟她坐公共汽車
臺彎	臺灣
拌腳之石	絆腳之石
蔽帚自珍	敝帚自珍
事過景遷	事過境遷
編篡字典	編纂字典
格登	咯噔
過的不錯	過得不錯
山顛	山巔
百尺杆頭	百尺竿頭
座一下	坐一下
固疾	痼疾
明火執杖	明火執仗
雕落	凋落
悚人聽聞	聳人聽聞
營爲	因爲
斬新	嶄新
對們	對門
青純	清純
狂大	廣大
座飛機	坐飛機
始作傭者	始作俑者
數爲至少四個人	數位至少四個人
無恥闌言	無恥讕言
忽然開朗	豁然開朗
困獸鬥	困猶鬥
針貶時弊	鍼砭時弊
崗來	剛來
最難得課	最難的課
邊請卡	邀請卡
故作矜恃	故作矜持
繁文褥節	繁文縟節
高興的不得了	高興得不得了
堵注	賭注
剛腹自用	剛愎自用
有疑點藤	有一點疼
必較多	比較多
心曠神飴	心曠神怡
暖哄哄	暖烘烘
受益非淺	受益匪淺
他們得不負責任的態度	他們的不負責任的態度
計畫	計劃
俗不可奈	俗不可耐
遊刀有餘	遊刃有餘
爲國捐驅	爲國捐軀
軼序井然	秩序井然
如雷灌耳	如雷貫耳
蕃衍	繁衍
怎嗎	怎麼
貪髒枉法	貪贓枉法
磕磕拌拌	磕磕絆絆
費寢忘食	廢寢忘食
天然汽	天然氣
漸漸的形成	漸漸地形成
份外	分外
投機搗把	投機倒把
成出不窮	層出不窮
還不過	還不夠
竭澤而魚	竭澤而漁
中國子	中國字
嘔氣	慪氣
交弮	交卷
雀瘢	雀斑
鬼域技倆	鬼蜮伎倆
冒然	貿然
玷玷自喜	沾沾自喜
擊濁揚清	激濁揚清
戰略部暑	戰略部署
不醒人事	不省人事
除惡勿盡	除惡務盡
看得是美國電影	看的是美國電影
約莫	約摸
栽髒陷害	栽贓陷害
好朋有	好朋友
五彩斑爛	五彩斑斕
推稱出新	推陳出新
搭拉	耷拉
翻然醒悟	幡然醒悟
林雨	淋雨
艱苦倍嘗	艱苦備嚐
伏輸	服輸
想望	嚮往
安份守紀	安分守紀
旁遍	旁邊
邀情	邀請
揚常而去	揚長而去
沾辱	玷辱
好好的準備	好好地準備
很來	很累
談討	探討
水乳交溶	水乳交融
定婚	訂婚
無尚	無上
不輸服	不舒服
破斧沉舟	破釜沉舟
庸庸彔彔	庸庸碌碌
山巒重迭	山巒重疊
一瀉千里	一瀉千里
卑躬曲膝	卑躬屈膝
方假	放假
搗騰	倒騰
敷演塞責	敷衍塞責
罷絀百家	黜絀百家
未日來臨	末日來臨
各行其事	各行其是
故作恣態	故作姿態
寰麟	婚禮
鴆形鵠面	鳩形鵠面
插血爲盟	歃血爲盟
客愛	可愛
可以馬	可以嗎
屈伏	屈服
背理	悖理
明片	名片
香菰	香菇
保護國萃	保護國粹
將學金	獎學金
菾菜	甜菜
月芽	月牙
委靡	萎靡
無線大	無限大
責無旁代	責無旁貸
擔擱	耽擱
偃苗助長	揠苗助長
死氣白賴	死乞白賴
盤跚	蹣跚
磐竹難書	罄竹難書
鴻福	洪福
翱遊	遨遊
不溫不火	不瘟不火
這到不錯	這倒不錯
勾針	鉤針
編篡	編纂
倉黃	倉皇
九宵	九霄
病入膏盲	病入膏肓
螞蜂	馬蜂
連鎖反映	連鎖反應
人言責責	人言嘖嘖
脈博微弱	脈搏微弱
變的困難	變得困難
不能自己	不能自已
辯辭	辯詞
忠於等到了	終於等到了
端五	端午
倆個	兩個
澹然	淡然
益於言表	溢於言表
十子路口	十字路口
因才施教	因材施教
撕殺	廝殺
赤博上陣	赤膊上陣
含胡	含糊
呼嗤	呼哧
暴烈恣睢	暴戾恣睢
回來臺灣	會來臺灣
要作塑膠袋	要做塑膠袋
塞太陽	曬太陽
無空不入	無孔不入
疏緩	舒緩
銷歇	消歇
燴炙人口	膾炙人口
車箱	車廂
敘言	序言
元煤	原煤
諜諜不休	喋喋不休
擠身三強	躋身三強
惡訊循環	惡性循環
洗碗	希望
夠貓	狗貓
峻工驗收	竣工驗收
情素	情愫
耐心的教育	耐心地教育
花着	花招
激忿	激憤
暇瑜互見	瑕瑜互見
宏揚	弘揚
回光反照	迴光返照
混身是膽	渾身是膽
雜遝	雜沓
惓惓	拳拳
嗜酒成僻	嗜酒成癖
痛心擊首	痛心疾首
開發看經濟	開發和經濟
學習的很愉快	學習得很愉快
牛崽褲	牛仔褲
兢競業業	兢兢業業
璀爛奪目	璀璨奪目
循章摘句	尋章摘句
合問她	和問她
展生	產生
臺杯	臺北
他杏林	他姓林
仗義輸財	仗義疏財
峻工	竣工
多某些人來說	對某些人來說
吃部下	吃不下
慓悍	剽悍
安幫定國	安邦定國
百練成鋼	百鍊成鋼
防患未燃	防患未然
財物科	財務科
請座	請坐
哀聲嘆氣	唉聲嘆氣
折衷	折中
不斷的	不斷地
飄泊	漂泊
擁帶	擁戴
漂亮的術	漂亮的樹
簡煉	簡練
戳力同心	戮力同心
號咷	號啕
一應具全	一應俱全
一點鵝	一點餓
聯綿	連綿
厲厲在目	歷歷在目
搭赸	搭訕
舢舨	舢板
談着談者	談着談着
慘絕人圜	慘絕人寰
他們的採	他們的菜
絕然不同	截然不同
昏饋無能	昏聵無能
俶儻	倜儻
舉足無措	手足無措
忘恩負意	忘恩負義
滿腹經倫	滿腹經綸
認識浮淺	認識膚淺
啞叭	啞巴
不斷的努力	不斷地努力
學識休養	學識修養
希少	稀少
根柢	根底
全神灌注	全神貫注
比畫	比劃
從中幹旋	從中斡旋
感人肺府	感人肺腑
振撼	震撼
恢諧	詼諧
少縱即逝	稍縱即逝
書柬	書簡
中華人名共和國	中華人民共和國
黯然消魂	黯然銷魂
閒情逸志	閒情逸致
草管人命	草菅人命
運籌帷握	運籌帷幄
走途無路	走投無路
訓戒	訓誡
蹓躂	溜達
沾污清白	玷污清白
能言善辨	能言善辯
惡耗	噩耗
阻擊敵人	狙擊敵人
你道德地旁	你到的地方
一榻糊塗	一塌糊塗
箇中三昧	箇中三味
無原無故	無緣無故
一幅對聯	一副對聯
血綠	血緣
一愁莫展	一籌莫展
層見迭出	層見疊出
緲視	藐視
意興闌姍	意興闌珊
刻劃	刻畫
辯析	辨析
３０份鍾	３０分鐘
共車	公車
莫明其妙	莫名其妙
模胡	模糊
象片	相片
堵絕浪費	堵杜浪費
妳怎麼了	你怎麼了
藐小	渺小
不可思義	不可思議
惟恐	唯恐
拒諫是非	拒諫飾非
萎糜不振	萎靡不振
起用試卷	啓用試卷
勘平叛亂	戡平叛亂
有沒有控	有沒有空
待你的國家	到你的國家
梗直	耿直
感人肺俯	感人肺腑
淺溥	淺薄
引伸	引申
爍石流金	鑠石流金
狡滑	狡猾
杳無音訊	杳無音信
敖敖待哺	嗷嗷待哺
瘋瘋顛顛	瘋瘋癲癲
糟塌	糟蹋
口乾舌躁	口乾舌燥
很日	很熱
投桃抱李	投桃報李
千釣一發	千鈞一髮
跳無	跳舞
成市	城市
精采	精彩
綿聯	綿連
循序前進	循序漸進
莫哀一是	莫衷一是
秣馬利兵	秣馬厲兵
宣賓奪主	喧賓奪主
這哩	這裏
死不暝目	死不瞑目
三個湊皮匠	三個臭皮匠
黎黑	黧黑
憚精竭慮	殫精竭慮
言談恢諧	言談詼諧
相輔相承	相輔相成
寮解	瞭解
腳色	角色
花稍	花哨
記錄片	紀錄片
貫輸知識	灌輸知識
左右開工	左右開弓
子畜	仔畜
嬌揉造作	矯揉造作
理令智昏	利令智昏
遠大報負	遠大抱負
斷壁殘桓	斷壁殘垣
新家波	新加坡
興奮得	興奮地
步履惟艱	步履維艱
你好馬	你好嗎
招惹事非	招惹是非
衝耳不聞	充耳不聞
付之東流	付諸東流
遺笑大方	貽笑大方
易如翻掌	易如反掌
我門	我們
微言大意	微言大義
不斷的改變	不斷地改變
掉換	調換
定車	停車
叫化子	叫花子
勸戒	勸誡
黑古龍冬	黑咕隆咚
反應意見	反映意見
故技重演	故伎重演
憑白無故	平白無故
我想情你	我想請你
銀董	運動
身體嬴弱	身體羸弱
桃論	討論
豁拳	划拳
蟠石	磐石
釘梢	盯梢
老趼	老繭
軲轤	軲轆
暉映	輝映
做弄	作弄
先發治人	先發制人
歷盡堅辛	歷盡艱辛
塗毒生靈	荼毒生靈
神采弈弈	神采奕奕
英雄倍出	英雄輩出
冒然從事	貿然從事
藍球健將	籃球健將
急言厲色	疾言厲色
給與	給予
開方	開放
子實	籽實
沾起來	站起來
流言飛語	流言蜚語
清徹	清澈
委罪	諉罪
棉裏藏針	綿裏藏針
大們口	大門口
絕不罷休	決不罷休
衆口爍金	衆口鑠金
興起不好	心情不好
結昏	結婚
今天得計畫	今天的計畫
老奸巨滑	老奸巨猾
眽眽	脈脈
忙綠	忙碌
串連	串聯
睡眼醒鬆	睡眼惺鬆
指手劃腳	指手畫腳
無恥濫言	無恥讕言
希冠	希望
東不拉	冬不拉
孤負	辜負
安份守己	安分守己
科學發展現	科學發展觀
口蜜腹箭	口蜜腹劍
良秀不齊	良莠不齊
先理後兵	先禮後兵
批漏百出	紕漏百出
排照	拍照
再慶祝一次把	再慶祝一次吧
呼蚩	呼哧
艱不可摧	堅不可摧
撤消	撤銷
堆動	推動
功虧一潰	功虧一簣
涌躍報名	踊躍報名
按途索驥	按圖索驥
風雨如悔	風雨如晦
記要	紀要
逃論室	討論室
修茸	修葺
拙拙逼人	咄咄逼人
墜落腐化	墮落腐化
打架鬥歐	打架鬥毆
暖呼呼	暖乎乎
新潁別緻	新穎別緻
熱坑頭	熱炕頭
時間一天一天的過去	時間一天一天地過去
熱中	熱衷
融匯貫通	融會貫通
克苦耐勞	刻苦耐勞
情你去吃飯	請你去吃飯
在馬上去	再馬上去
通霄不眠	通宵不眠
內容懂不清楚	內容都不清楚
批具	啤酒
顯象管	顯像管
來的這麼快	來得這麼快
刷費苦心	煞費苦心
粗曠	粗獷
有控	有空
駕御	駕馭
全心全力的	全心全力地
雅片	鴉片
輯逸	輯佚
千均一發	千鈞一髮
不堪之論	不刊之論
治絲益紛	治絲益棼
別出心才	別出心裁
入坐	入座
募然回首	驀然回首
感情融恰	感情融洽
倉惶	倉皇
化了半個小時	花了半個小時
到處傳頌	到處傳誦
變的很輕鬆	變得很輕鬆
一仍舊慣	一仍舊貫
變本加利	變本加厲
蘭天白雲	藍天白雲
可資借戒	可資借鑑
留戀忘返	留連忘返
欣嘗	欣賞
綠樹成陰	綠樹成蔭
點蔡	點菜
甘敗下風	甘拜下風
左證	佐證
暱友打算	你有打算
奢糜	奢靡
拼拼揍揍	拼拼湊湊
罰角球	發角球
文彩	文采
永敢	勇敢
各我媽媽	給我媽媽
提以	提議
舉一返三	舉一反三
前踞後恭	前倨後恭
巧言厲色	巧言令色
興亡週期率	興亡週期律
學玩了	學完了
瘋癱	風癱
人情事故	人情世故
各施其職	各司其職
教育基精	教育基金
牀第之私	牀笫之私
壓詐平民	壓榨平民
下起	下去
手屈一指	首屈一指
棒他	幫他
惟其	唯其
願賴	原來
衆目暌暌	衆目睽睽
脂麻	芝麻
標識	標誌
珍羞	珍饈
歹去	帶去
忿怒	憤怒
二零五齡年	二零五零年
漁汛	魚汛
引疚自責	引咎自責
裝造性	創造性
助紂爲謔	助紂爲虐
不啻	不是
白晰	白皙
夾肢窩	胳肢窩
十隻路口	十字路口
精兵減政	精兵簡政
赳糾武夫	赳赳武夫
曇花一顯	曇花一現
令人乍舌	令人咋舌
剗除	剷除
間媽媽	見媽媽
票涼	漂亮
再接再礪	再接再厲
遺害無窮	貽害無窮
取銷	取消
遁辭	遁詞
辯辨是非	明辨是非
不斷的鼓勵	不斷地鼓勵
座呢個公車	坐那個公車
攙假	摻假
惜來看	借來看
令人發直	令人髮指
自命得意	自鳴得意
驕奢淫佚	驕奢淫逸
一扁吃	一邊吃
佳賓	嘉賓
刻勤刻儉	克勤克儉
缺之不恭	卻之不恭
枝捂	支吾
虛無縹渺	虛無飄渺
感恩帶德	感恩戴德
滴里嘟嚕	嘀裏嘟嚕
虛座以待	虛左以待
嚴謹公款吃喝	嚴禁公款吃喝
門裏出生	門裏出身
請辦我	請幫我
可況	何況
他的華	他的話
愁天	秋天
弄多的很快	弄多得很快
中心感謝	衷心感謝
義不容詞	義不容辭
立功瀆罪	立功贖罪
希有	稀有
交到了	就到了
闇然銷魂	黯然銷魂
帶來得危機	帶來的危機
丟三拉四	丟三落四
一筆鉤銷	一筆勾銷
有持無恐	有恃無恐
淵遠流長	源遠流長
陰謀鬼計	陰謀詭計
一古腦兒	一股腦兒
腳指	腳趾
蜇伏	蟄伏
花梢	花哨
坐陣	坐鎮
利害悠關	利害攸關
五色斑瀾	五色斑斕
對不氣	對不起
十五分種	十五分鐘
一前	以前
風雨蕭蕭	風雨瀟瀟
恢諧幽默	詼諧幽默
濃裝豔抹	濃妝豔抹
莫斯漢堡	摩斯漢堡
九宵雲外	九霄雲外
爬上	爬山
大多類同	大多雷同
詡詡如生	栩栩如生
委謝	萎謝
陪養	培養
以警效尤	以儆效尤
脣槍舌箭	脣槍舌劍
大放厥辭	大放厥詞
入場卷	入場券
烤試	考試
瘋顛	瘋癲
叫真	較真
我要會我的國家	我要回我的國家
系根據	是根據
惡灌滿盈	惡貫滿盈
唐僧帥徒	唐僧師徒
始作踊者	始作俑者
虎視眈耽	虎視眈眈
揚揚灑灑	洋洋灑灑
相像	現象
天地無垠	天地無限
瞻養父母	贍養父母
不可思異	不可思議
消聲匿跡	銷聲匿跡
太概	大概
關連	關聯
自記	自己
真巧嘔	真巧喔
要末	要麼
軍事訓煉	軍事訓練
不落巢臼	不落窠臼
老實本份	老實本分
通霄達旦	通宵達旦
鬆馳	鬆弛
提綱契領	提綱挈領
湊和	湊合
歡渡春節	歡度春節
不單	不但
爆發戶	暴發戶
開是	開始
渺視	藐視
自怨自弋	自怨自艾
推崇倍至	推崇備至
慎重的希望	慎重地希望
殺尾	煞尾
莫可明狀	莫可名狀
夠戧	夠嗆
吹唐人	吹糖人
別出新裁	別出心裁
史無前列	史無前例
最總	最終
和言悅色	和顏悅色
斷壁頹桓	斷壁頹垣
他的婉	他的腕
腳根	腳跟
勵兵秣馬	厲兵秣馬
鹵莽	魯莽
協從不問	脅從不問
趁心如意	稱心如意
望而怯步	望而卻步
惟利是圖	唯利是圖
正襟威坐	正襟危坐
自學成才	自學成材
自各兒	自個兒
丟人顯眼	丟人現眼
固步自封	故步自封
人所不恥	人所不齒
望洋心嘆	望洋興嘆
張燈結采	張燈結綵
饌衣服	穿衣服
他清她吃飯	他請她吃飯
嗎嗎	媽媽
抔水車薪	杯水車薪
苦心孤旨	苦心孤詣
糜糜之音	靡靡之音
朋有	朋友
成現	呈現
錄象	錄像
坐壁上觀	作壁上觀
安置若素	安之若素
蟠踞	盤踞
暴舔天物	暴殄天物
辦發	辦法
又意思	有意思
目不交捷	目不交睫
希奇	稀奇
心狠手棘	心狠手辣
搜已	所以
付食品	副食品
瀉湖	潟湖
便很帥	變很帥
臺灣得風景	臺灣的風景
中流抵柱	中流砥柱
怎嚜走	怎麼走
奴顏卑膝	奴顏婢膝
米了	迷了
污合之衆	烏合之衆
扶貪	扶貧
高現	高興
打公車	搭公車
砍大山	侃大山
深受蒙敝	深受矇蔽
虛無縹渺	虛無縹緲
握着我的朋友	我找我的朋友
交相機	照相機
興高彩列	興高采烈
蟠曲	盤曲
雕零	凋零
一喏千金	一諾千金
下功夫	下工夫
主在鄉下	住在鄉下
毗臨	毗鄰
剌剌不休	刺刺不休
劉信	留信
必恭必敬	畢恭畢敬
真象大白	真相大白
變的更大	變得更大
再接再勵	再接再厲
渝期作廢	逾期作廢
公車佔	公車站
竄改政策	篡改政策
病人膏盲	病人膏肓
座７１６號的公車	坐７１６號的公車
丫鬟	丫環
傍邊	旁邊
栩詡如生	栩栩如生
白頭攜老	白頭偕老
一杯黃土	一抔黃土
服事	服侍
門可落雀	門可羅雀
手摽	手錶
懹人民自己選擇	讓人民自己選擇
蟠據	盤踞
情份	情分
鼓躁而進	鼓譟而進
不彷	不妨
很葬	很髒
和事老	和事佬
旅力過人	膂力過人
宮庭	宮廷
熱漲冷縮	熱脹冷縮
望風披糜	望風披靡
雄糾糾	雄赳赳
怨天憂人	怨天尤人
薰陶	薰陶
遨翔	翱翔
青跨	情況
光采	光彩
莫不關心	漠不關心
廖廖無幾	寥寥無幾
經額	金額
釣消執照	吊銷執照
化夏子孫	華夏子孫
腦羞成怒	老羞成怒
跌交	跌跤
氣慨	氣概
張惶	張皇
窮窮孑立	煢煢孑立
僥勇善戰	驍勇善戰
怨天由人	怨天尤人
鬼哭狼嗥	鬼哭狼嚎
神彩	神采
懲前斃後	懲前毖後
推陳相見	推誠相見
幅圓遼闊	幅員遼闊
愛不失手	愛不釋手
粗製爛造	粗製濫造
推委	推諉
渡假村	度假村
裏拜四	禮拜四
大放決詞	大放厥詞
拾遺補闕	拾遺補缺
囹圉	囹圄
雜踏	雜沓
鞭僻入理	鞭辟入裏
其末考	期末考
爐火成青	爐火純青
央央大國	泱泱大國
出租得事	出租的事
搭連	褡褳
他門	他們
鄧的時候	等的時候
無計於事	無濟於事
候天	後天
纏能拯救	才能拯救
壓伏	壓服
不太施	不太溼
毛骨竦然	毛骨悚然
過份	過分
招搖裝騙	招搖撞騙
森嚴壁磊	森嚴壁壘
賦與	賦予
歡心鼓舞	歡欣鼓舞
誹夷所思	匪夷所思
再黑板寫的東西	在黑板寫的東西
明知固犯	明知故犯
份量	分量
放心地生活	放心的生活
情怳	情況
掂斤撥兩	掂斤播兩
嗔目結舌	瞠目結舌
紜紜衆生	芸芸衆生
喝采	喝彩
一切就序	一切就緒
斥之以鼻	嗤之以鼻
以開發國家	已開發國家
恨高興	很高興
無泄可擊	無懈可擊
趨之若騖	趨之若鶩
得不嘗失	得不償失
蟬連冠軍	蟬聯冠軍
我票告訴您	我要告訴您
由其固定的速度	有其固定的速度
間直	簡直
從德國萊	從德國來
哪哩	哪裏
水長船高	水漲船高
悾怕	恐怕
耽憂	擔憂
回越南得時候	回越南的時候
全家遷徒	全家遷徙
測隱之心	惻隱之心
高高興興的	高高興興地
一筆勾消	一筆勾銷
銷費率	消費率
依然固我	依然故我
在坐	在座
正加	增加
摹仿	模仿
潔白無暇	潔白無瑕
歐打	毆打
修養生息	休養生息
多要	都要
撥亂返正	撥亂反正
肄無忌憚	肆無忌憚
謊謬絕倫	荒謬絕倫
豆寇年華	豆蔻年華
學子	學字
殘無人道	慘無人道
有趣的說到	有趣地說到
廢盡心思	費盡心思
粘稠	黏稠
稱做	稱作
原子幅射	原子輻射
刻己奉公	克己奉公
照篇	照片
帶欠缺	但欠缺
忿忿	憤憤
發楊廣大	發揚光大
非常的寶貴	非常地寶貴
鐺鐺	噹噹
表達的是	表達的事
獨劈蹊徑	獨闢蹊徑
子豬	仔豬
做弊	作弊
佑對	有對
棒錘	棒槌
言簡意該	言簡意賅
不宵一顧	不屑一顧
侈糜	侈靡
汗流夾背	汗流浹背
履險如宜	履險如夷
寒喧	寒暄
錮疾	痼疾
建慷	健康
單純的說	單純地說
而截	而且
混身	渾身
手急眼快	手疾眼快
注在	住在
記念	紀念
萬相更新	萬象更新
下了可	下了課
筆劃	筆畫
根林美美去	跟林美美去
餲得不得了	渴得不得了
趼子	繭子
決對服從	絕對服從
不惶顧及	不遑顧及
佳賓滿座	嘉賓滿座
死不冥目	死不瞑目
洪篇鉅製	鴻篇鉅製
按居樂業	安居樂業
色採	色彩
大學肆業	大學肄業
聲名雀起	聲名鵲起
奴生	女生
夙儒	宿儒
泄祕	泄密
眼靚	眼睛
既使如此	即使如此
改弦易章	改弦易張
出類拔粹	出類拔萃
杯盤狼籍	杯盤狼藉
一把很大的化	一把很大的花
伶牙利齒	伶牙俐齒
殺費苦心	煞費苦心
褻贖	褻瀆
羅紋	螺紋
鳩佔雀巢	鳩佔鵲巢
推心至腹	推心置腹
柱着柺杖	拄着柺杖
子棉	籽棉
血濃與水	血濃於水
反覆	反覆
身體贏弱	身體羸弱
再開一個好把	再開一個好吧
以老賣老	倚老賣老
志大材疏	志大才疏
熱惱	熱鬧
稅覺	睡覺
寄怪	奇怪
惟我獨尊	唯我獨尊
他得生活費	他的生活費
留芳百世	流芳百世
蔘加	參加
平空	憑空
好好地經驗	好好的經驗
脹紅了臉	漲紅了臉
賽翁失馬	塞翁失馬
幸福快樂的過	幸福快樂地過
無寧	毋寧
義氣用事	意氣用事
蛛絲螞跡	蛛絲馬跡
定期會悟	定期會晤
讀書扎記	讀書札記
灸手可熱	炙手可熱
殘篇斷簡	殘編斷簡
哆唆	哆嗦
做聲	作聲
狼籍	狼藉
警張	緊張
各書己見	各抒己見
高官厚錄	高官厚祿
額首稱慶	額手稱慶
追本朔源	追本溯源
做公車	坐公車
小子化	少子化
源料	原料
岡來	剛來
不徑而走	不脛而走
摸棱兩可	模棱兩可
既往開來	繼往開來
器宇軒昂	氣宇軒昂
物極必返	物極必反
藊豆	扁豆
重重迭迭	重重疊疊
一層不變	一成不變
書聲琅朗	書聲琅琅
找的時間	找個時間
想往光明	嚮往光明
去萬	去玩
集液成裘	集腋成裘
走天	昨天
管哩	管理
澳是	要是
談笑風聲	談笑風生
子細	仔細
理物	禮物
萬古留芳	萬古流芳
投鼠計器	投鼠忌器
按納	按捺
梯己	體己
綱紀廢馳	綱紀廢弛
尤如猛虎下山	猶如猛虎下山
義氣風發	意氣風發
東四	東西
貴定	規定
卑卻	卑怯
舔犢情深	舐犢情深
縱橫捭合	縱橫捭闔
縐紋	皺紋
粘土	黏土
只有妳	只有你
和靄可親	和藹可親
很好得一份工作	很好的一份工作
捨身取義	捨生取義
真得是壞人	真的是壞人
捉襟見紂	捉襟見肘
還沒作	還沒做
棵粒歸倉	顆粒歸倉
嚴懲不待	嚴懲不貸
可望不可及	可望不可即
混水摸魚	渾水摸魚
保母	保姆
清賣給我	請買給我
悲忿	悲憤
懲一禁百	懲一儆百
惡慣滿盈	惡貫滿盈
魚具	漁具
題綱挈領	提綱挈領
艱苦撲素	艱苦樸素
色勵內荏	色厲內荏
有孔	有空
聲勢赫弈	聲勢赫奕
搭當	搭檔
火者站	火車站
勾聯	勾連
目不瑕接	目不暇接
風聲鶴戾	風聲鶴唳
倔犟	倔強
年輕得夫婦	年輕的夫婦
虎視耽耽	虎視眈眈
斧底抽薪	釜底抽薪
辨白	辯白
食不果腹	食不裹腹
摔交	摔跤
項練	項鍊
負單	負擔
元來	原來
讚歎不己	讚歎不已
一闕	一闋
來我的家完	來我的家玩
裝璜	裝潢
孤伶伶	孤零零
佈署已定	部署已定
候門似海	侯門似海
圖窮匕現	圖窮匕見
痛心嫉首	痛心疾首
對阿	對啊
沒人琣他	沒人陪他
展轉	輾轉
猶柔寡斷	優柔寡斷
黯無天日	暗無天日
搭擋	搭檔
照成	造成
年少氣勝	年少氣盛
應接不遐	應接不暇
疾賢妒能	嫉賢妒能
熱心的不得了	熱心得不得了
委屈求全	委曲求全
高心	高興
蜂涌而至	蜂擁而至
火伴	夥伴
很哩	很累
閃爍其辭	閃爍其詞
寡不抵衆	寡不敵衆
憤悶不平	憤懣不平
青少年門	青少年們
感恩載德	感恩戴德
原形必露	原形畢露
親愛的少年門	親愛的少年們
伏侍	服侍
隨聲附合	隨聲附和
裝腔做勢	裝腔作勢
馬糊	馬虎
末齒不忘	沒齒不忘
行成	形成
瘜肉	息肉
看做	看作
焚膏既晷	焚膏繼晷
描模	描摹
丁寧	叮嚀
不詳之兆	不祥之兆
冷不妨	冷不防
翁中捉鱉	甕中捉鱉
號嗎	號碼
混爲一團	混爲一談
搔癢病	瘙癢病
衣衿	衣襟
怎門辦	怎麼辦
貳心	二心
書寫了草	書寫潦草
紹待卡	招待卡
躍武揚威	耀武揚威
波瀾	波蘭
轂轆	軲轆
座落	坐落
厲害關係	利害關係
戶然	忽然
清假	請假
政符	政府
艱壁清野	堅壁清野
刻劃人物	刻畫人物
漂零	飄零
換給	還給
澹泊	淡泊
雕謝	凋謝
孤苦零丁	孤苦伶仃
真象	真相
一勞永易	一勞永逸
一毛不陪	一毛不賠
綜合症	綜合徵
幅射	輻射
略見一般	略見一斑
玩着玩者	玩着玩着
越俎代包	越俎代庖
按裝	安裝
觥疇交錯	觥籌交錯
列子	例子
李佬時	李老師
夙來	素來
事情阿	事情啊
反工重來	返工重來
裏拜天	禮拜天
喝倒采	喝倒彩
板上走丸	阪上走丸
老聲常談	老生常談
考良	考量
已後	以後
即然	既然
酒鍾	酒盅
勵行節約	厲行節約
無所不致	無所不至
曲指可數	屈指可數
滄茫大海	蒼茫大海
老師文學生	老師問學生
多餘	多於
磨崖石刻	摩崖石刻
不貽餘力	不遺餘力
無恥之猶	無恥之尤
林美妹	林美美
循規導矩	循規蹈矩
估名釣譽	沽名釣譽
層巒迭障	層巒疊嶂
原物必還	原物璧還
澄徹	澄澈
剝歇	剝削
養小還	養小孩
不可望	不可忘
低免	抵免
渙然一新	煥然一新
寄與	寄予
做美	作美
措火積薪	厝火積薪
當人不讓	當仁不讓
追朔	追溯
機伶	機靈
天禮難容	天理難容
以德抱怨	以報抱怨
打臘	打蠟
肆無忌殫	肆無忌憚
所擔任的是有限	所擔任的事有限
圖象	圖像
白壁微瑕	白璧微瑕
金剛努目	金剛怒目
纏能收割	才能收割
塌實	踏實
意正詞嚴	義正詞嚴
退色	褪色
蟠根錯節	盤根錯節
受與獎章	授與獎章
紳仕	紳士
巍然仡立	巍然屹立
浮圖	浮屠
輻湊	輻輳
姿式	姿勢
自起	自己
撘公車	搭公車
攻城掠地	攻城略地
金榜提名	金榜題名
再波蘭	在波蘭
班駁	斑駁
三翻五次	三番五次
尾大不弔	尾大不掉
旁皇	彷徨
輩份	輩分
不卑不吭	不卑不亢
磨肩擦背	摩肩擦背
枝解	肢解
不局道	不知道
蕉萃	憔悴
飄流	漂流
賢慧	賢惠
心恢意懶	心灰意懶
欲妄	慾望
了所學校	各所學校
直捷了當	直截了當
戒驕戒燥	戒驕戒躁
一讓	一樣
巧裝打扮	喬裝打扮
百年傢俱	百年家居
真得	值得
籲寒問暖	噓寒問暖
生濟	生計
出奇致勝	出奇制勝
風京	風景
淹沒不聞	湮沒不聞
破錠百出	破綻百出
又高又受	又高又瘦
顯身說法	現身說法
眼花暸亂	眼花繚亂
一蓋而論	一概而論
懸樑刺骨	懸樑刺股
大放獗詞	大放厥詞
髒款	贓款
作些政策	做些政策
防礙	妨礙
扇風點火	煽風點火
富麗唐皇	富麗堂皇
震聾發聵	振聾發聵
日蝕	日食
舉世振驚	舉世震驚
餵了	爲了
脫離萍	脫離貧
盅惑人心	蠱惑人心
一涌而入	一擁而入
人心項背	人心向背
臥是李	我是李
有效的規劃	有效地規劃
分道揚標	分道揚鑣
厲精圖治	勵精圖治
絀絀逼人	咄咄逼人
頭昏腦脹	頭昏腦漲
式樣新潁	式樣新穎
發人深醒	發人深省
玩世不公	玩世不恭
手溜彈	手榴彈
金壁輝煌	金碧輝煌
但靠一份收入	單靠一份收入
原意	願意
沙魚	鯊魚
不驕不燥	不驕不躁
視閾	視域
禮上往來	禮尚往來
處裏	處理
靠事	考試
橫衝直闖	橫衝直撞
憂柔寡斷	優柔寡斷
瑕邇聞名	遐邇聞名
謀畫	謀劃
獨腳戲	獨角戲
藍縷	襤褸
嬈幸生還	僥倖生還
積思廣益	集思廣益
恭惟	恭維
按步就班	按部就班
更疊	更迭
慢道	漫道
忿恨	憤恨
磨擦	摩擦
令人發指	令人髮指
重要得東西	重要的東西
永決	永訣
按磨	按摩
一脈相成	一脈相承
龍盤虎據	龍盤虎踞
低徊	低迴
水瀉不通	水泄不通
經張	緊張
跚跚來遲	姍姍來遲
坐位	座位
成份	成分
惺鬆	惺忪
無尚光榮	無上光榮
危言悚聽	危言聳聽
伏罪	服罪
但然	當然
餘輝	餘暉
落莫	落寞
尋序漸進	循序漸進
重迭	重疊
飄渺	縹緲
坐次	座次
恰商	洽商
深明大意	深明大義
妳會時後	妳回時候
沈思	沉思
沙糖	砂糖
因發	引發
親睞	青睞
弘願	宏願
萬籟具寂	萬籟俱寂
控的時間	空的時間
冒天下之大不諱	冒天下之大不韙
窮途沒路	窮途末路
沽惡不悛	怙惡不悛
暗度陳倉	暗渡陳倉
貽然自得	怡然自得
伏法	服法
依服	衣服
組寵物的人	租寵物的人
坐地分髒	坐地分贓
梳裝打扮	梳妝打扮
變換莫測	變幻莫測
神聖壯嚴	神聖莊嚴
蜂涌而上	蜂擁而上
連翩	聯翩
珠連璧合	珠聯璧合
一枕黃梁	一枕黃粱
震憾人心	震撼人心
滿臉縐紋	滿臉皺紋
上免得分析	上面的分析
山查	山楂
循規韜矩	循規蹈矩
一後	以後
氣勢滂礴	氣勢磅礴
浮光略影	浮光掠影
委屈求全	委屈求曲
開興	開心
每辦法	沒辦法
粘液	黏液
米珠薪貴	米珠薪桂
自即	自己
我要座得巴士	我要坐的巴士
鼎立相助	鼎力相助
霪雨	淫雨
大有稗益	大有裨益
告戒	告誡
鉤勒	勾勒
做二九七的公車	坐二九七的公車
漂渺	縹緲
上方寶劍	尚方寶劍
趨炎赴勢	趨炎附勢
昭顯機	照相機
名列前矛	名列前茅
嫉惡如仇	疾惡如仇
居心不測	居心叵測
以開發地區	已開發地區
大幅度的提升	大幅度地提升
掱手	扒手
按裝機器	安裝機器
挑撥事非	挑撥是非
真的事對	真的是對
生上	身上
手頭寬餘	手頭寬裕
既往不究	既往不咎
調以輕心	掉以輕心
中裁	仲裁
振筆急書	振筆疾書
美里	美麗
更古未有	亙古未有
無可耐何	無可奈何
承上起下	承上啓下
我回想妳們	我會想你們
難德	南德
裁板	裁判
大壩合攏	大壩合龍
震震有詞	振振有詞
喜孜孜	喜滋滋
蓬壁增輝	蓬蓽增輝
能曲能伸	能屈能伸
報導	報道
支無其詞	支吾其詞
五癆七傷	五勞七傷
恍忽	恍惚
不作爲訓	不足爲訓
一張一馳	一張一弛
揣揣不安	惴惴不安
鍾就	終究
無動於中	無動於衷
勞天	聊天
茄克	夾克
悼辭	悼詞
惡意咀咒	惡意詛咒
清流	請留
蟄人	蜇人
分付	吩咐
衣著	衣着
鬼域伎倆	鬼蜮伎倆
自然而然的	自然而然地
鳳毛鱗角	鳳毛麟角
鯁直	耿直
耳儒目染	耳濡目染
雲豆	芸豆
五體頭地	五體投地
騰她	等她
宏福齊天	洪福齊天
惟獨	唯獨
上果	上課
獨闢溪徑	獨闢蹊徑
因噎費食	因噎廢食
珍重其事	鄭重其事
風雲變換	風雲變幻
供獻巨大	貢獻巨大
人材	人才
報怨不堪	抱怨不堪
降龍服虎	降龍伏虎
點視機	電視機
百廢具興	百廢俱興
元元本本	原原本本
糜日不思	靡日不思
憂心沖沖	憂心忡忡
嬰而	嬰兒
考利以下	考慮一下
閃爍其詞	閃爍其辭
嚴懲不怠	嚴懲不貸
立杆見影	立竿見影
雷歷風行	雷厲風行
虎魄	琥珀
成績蜚然	成績斐然
令人恐布	令人恐怖
搖搖欲墮	搖搖欲墜
劈謠	闢謠
翻覆無常	反覆無常
移花截木	移花接木
風糜一時	風靡一時
委宛	委婉
轟堂大笑	鬨堂大笑
侯車室	候車室
奇給我	寄給我
下明	小明
得壟望蜀	得隴望蜀
動轍得咎	動輒得咎
藕斷絲聯	藕斷絲連
諄諄告戒	諄諄告誡
萬古常青	萬古長青
濫芋充數	濫竽充數
票亮	漂亮
一諾千斤	一諾千金
不斷的增加	不斷地增加
我借你們	我接你們
首坐	首座
浸人心脾	沁人心脾
一泄千里	一瀉千里
歪門斜道	歪門邪道
堅如盤石	堅如磐石
始終不遇	始終不渝
風塵僕撲	風塵僕僕
魚鼓	漁鼓
偷工簡料	偷工減料
門坎	門檻
生體	身體
勢不可擋	勢不可當
辰己午未	辰巳午未
含糊其詞	含糊其辭
蘇嘉	暑假
判辭	判詞
子粒	籽粒
踏青我們	他請我們
錯手不及	措手不及
毛骨聳然	毛骨悚然
一見衷情	一見鍾情
當做	當作
編者案	編者按
既使	即使
面面具到	面面俱到
改弦更章	改弦更張
永往直前	勇往直前
名珠暗投	明珠暗投
天翻地覆	天翻地覆
保鑣	保鏢
闇然淚下	黯然淚下
厲害得失	利害得失
壅榮華貴	雍榮華貴
完五月	玩五月
錄行	旅行
病入膏盲	病入肓盲
卑恭屈膝	卑躬屈膝
暴光	曝光
潛然淚下	潸然淚下
重整旗鼓	重振旗鼓
暗然失色	黯然失色
生靈塗碳	生靈塗炭
比分板平	比分扳平
定戶	訂戶
逗遛	逗留
西歡	喜歡
唯命是從	惟命是從
從是	總是
蝦蟆	蛤蟆
甘之如怡	甘之如飴
潑浪鼓	撥浪鼓
淪肌夾髓	淪肌浹髓
少字化	少子化
穿流不息	川流不息
凋蟲小技	雕蟲小技
氣門心	氣門芯
箴口不言	緘口不言
一語破地	一語破的
詞令	辭令
富麗堂黃	富麗堂皇
文謅謅	文縐縐
微信	微信
分庭抗理	分庭抗禮
輟句成文	綴句成文
堅幀不移	堅貞不移
槍枝	槍支
倉遑	倉皇
獨佔螯頭	獨佔鰲頭
羊羯子	羊蠍子
情不自盡	情不自禁
倒楣	倒黴
一竊不通	一竅不通
脈胳分明	脈絡分明
語無綸次	語無倫次
憤筆急書	奮筆疾書
自我吹籲	自我吹噓
歷精圖治	勵精圖治
爆亂	暴亂
沙漿	砂漿
題高	提高
零丁	伶仃
延襲成規	沿襲成規
泄藥	瀉藥
孤另另	孤零零
委屈婉轉	委曲婉轉
改很多幼稚園	蓋很多幼稚園
全面的規劃	全面地規劃
即然如此	既然如此
大姆指	大拇指
一整天水樂	一整天睡了
鍾靈玉秀	鍾靈毓秀
賀辭	賀詞
源源本本	原原本本
針炙療法	鍼灸療法
最前的子	最前的字
散逸	散佚
曲高合寡	曲高和寡
認罪服法	認罪伏法
架式	架勢
票漂亮亮	漂漂亮亮
份內之事	分內之事
通貨澎脹	通貨膨脹
照本宣課	照本宣科
杆快	趕快
本份	本分
稍事擔擱	稍事耽擱
沾着	站着
鞠躬盡粹	鞠躬盡瘁
等以等	等一等
佳言懿行	嘉言懿行
水利發電	水力發電
苦思瞑想	苦思冥想
抓耳擾腮	抓耳撓腮
醮水	蘸水
課目	科目
阿諛奉迎	阿諛逢迎
殉私舞弊	徇私舞弊
僱傭	僱用
肺腹之言	肺腑之言
茫無頭序	茫無頭緒
做月子	坐月子
工程峻工	工程竣工
鬼鬼崇崇	鬼鬼祟祟
嚴陣以代	嚴陣以待
早藏	早上
褓姆	保姆
小題大作	小題大做
異曲同功	異曲同工
播愛	博愛
枝梧	支吾
引起反映	引起反應
坐者	坐着
夙怨	宿怨
蹓彎兒	遛彎兒
大傷原氣	大傷元氣
爆躁	暴躁
泊來品	舶來品
出謀畫策	出謀劃策
旁證博引	旁徵博引
以逸代勞	以逸待勞
裨官野史	稗官野史
成功的制定	成功地制定
語無論次	語無倫次
無細可乘	無隙可乘
鬧轟轟	鬧哄哄
夢饜	夢魘
捶心泣血	椎心泣血
英雄氣慨	英雄氣概
仔細的觀察	仔細地觀察
蒼海桑田	滄海桑田
污七八糟	烏七八糟
濯發難數	擢髮難數
細大不涓	細大不捐
真知卓見	真知灼見
跟美	很美
天網詼詼	天網恢恢
打躬作楫	打躬作揖
劃地爲牢	畫地爲牢
憤世疾俗	憤世嫉俗
深符衆望	深孚衆望
參家	參加
密而不宣	祕而不宣
靡爛不堪	糜爛不堪
多付出地幾十倍	多付出的幾十倍
鳩合	糾合
不寒而立	不寒而慄
反來複去	反來覆去
乎很大的吸	呼很大的吸
雕弊	凋敝
嘆爲觀之	歎爲觀止
無獨有隅	無獨有偶
自食其利	自食其力
踟躇	踟躕
疏峻	疏浚
留連	流連
落腮鬍子	絡腮鬍子
模寫	摹寫
金毆無缺	金甌無缺
吧手	把手
轅動比賽	運動比賽
言之足足	言之鑿鑿
緊褲	辛苦
高行	高興
步入正規	步入正軌
輕歌慢舞	輕歌曼舞
不好以時	不好意思
化錢	花錢
少子華	少子化
冬天件	冬天間
壓韻	押韻
真恭喜妳阿	真恭喜妳啊
硬梆梆	硬邦邦
計劃慎密	計劃縝密
山青水秀	山清水秀
聞過飾非	文過飾非
擁塞不通	擁壅不通
筆心	筆芯
莊況	狀況
退化變質	蛻化變質
瞳人	瞳仁
募然	驀然
出們	出門
殺戳	殺戮
喧然大波	軒然大波
常不一樣	穿不一樣
鳳冠霞披	鳳冠霞帔
把輸給弄丟	把書給弄丟
消遙法外	消逍法外
半途而費	半途而廢
磬竹難書	罄竹難書
粗製亂造	粗製濫造
鳩集	糾集
御手	馭手
浪廢水	浪費水
魔難	磨難
有口皆杯	有口皆碑
干與	干預
合衷共濟	和衷共濟
不拘導	不知道
含蓄蘊籍	含蓄蘊藉
綱來	剛來
蜇居	蟄居
工課	功課
計錄	記錄
無理漫罵	無理謾罵
無所是從	無所適從
負擔地因素	負擔的因素
列出題綱	列出提綱
腳門	角門
擬越來越漂亮	妳越來越漂亮
有處	有趣
棄甲拽兵	棄甲曳兵
慘遭屠戳	慘遭屠戮
四班牙	西班牙
後發治人	後發制人
坐右銘	座右銘
根冒	感冒
岑麼樣	怎麼樣
梅天	每天
強辭奪理	強詞奪理
天崩地折	天崩地坼
蓽路藍縷	篳路藍縷
無以附加	無以復加
忘夫所以	忘乎所以
火中取粟	火中取栗
番然悔悟	翻然悔悟
休葸	休息
並行不背	並行不悖
再起牀呢	在起牀呢
總明	聰明
非常的珍貴	非常地珍貴
伸雪	申雪
甚麼	什麼
峨嵋山	峨眉山
泰泰	太太
趁心	稱心
考食物	烤食物
燦然一笑	粲然一笑
小還	小孩
出奇不意	出其不意
延後	然後
班配	般配
氣個月	七個月
插科打渾	插科打諢
玷親帶故	沾親帶故
連袂	聯袂
莫中一是	莫衷一是
開心得	開心地
埤酒	啤酒
情坐	請坐
粘性	黏性
決無僅有	絕無僅有
熱呼呼	熱乎乎
報道總裁	霸道總裁
箇中各樣	各種各樣
麻庳大意	麻痹大意
修茸一新	修葺一新
置若惘聞	置若罔聞
名落深山	名落孫山
慢不經心	漫不經心
發憤忘食	發奮忘食
精神矍爍	精神矍鑠
沒有控	沒有空
烤師	考試
震憾	震撼
明查秋毫	明察秋毫
鈕釦	鈕釦
死心踏地	死心塌地
打冷顫	打冷戰
下車一始	下車伊始
雨聲浙瀝	雨聲淅瀝
籌畫	籌劃
一促而就	一促而蹴
坦胸露臂	袒胸露臂
心安禮得	心安理得
淋漓盡至	淋漓盡致
粘豆包	黏豆包
坐無虛席	座無虛席
造事者	肇事者
刻日	剋日
中國共產常	中國共產黨
省分	省份
發生國	發生過
定單	訂單
卓智多謀	足智多謀
座標系	座標系
娘兩	娘倆
百戰不貽	百戰不殆
篷蓽生輝	蓬蓽生輝
此係膺品	此係贗品
負嵎頑抗	負隅頑抗
星羅旗布	星羅棋佈
千頭萬序	千頭萬緒
部份	部分
運籌惟幄	運籌帷幄
託咐	託付
溟溟	冥冥
脈膊微弱	脈搏微弱
無庸	毋庸
以身徇國	以身殉國
普便	普遍
堅韌不拔	堅忍不拔
鄭加	增加
以一擋十	以一當十
天下糜然	天下靡然
佶屈騖牙	佶屈聱牙
沉緬往事	沉湎往事
薄暮冥冥	薄暮暝暝
開門緝盜	開門揖盜
以開發	已開發
最有名的採	最有名的菜
執謎不悟	執迷不悟
覆信	覆信
惟命是從	唯命是從
煤碳	煤炭
金鋼鑽頭	金剛鑽頭
鬨動	轟動
勇敢得	勇敢地
世外桃園	世外桃源
富麗堂惶	富麗堂皇
噠噠	嗒嗒
豐功偉跡	豐功偉績
以偏蓋全	以偏概全
秀外惠中	秀外慧中
支解	肢解
夫倡婦隨	夫唱婦隨
流覽一遍	瀏覽一遍
除去完	出去玩
嘍羅	嘍囉
驃肥體壯	膘肥體壯
其樂淘淘	其樂陶陶
紅通通	紅彤彤
奴朋友	女朋友
感在	改在
思辯	思辨
飛機着落	飛機着陸
驃了	漂亮
舉家遷徒	舉家遷徙
心懷巨測	心懷叵測
殉情枉法	徇情枉法
良晨美景	良辰美景
無精打彩	無精打采
冠勉堂皇	冠冕堂皇
蹀血	喋血
怎麼形成地	怎麼形成的
火山暴發	火山爆發
裏拜	禮拜
爆發	暴發
麻木不忍	麻木不仁
處心集慮	處心積慮
隕身不恤	殞身不恤
傳頌一時	傳誦一時
正經八擺	正經八百
黃樑美夢	黃粱美夢
吃葚麼	吃什麼
心心相應	心心相印
也雪	也許
噏動	翕動
匍伏	匍匐
一如繼往	一如既往
罪不及奴	罪不及孥
孤芳自償	孤芳自賞
原故	緣故
精誠所致	精誠所至
歪風斜氣	歪風邪氣
菜子	菜籽
幸苦	辛苦
故技	故伎
信口開合	信口開河
墨守陳規	墨守成規
休息一點	休息一天
引伸義	引申義
神甫	神父
旋渦	漩渦
敲榨勒索	敲詐勒索
民生凋蔽	民生凋敝
唷意思	有意思
貌和神離	貌合神離
盤石	磐石
花狸狐哨	花裏胡哨
梢公	艄公
渾渾惡惡	渾渾噩噩
察顏觀色	察言觀色
神氣凌人	盛氣凌人
已定	一定
念道	唸叨
至到	直到
燈心	燈芯
帶孝	戴孝
一間一間的在建造	一間一間地在建造
痿靡不振	萎靡不振
留連忘返	流連忘返
鞭闢入理	鞭辟入裏
熱呼	熱乎
雄材大略	雄才大略
聯接	連接
蠟梅盛開	臘梅盛開
題辭	題詞
興高彩烈	興高采烈
像貌	相貌
憶起去	一起去
迫不急待	迫不及待
含辛如苦	含辛茹苦
不拘小結	不拘小節
萬事享通	萬事亨通
滔光養晦	韜光養晦
一支狗	一隻狗
涵蓄	含蓄
功虧一蕢	功虧一簣
一口同聲	異口同聲
提綱攜領	提綱挈領
藏詬納污	藏垢納污
坻裏	地理
戮力同心	勠力同心
東施效頻	東施效顰
粗枝大意	粗枝大葉
從常計議	從長計議
誅連無辜	株連無辜
言簡意駭	言簡意賅
聊體	聊天
圓丁	園丁
皎皎者	佼佼者
羽扇倫巾	羽扇綸巾
長愛文	張愛文
胡塗	糊塗
沆泄一氣	沆韰一氣
觀磨教學	觀摩教學
互相推委	互相推諉
買牘還珠	買櫝還珠
未普邊	未普遍
比年長者來的多	比年長者來得多
啓錨	起錨
大摟	大樓
迷天大謊	彌天大謊
門廷若市	門庭若市
交待	交代
發楞	發愣
文花	文化
痲風	麻風
恨情張	很緊張
皮簧	皮黃
心勞日絀	心勞日拙
建在	現在
滿山遍野	漫山遍野
美侖美奐	美輪美奐
誓死如歸	視死如歸
化學反映	化學反應
同等學歷	同等學力
名門旺族	名門望族
名子	名字
直接的被感受	直接地被感受
放便	方便
金石可褸	金石可鏤
學習地意願	學習的意願
嚴正申明	嚴正聲明
答訕	搭訕
個紓	個數
紋身	文身
而接	而且
不知所錯	不知所措
磁器	瓷器
短小精幹	短小精悍
定貨	訂貨
月蝕	月食
驀捐	募捐
招莫	招募
滿頭大漢	滿頭大汗
弦律	旋律
作賊心虛	做賊心虛
公克	功課
玩藝兒	玩意兒
原由	緣由
褡聯	褡褳
辛虧	幸虧
而以	而已
理面	裏面
枓拱	斗拱
獨具惠眼	獨具慧眼
寒傖	寒磣
不言而語	不言而喻
還壁歸趙	還璧歸趙
這樣以來	這樣一來
體晾	體諒
壓寶	押寶
萹豆	扁豆
清徹見底	清澈見底
斬釘接鐵	斬釘截鐵
豐富多采	豐富多彩
系望	希望
大聲急呼	大聲疾呼
摹擬	模擬
知書達禮	知書達理
封妻陰子	封妻廕子
癡心忘想	癡心妄想
譽寫文章	謄寫文章
宣染	渲染
弘論	宏論
曾加	增加
瞭望	瞭望
內鬨	內訌
那理	那裏
累墜	累贅
消魂	銷魂
戰戰驚驚	戰戰兢兢
自名不凡	自命不凡
警省	警醒
慶祝地會	慶祝的會
歸根結柢	歸根結底
愛帶	愛戴
題及	提及
風彩動人	風釆動人
不經而走	不脛而走
步人正規	步人正軌
繁文溽節	繁文縟節
長其	長期
爆動	暴動
胡蝶	蝴蝶
聲音宏亮	聲音洪亮
適當的生育	適當地生育
輪功行賞	論功行賞
勾劃	勾畫
淹沒無聞	湮沒無聞
憤發圖強	奮發圖強
爛熳	爛漫
班白	斑白
白璧微暇	白璧微瑕
評頭評足	品頭評足
首當其充	首當其衝
謀取暴利	牟取暴利
答覆	答覆
六根禮拜日	六跟禮拜日
渾玉樸金	渾玉璞金
啞雀無聲	鴉雀無聲
脫潁而出	脫穎而出
擠擠一堂	濟濟一堂
殞落	隕落
甘冒不諱	甘冒不韙
合盤托出	和盤托出
完壁歸趙	完璧歸趙
窮兵瀆武	窮兵黷武
因地治宜	因地制宜
治逾疾病	治癒疾病
做八八的公車	坐八八的公車
痲痹	麻痹
桀傲不馴	桀驁不馴
贏餘	盈餘
不加思索	不假思索
遣辭	遣詞
渲泄	宣泄
才陪吵醒	才被吵醒
稟承	秉承
材華	才華
闊老	闊佬
無計之談	無稽之談
紅虹	紅紅
暮藹沉沉	暮靄沉沉
羈靡	羈縻
漚心瀝血	嘔心瀝血
默守成規	墨守成規
臨摩書法	臨摹書法
照然若揭	昭然若揭
解我的朋友	請我的朋友
獨擋一面	獨當一面
開時	開始
入不付出	入不敷出
弘旨	宏旨
錯落有制	錯落有致
份內	分內
度過難關	渡過難關
一刀兩段	一刀兩斷
頂力相助	鼎力相助
信口詞黃	信口雌黃
材華橫溢	才華橫溢
如梗在喉	如鯁在喉
令人目炫	令人目眩
記憶尤新	記憶猶新
尉然成風	蔚然成風
不智道	不知道
痲疹	麻疹
褡連	褡褳
淄銖必較	錙銖必較
地大物搏	地大物博
九洲	九州
吹毛求刺	吹毛求疵
彬彬有理	彬彬有禮
驃悍	剽悍
聯綴	連綴
幾希	繼續
好高務遠	好高騖遠
漂涼	漂亮
妄費心機	枉費心機
羅唆	囉唆
打篹	打算
出你	祝你
預聞	與聞
在考	在烤
慘澹	慘淡
應爲	因爲
壇花一現	曇花一現
產玲	產齡
所以問題	所有問題
自抱自棄	自暴自棄
傾刻之間	頃刻之間
一幅手套	一副手套
讓後	然後
尚待商確	尚待商榷
裝做	裝作
骨瘦如豺	骨瘦如柴
共喜	恭喜
和一點飲料	喝一點飲料
不咀導	不知道
相對的提高	相對地提高
湖塗	糊塗
起迄	起訖
振濟災民	賑濟災民
跳五	跳舞
搳拳	划拳
有條不穩	有條不紊
補靪	補丁
頒白	斑白
寫作題綱	寫作提綱
賜與	賜予
在過幾十年	再過幾十年
沉緬	沉湎
絣幹	餅乾
延申	延伸
年經人	年輕人
功虧一匱	功虧一簣
祕密歪斜	祕密外泄
無禮漫罵	無禮謾罵
提昌	提倡
恨票亮	很漂亮
陸行	旅行
食不裹腹	食不果腹
步履維堅	步履維艱
百頁窗	百葉窗
慢說	漫說
披星帶月	披星戴月
免爲其難	勉爲其難
推託責任	推脫責任
公作	工作
一攬子貨幣	一籃子貨幣
進一份力	盡一份力
希罕	稀罕
傢俱	傢俱
酒中滲水	酒中摻水
誇誇奇談	誇誇其談
兩軍對恃	兩軍對峙
發號司令	發號施令
妝束	裝束
九洲方圓	九州方圓
庸庸碌錄	庸庸碌碌
厭力	壓力
寒顫	寒戰
沙鍋	砂鍋
受予勳章	授予勳章
紛至踏來	紛至沓來
瞅天	秋天
膺品	贗品
細枝末結	細枝末節
單初	當初
抱見阿	抱歉啊
公課	功課
吃裏爬外	吃裏扒外
中文殼	中文課
老驥伏瀝	老驥伏櫪
不頸而走	不脛而走
份公司	分公司
樂與減少	樂於減少
成下之盟	城下之盟
樂孜孜	樂滋滋
不辨黍麥	不辨菽麥
奮鬥終身	奮鬥終生
籌馬	籌碼
梗咽	哽咽
官運享通	官運亨通
層巒疊障	層巒疊嶂
前倨後躬	前倨後恭
愛烏及屋	愛屋及烏
一槌定音	一錘定音
仗義直言	仗義執言
玩皮	頑皮
不記其數	不計其數
盡心極力	盡心竭力
猩猩作態	惺惺作態
惹事生非	惹是生非
落漠	落寞
挑了	跳了
討潤以下	討論一下
萬變不離其中	萬變不離其宗
屯積居奇	囤積居奇
一鼓足氣	一鼓作氣
脈博	脈搏
行蹤鬼祕	行蹤詭祕
利害	厲害
反雲覆雨	翻雲覆雨
負貴	富貴
膾灸人口	膾炙人口
刮刮叫	呱呱叫
呼吃	呼哧
精精業業	兢兢業業
這末	這麼
相對的減少	相對地減少
持續的下降	持續地下降
通情達禮	通情達理
戊戍變法	戊戌變法
希世	稀世
直言不違	直言不諱
寒喧客套	寒暄客套
吃涼	吃驚
呱呱墮地	呱呱墜地
模範事績	模範事蹟
造謠裝騙	招搖撞騙
福份	福分
日字	日子
位於	爲於
理曲詞窮	理屈詞窮
忍勞任怨	任勞任怨
付其責	負其責
漂漂亮亮地風景	漂漂亮亮的風景
朗朗稱道	琅琅稱道
一付中藥	一服中藥
餘勇可沽	餘勇可賈
寬弘大量	寬宏大量,寬洪大量
遠見灼識	遠見卓識
水份	水分
幫別的學生的芒	幫別的學生的忙
亙多醫療費用	更多醫療費用
居爲己有	據爲己有
無艱不摧	無堅不摧
鴻圖	宏圖
前撲後繼	前仆後繼,前赴後繼
碑帖臨摩	碑帖臨摹
強駑之末	強弩之末
無與論比	無與倫比
單獨二胎	單獨二孩
一望無銀	一望無垠
演譯歸納	演繹歸納
照像	照相
浮想連翩	浮想聯翩
把勢	把式
寬洪大量	寬宏大量
盤據	盤踞
設麼	什麼
批沙揀金	披沙揀金
義無返顧	義無反顧
飲鳩止渴	飲鴆止渴
洽如其分	恰如其分
熙熙嚷嚷	熙熙攘攘
思惟	思維
報籌	報酬
桃梨滿園	桃李滿園
怎麼楊	怎麼樣
綠草如蔭	綠草如茵
一股作氣	一鼓作氣
形像代言人	形象代言人
糾糾武夫	赳赳武夫
提共	提供
裝禎	裝幀
飄颻	飄搖
針貶	鍼砭
學習肆業	學習肄業
百步串楊	百步穿楊
形影相掉	形影相弔
騰挪跌蕩	騰挪跌宕
遮天避日	遮天蔽日
蕭灑	瀟灑
懸樑刺股	懸樑刺骨
頂禮模拜	頂禮膜拜
竭澤而漁	竭澤而魚
鋒芒必露	鋒芒畢露
七點鍾	七點鐘
越來越底	越來越低
魚網	漁網
贊不決口	讚不絕口
嚎咷	號啕
雕敝	凋敝
渺遠	邈遠
材疏學淺	才疏學淺
按部就班	按步就班
倘佯	徜徉
估停站	古亭站
宥於成見	囿於成見
聯貫	連貫
嫁裝	嫁妝
誇大其辭	誇大其詞
一倡百和	一唱百和
修系	休息
三翻兩次	三番兩次
宵衣幹食	宵衣旰食
姿意胡爲	恣意胡爲
宿興夜寐	夙興夜寐
神彩飛揚	神采飛揚
打躬作輯	打躬作揖
粗鹵	粗魯
鬧烘烘	鬧哄哄
陳陳相應	陳陳相因
雕徹	雕砌
五采繽紛	五彩繽紛
如法泡製	如法炮製
淌水過去	蹚水過去
一長爭段	一長爭短
挖牆角	挖牆腳
策畫	策劃
通輯	通緝
一間一間的關必	一間一間地關閉
測天	這天
朦懂無知	懵懂無知
過尤不及	過猶不及
向偶而泣	向隅而泣
直言不晦	直言不諱
心力絞碎	心力交瘁
誓辭	誓詞
迭牀架屋	疊牀架屋
科頭洗足	科頭跣足
馳聘疆場	馳騁疆場
情你	請你
自顧不遐	自顧不暇
黑鼓隆咚	黑咕隆咚
提心掉膽	提心吊膽
洋琴	揚琴
萎頓	委頓
軍事部暑	軍事部署
洗煉	洗練
相對得	相對地
續承	繼承
暇瑜互現	瑕瑜互現
些日會	生日會
收伏	收服
風友	朋友
銷髒滅跡	銷贓滅跡
欷歔	唏噓
發揚廣大	發揚光大
二簧	二黃
飄邈	縹緲
憑心而論	平心而論
開中明義	開宗明義
洗耳躬聽	洗耳恭聽
浪廢金錢	浪費金錢
眼晴	眼睛
常年累月	長年累月
在加上	再加上
民生凋蔽	民生敝蔽
口株筆伐	口誅筆伐
烏煙髒氣	烏煙瘴氣
開源截流	開源節流
寧死不曲	寧死不屈
總視	總是
北老師罵他	怕老師罵他
儒子可教	孺子可教
家重	加重
顫慄	戰慄
翁聲翁氣	甕聲甕氣
帳本	賬本
牽就	遷就
兵慌馬亂	兵荒馬亂
遷徒	遷徙
義正辭嚴	義正詞嚴
躁熱	燥熱
括大風	颳大風
毫無疑議	毫無疑義
玩的橫高興	玩得很高興
改斜歸正	改邪歸正
橫度長江	橫渡長江
專程竭見	專程謁見
草木雕零	草木凋零
寥廖無兒	寥寥無兒
讀哩	獨立
不郎不莠	不郎不秀
爛竽充數	濫竽充數
惰胎	墮胎
美崙美幻	美輪美奐
可做籃本	可做藍本
標柄千古	彪柄千古
即史	即使
一丘之鶴	一丘之貉
身提	身體
搬門弄斧	班門弄斧
除舊補新	除舊佈新
終生大事	終身大事
新家坡	新加坡
秣馬礪兵	秣馬厲兵
怎嚜	怎麼
天經地儀	天經地義
証明	證明
一但	一旦
胞子	孢子
嬌傲	驕傲
驕揉造作	矯揉造作
來不起	來不及
股分	股份
若及若離	若即若離
心勞力絀	心勞力拙
呵腰	哈腰
胡臭	狐臭
板球	棒球
世無前例	史無前例
現再	現在
草官人命	草菅人命
語無侖次	語無倫次
交他的朋友	教他的朋友
以身徇職	以身殉職
臺我無聊	太過無聊
醍醐貫頂	醍醐灌頂
氣喘吁噓	氣喘吁吁
清等我	請等我
詞不達義	詞不達意
式式看	試試看
扶老偕幼	扶老攜幼
道理深粵	道理深奧
忍識	認識
老生長談	老生常談
誼起	一起
不貶眼	不眨眼
器度不凡	氣度不凡
忠貞不逾	忠貞不渝
睡過頭把	睡過頭吧
坐以待毖	坐以待斃
不共帶天	不共戴天
待價而估	待價而沽
豫備	預備
賙濟	賙濟
隱隱綽綽	影影綽綽
黑鴉鴉	黑壓壓
響徹雲宵	響徹雲霄
繼往不究	既往不究
眼花撩亂	眼花繚亂
婷婷玉立	亭亭玉立
不浮衆望	不孚衆望
明辯是非	明辨是非
得意揚揚	得意洋洋
倒打一把	倒打一耙
條分縷拆	條分縷析
簽字蓋戮	簽字蓋戳
硬幫幫	硬邦邦
一相情願	一廂情願
直接了當	直截了當
紓緩	舒緩
定閱	訂閱
宿願	夙願
傅會	附會
畢路藍縷	篳路藍縷
事必恭親	事必躬親
助肘爲虐	助紂爲虐
變的更良好	變得更良好
撥蘭	波蘭
圖謀不規	圖謀不軌
揠旗息鼓	偃旗息鼓
攙雜	摻雜
