冽	洌烈獵裂列劣鬣捩	咧
菊	橘跼掬鞠侷桔局	拒拘懼鋸巨颶居莒遽疽齟倨劇苣屨句具鉅聚踞駒狙蛆舉車據沮瞿距足炬俱咀矩
猙	癥諍爭徵丁掙箏怔睜崢錚症蒸正	政整拯掙幀証鄭證症正
坦	袒毯	探碳覃貪罈歎談坍攤癱嘆炭彈曇痰潭譚灘壇檀
檣	牆彊戕薔強	鎗槍嗆繈將鏘搶腔羌強
誤	鎢惡戊勿悟塢霧騖物寤軏堊兀晤務	無巫毋圬屋梧嫵惡舞汙烏吾誣鎢吳五侮鼯於蕪捂鵡憮嗚蜈午亡武伍污唔
塌	他牠漯它獺遢遝榻她踏蹋撻躂	他塔牠漯它獺遢遝榻她踏蹋撻躂
搖	瑤姚榣崤窯僥遙謠餚爻洮堯淆	吆藥腰麼要妖窈樂舀鷂杳耀邀拗曜夭咬鑰喲
奎	夔葵睽魁揆逵	匱愧窺盔餽虧喟傀簣潰
癲	滇巔顛	奠甸店點碘典靛玷佃惦電鈿澱殿墊
櫓	滷魯擄鹵虜	蘆路盧露臚鑪鹿鱸麓戮顱僇爐碌氯嚕鷺廬陸錄穋祿瀘賂
務	鎢誤惡戊勿悟塢霧騖物寤軏堊兀晤	無巫毋圬屋梧嫵惡舞汙烏吾誣鎢吳五侮鼯於蕪捂鵡憮嗚蜈午亡武伍污唔
寢		擒嶔禽欽沁侵芹噙勤秦琴親撳
燜	懣悶	們悶門捫
鑤	鉋暴爆鮑報抱刨豹	雹葆堡包褓褒飽胞寶保苞薄
粕	醱破迫泊珀魄樸	剖婆陂波叵鄱潑坡頗
興	性腥倖杏馨幸悻猩姓惺星	行杏型姓馨形邢醒腥硎性倖省悻惺星幸猩陘刑
婷	廷霆蜓停亭庭	聽廳挺汀梃艇
轡	珮配佩沛	壞裴呸陪培胚賠
天	添	舔恬腆忝靦闐田畋填甜
始	矢史豕屎使駛	濕詩室十恃施螫筮師匙提奭實勢嗜舐豉射市食士事仕拭碩拾識蝕試世釋柿逝是適噓屍塒侍示時什飾溼軾獅失誓弒氏式蝨噬石使視
覦	盂妤隅娛榆愚魚逾禺輿愉褕蝓竽雩渝腴漁臾於諛圩餘餘瑜俞予歟萸於虞	瘉澦域瘀宇馭獄峪昱燠雨預迂語紆與煜齬慾噢芋育俞堉鬱豫羽毓裕禦籲嫗敔喻玉欲圉譽禺禹熨嶼癒寓愈諭圄御谷鬱淤遇庾聿尉予浴
昆	錕崑焜坤琨髡	困睏梱綑捆
俠	霞峽黠挾轄呷遐匣洽狎柙斜瑕狹暇	夏廈下嚇暇蝦瞎
檯	薹颱苔擡跆臺臺	泰苔汰態胎太
濕	獅師蝨詩屍失屍蝨施溼噓	拭豕恃軾是匙氏拾使視豉仕噬蝕誓筮室提嗜什逝屎舐式適柿飾奭士碩螫十弒市示試始塒石食實時勢侍世史識矢射事駛釋
陣	賑鎮鴆枕振朕娠震	疹禎榛枕斟箴真診偵砧貞針珍甄楨縝臻
淺	遣譴	倩乾鉛謙韆嵌歉錢纖潛愆籤塹搴仟千牽欠簽前遷鉗騫鈐黔箝幹虔縴阡
割	鴿胳歌疙戈擱哥	革格隔個膈合鬲蛤鉻骼閤箇閣咯鎘各郃葛
狩	授售壽受綬獸瘦	熟守首收手
洶	兄兇匈胸	雄熊
磷	鄰林淋遴痳燐轔琳鱗霖臨麟璘	吝凜藺賃躪懍
娶	趣取漆曲齲去	取趨渠驅砠趣劬漆曲齲衢去蛐區麴屈圈軀璩蛆嶇瞿
礫	荔琍儷痢例利厲欐莉曆勵瀝慄隸蒞釙蠣靂立礪壢粒唳力戾俐吏麗癘鬲溧笠歷酈	裏貍醴李離鯉釐黎罹禮漓理浬梨驪狸蜊俚娌邐澧麗蠡犁璃鋰喱籬犛裡哩
蕈	汛殉雋徇郡峻濬俊潠訓迅遜浚馴訊駿巽竣菌	燻潯巡窘徇薰循醺鈞龜軍馴勛尋君詢均璿洵荀勳旬
僭	件檻劍健見艦漸毽諫濺踐監箭間閒薦腱建鍵餞鑑鑒澗賤薦	箋縑兼姦韉漸殲奸囝艱柬檢簡濺減筧監間肩尖湔剪鹼瞼繭堅菅緘撿揀儉煎
齷	臥沃斡渥握	窩我萵倭渦
搓	撮蹉磋	厝錯撮措銼嵯挫
樊	藩煩釩蕃礬繁凡帆墦	犯反返蕃梵泛番汎幡販翻飯繙範氾帆
蠢		春脣醇鶉淳純
勦	較餃姣皎狡超腳抄僥繳鉸攪角絞鈔剿矯	潮教巢姣窖驕嬌焦詨椒交吵醮蕉朝礁較澆跤轎郊晁鮫膠校蛟叫嘲覺炒嚼
季	霽髻寄際繼繫稷薺技記忌騎悸覬劑紀計祭妓驥濟鯽芰暨洎薊系冀躋既	急唧疾脊跡即寂楫屐居伋績擠吉犄饑譏擊羈機及乩嫉積激己汲藉亟岌吃瘠奇給稽借棘箕級圾嘰戟麂躋蹟籍濟輯畸嵇幾其肌期集戢飢雞極癘璣基磯畿姬勣
導	蹈盜悼道到稻島搗禱倒	蹈盜悼道到稻島搗禱叨刀倒
龍	聾窿籠矓隆瓏朧嚨	隴攏壟
錐	追椎隹	贅綴墜惴
畢	庇埤幣裨箄襞篦蔽鄙必弊斃比蹕碧詖鉍賁陛避壁嗶闢璧臂敝痺愎泌睥婢薜閉祕弼俾	逼鄙匕筆鼻沘比妣彼
燕	釅雁宴研艷殷硯嚥菸奄咽厭贗沿湮彥諺煙驗堰焰燄嫣焉唁醃淹豔饜胭晏	言釅雁宴兗演研艷殷硯嚥鹽菸奄顏厭巖咽簷閻贗沿眼湮彥諺煙偃魘驗堰郾焰延筵儼燄嫣焉嚴炎唁醃淹衍豔妍鼴饜掩癌胭晏
敘	序恤緒酗續卹蓄畜絮婿頊旭勗洫	鬚咻噓訏栩須戌胥墟籲煦虛需徐許
侷	跼掬桔菊局鞠橘	苣炬颶具巨疽鉅倨劇遽屨距俱狙聚據齟咀莒舉懼踞瞿蛆車駒拘句鋸沮足拒居矩
底	氐牴邸詆抵砥柢	氐笛嘀娣犒敵第地遞翟迪棣締帝狄嫡的低滌弟芽荻蒂鏑滴諦
鱉		彆癟別
出	齣初	杵絀櫥跦楮觸矗楚廚黜除鋤歜畜雛處躇礎怵褚芻儲
予	敔與魚諛宇雨雩竽禹愚禺虞齬蝓噢盂圉逾褕圩渝語萸漁瑜庾輿嶼歟於腴妤隅愉覦羽臾餘榆圄俞娛	與諛虞鬱尉癒逾玉語漁谷輿於愈聿妤隅羽獄淤堉榆譽覦瘀熨宇雩竽愚寓蝓萸昱紆峪預豫域愉臾遇慾禦俞娛芋馭御喻魚育雨禹瘉迂齬噢圉褕諭澦渝瑜庾裕嶼腴嫗籲餘圄敔禺盂圩煜欲歟毓浴燠
鞦	蚯丘邱龜秋鰍	仇毬酋泅求裘球梂囚
瑚	壺鬍鵠蝴胡糊湖葫囫弧斛狐	瓠互琥虎扈許惚唬乎戲呼戶忽滬楛沍護
鶴	蠔蚵嗥赫賀號暍郝毫貉濠嚇荷和豪嚎壕喝	褐劾訶曷蒿荷禾郃何鎬號郝嗑耗河閤呵皓顥閡涸闔好昊盒鄗盍翮核合紇浩貉和蓋喝
沛	佩珮轡配	培裴陪賠胚壞呸
撇	瞥	瞥
僥	攪矯餃餚洮淆狡瑤崤剿搖爻較勦鉸姚榣腳遙絞謠繳堯窯姣皎角	礁醮吆澆藥嚼焦腰麼跤蕉嬌教要妖椒交窈叫覺轎樂郊較舀鷂杳窖膠耀邀蛟鮫拗曜驕校夭姣詨咬鑰喲
吋	寸	忖皴村存
乃	迺氖奈奶	耐奈
汁	脂梔之泜芝胝枝吱祇肢支祗只卮織隻蜘知氏	智徵制植痔直致摭製蛭址躓質窒雉值躑擲峙祉幟祇趾稚執職炙痣識咫置輊只至殖滯紙芷止秩摯知姪指緻治志旨誌
況	眶曠礦框壙	誑劻匡筐狂框
寞	膜末貊莫磨陌默墨驀沫秣脈茉漠沒歿	膜抹蘑摩摸磨模糢謨魔摹麼
遵	尊樽	俊撙圳
窠	軻科柯刻顆蚵苛瞌稞棵蝌磕	嗑課客恪溘坷渴剋髁可咳喀殼緙克刻
箏	癥諍爭徵丁猙掙怔睜崢錚症蒸正	政整拯掙幀証鄭證症正
氏	脂室恃螫梔筮之奭勢嗜舐豉市泜士芝事仕胝枝拭吱祇肢支祗識汁試世只釋柿逝是織適卮侍隻示飾軾蜘誓弒知式噬使視	制植施製射躑祉祇幟趾執炙咫輊殖噓止獅知始至治實使濕智徵師致史矢躓食值稚碩痣蝕駛滯塒豕失秩摯指石蝨詩屎直摭匙提蛭雉峙職拾識置紙什溼志旨十痔址質窒擲只屍芷時姪緻誌
衷	終忠鐘盅忪鍾中	湩種仲重衆腫眾中塚踵
類	擂累淚	擂雷壘耒漯儡嫘縲羸蕾勒鐳磊累
埤	必璧陂疲嗶沘斃琵俾陛賁啤鄙蹕脾篦皮祕枇陴鈹比紕毗幣弊鉍敝薜痺箄避襞臂庇畢愎碧鼙泌蔽詖闢閉弼婢壁罷睥裨	劈披筆譬仳匕否沘妣壞僻逼癖批闢鄙匹媲丕霹痞彼闢鈹比屁被紕疋鼻
扣	寇叩佝釦	口
彙	諱惠晦喙蕙燴慧繪穢彗賄會卉匯誨潰	麾恢詼蟲茴暉毀墮灰揮燬賄虺輝悔回會徽迴蛔誨
慢	鏝曼縵漫蔓幔	饅鰻屘蹣漫蠻瞞滿
應	瑛嚶映英瓔嬰鸚鶯硬膺櫻纓鷹罌	穎盈瑛嚶瓔楹迎櫻纓嬴熒螢贏營嬰映瑩鸚鶯縈膺鷹罌蠅瀛郢英景塋硬影
歿	默沒秣漠陌膜磨末寞脈貊墨茉驀沫莫	磨摹模摩摸抹糢麼蘑謨魔膜
常	腸嘗嫦嚐徜萇場裳償長	暢鯧敞悵娼氅昌場猖唱倡倀廠
鋁	呂褸履膂屢旅婁侶縷	慮閭率氯綠驢濾律櫚
蜂	豐諷峯風鋒楓封烽瘋	俸諷逢縫馮鳳奉
膈	郃革隔格咯骼閣閤葛鬲鎘蛤	哥歌各戈疙個箇鉻擱割胳葛鴿
妃	菲霏啡非飛扉	費菲痱斐屝肥翡沸腓誹吠怫廢肺芾匪
般	胖扳班頒玻磐菠瘢蟠槃播搬斑踫盤缽蹣剝撥	卜畔鈸博版蔔鉑板阪駁扮攀盼鈑箔闆荸潘脖半舨搏蘗叛瓣跛檗播拌渤拚帛薄亳白伴辦柏絆判膊姅薜勃泊簸伯舶擘
魄	珀迫破樸泊粕醱	叵波鄱陂剖潑婆坡頗
緊	饉覲僅瑾盡儘謹錦	金噤浸晉覲勁縉矜津燼禁斤襟今觔巾僅盡儘近筋進
岱	迨大貸黛怠逮待玳帶殆代戴袋	逮待歹呆
療	聊嘹潦寥撩寮繚遼燎僚	料撩暸了燎瞭廖
皖	宛輓晚綰碗莞蜿娩緩婉挽	惋桓彎灣丸完歡蜿腕環澴煥汍豌剜瘓渙還幻換鍰莞頑喚萬宦患奐玩豢洹梡寰
酪	落洛絡烙咯駱犖珞雒勞	佬騾鏍撈囉姥勞玀牢螺羅嘮蘿籮老癆裸鑼儸邏
璜	韹湟隍磺蝗皇徨凰篁簧黃煌遑惶	幌肓謊洸荒慌晃恍
苔	跆颱薹臺擡檯胎	泰汰跆颱薹臺太態擡檯胎
琅	螂狼郎廊瑯榔	浪朗
麟	痳霖鱗林鄰燐淋磷轔遴臨琳璘	吝懍躪藺凜賃
砲	泡皰炮	炮咆拋庖刨袍匏跑
襬	百擺佰	白拜敗
儕	柴豺	釵拆差
席	惜習檄褶錫息媳襲蓆昔熄	細悉禧行谿羲繫嬉晰蟋釐洗吸唏曦隙希蹊稀淅溪矽畦奚鰓係翕犧譆熙夕攜烯析西兮嘻僖蜥晞棲璽系汐膝潟戲犀熹徙喜歙
扮	半姅伴辦瓣絆拌	頒搬斑扳舨版板般瘢阪班鈑闆
淆	瑤姚榣崤窯僥遙謠搖餚爻堯洮	吆藥腰麼要妖窈樂舀鷂杳耀邀拗曜夭咬鑰喲
僵	江薑疆姜將繮漿韁	獎絳彊槳蔣講將強醬匠降
輪	侖掄綸淪論崙倫	掄論
禽	擒芹勤秦琴噙	嶔寢欽沁侵親撳
饉	覲謹瑾緊錦僅儘	盡金燼晉矜噤津禁僅勁儘筋襟覲縉觔斤浸進近巾今
賬	瘴脹丈帳障仗長杖漲幛	璋蟑樟獐掌彰章張長漲漳
怕	帕	葩琶爬趴扒耙啪杷
壩	灞霸耙伯罷爸	笆吧鈸琶疤拔芭捌巴靶扒把跋罷叭八杷
鐵	帖	餮帖貼
韃	瘩答達靼怛	瘩答搭大打褡躂
匈	兄兇洶胸	雄熊
冒	瑁茂懋貌耄貿帽	茅茆卯髦泖毛貓矛錨
嘍	樓婁螻髏	簍瘺鏤摟露漏陋
褻	蟹邂榭屜解洩屑駭卸械瀉懈謝契燮楔洩紲	攜協歇寫邪斜些挾諧蠍偕鞋擷頡血脅勰
靂	荔琍儷痢例利厲欐莉曆礫勵瀝慄隸蒞釙蠣立礪壢粒唳力戾俐吏麗癘鬲溧笠歷酈	裏貍醴李離鯉釐黎罹禮漓理浬梨驪狸蜊俚娌邐澧麗蠡犁璃鋰喱籬犛裡哩
垠	夤吟銀鄞齦淫簷寅霪	癮聽胤印飲因尹茵音湮姻陰縯慇氤蔭殷隱引蚓
賻	富腹馥覆附副傅復付複赴婦咐父阜賦負駙訃	氟縛匐膚鈇俯府腑夫腐頫蝠紼扶甫幅芾孚弗輻紱福袱浮伏符菔釜敷拂涪撫怫斧孵莆趺輔彿服父麩脯芙伕俘
絮	序恤旭緒酗續卹蓄畜敘婿頊勗洫	鬚咻噓訏栩須戌胥墟籲煦虛需徐許
甩		蟀率衰摔帥
拷	考烤	犒靠銬
杆	幹肝竿甘柑感趕敢稈橄	感趕敢稈橄幹肝竿甘柑
崔	催衰摧	淬粹悴萃璀瘁橇翠脆
街	皆階偕結接嗟揭	睫傑節櫛芥竭姐潔捷姊頡疥擷戒結桔孑藉羯桀借劫拮碣界解訐介屆詰誡截
懺	儳羼	攙禪蟾嬋巉鏟饞剷摻諂讒澶孱潺蟬毚單纏闡產
撢	膽疸	簞誕丹淡蛋石憚彈但啖啗氮旦擔耽單澹
簾	憐漣奩簾蓮濂鐮聯鰱連廉	瀲煉楝斂鏈臉鍊戀殮練
拆	差釵	柴儕豺
日		
跦	雛儲鋤除櫥躇芻廚	矗齣出畜黜儲絀杵礎楮怵褚處歜楚觸初
燦	孱璨	慘參蠶餐慚殘
染	苒冉髯	然髯燃
尼	霓倪泥呢怩妮	你溺暱膩妳逆泥擬旎匿睨
餵	位慰魏胃衛蔚謂未褽遺尉喂渭畏為味穌偽	尾娓維痿緯萎威韋唯惟濰圍桅為崴煨薇逶幃葦危偉洧帷鮪微巍偎闈猥諉違委
肉		柔鞣揉蹂
劫	睫傑節櫛竭潔捷頡擷結桔孑羯桀拮碣訐詰截	芥姐揭姊疥階戒結藉接皆借偕界嗟解介街屆誡
氤	湮陰姻因慇茵音殷	夤癮聽胤銀印鄞飲齦尹淫簷寅垠吟縯蔭隱霪引蚓
澎	蓬膨硼彭朋棚鵬抨篷烹砰	蓬膨彭捧朋棚鵬抨碰篷硼烹砰
芍	勺杓韶	少捎哨紹燒梢邵稍召
濠	貉毫嗥蚵壕豪鶴蠔嚎號	皓昊浩蒿鎬郝顥鄗好號涸耗
份	分奮糞忿憤	棻分汾焚粉吩芬紛墳氛
迤	尾姨咦椅蟻飴旖誼偯栘移以夷彝已遺沂宜頤疑乙怡貽訑迆蛇矣胰圯儀一痍倚	漪蟻藝屹肄軼刈誼囈移縊以逸彝夷佾已溢沂宜劓醫疫頤疑噫乙懿鎰毅揖義訑迆蛇邑億液役佚儀易羿倚姨咦尾弋裔蜴椅壹飴驛弈旖譯帟翌異益偯栘臆遺亦艾腋曳咿議詣意伊怡繹貽憶掖浥翳矣胰圯奕一翼抑痍衣依
譎	鴃掘鱖抉獗決蹶劂腳倔玨角攫爵孓崛觼覺蕨訣厥絕嚼噱	倔蹶嗟
綞	陲垂捶槌錘箠椎鎚	炊吹
獨	讀髑毒黷瀆櫝犢牘	度妒賭肚睹蠹嘟都督杜堵篤鍍渡
青	輕蜻清氫頃卿鯖傾	請親擎檠頃情晴磬傾慶罄
餛	琿混渾魂	葷輥混昏渾婚
株	諸誅朱珠茱豬銖蛛硃侏藷	軸蛀躅鑄渚助拄箸術注主囑薴祝築朮貯柱竺杼屬煮燭駐註矚佇逐竹住
點	碘典	靛滇鈿店澱奠電墊殿癲玷顛佃巔惦甸
葫	囫糊狐鵠胡鬍蝴壺湖弧斛瑚	戶滬虎沍扈乎瓠忽惚互琥唬戲護楛許呼
枋	芳坊方	放訪倣防妨舫坊肪仿彷紡房
仁	兒人任壬	刃任軔忍認荏賃稔飪韌紉仞妊衽
森		
東	冬鼕咚	董凍胴動恫洞棟懂
配	佩珮沛轡	培裴陪賠胚壞呸
及	急唧疾脊即寂楫伋吉擊嫉汲亟岌藉吃瘠借棘圾級籍輯戢集極	唧霽髻寄脊跡際繼冀繫屐居績稷擠犄薺饑譏技記忌羈騎機乩激積覬己悸劑紀季奇給稽既箕計嘰祭戟麂妓蹟躋驥濟鯽畸嵇幾其肌芰期飢癘雞暨洎璣基薊系磯畿姬勣
嘿	黑	黑
簷	炎夤延研閻妍癌銀鄞齦淫寅沿簷鹽垠顏吟筵巖嚴言霪巖炎延研閻妍癌簷沿鹽顏筵巖嚴言巖	豔堰茵儼雁慇硯眼因彥煙音沿燕醃陰厭縯氤燄宴演聽飲焰尹菸諺驗衍醃湮掩魘姻贗郾咽艷殷引晏研偃癮胤印兗奄嚥胭鼴饜釅淹焉蔭嫣隱唁蚓豔堰焰儼諺菸雁驗衍魘掩湮醃贗郾咽艷殷硯晏偃研兗眼嚥奄彥煙胭沿燕鼴醃饜釅厭淹燄焉演嫣宴唁
鍥	契妾竊切挈愜怯	伽切茄且
謠	瑤姚榣崤窯僥遙搖餚爻洮堯淆	吆藥腰麼要妖窈樂舀鷂杳耀邀拗曜夭咬鑰喲
跚	扇姍縿刪山舢煽杉衫羶珊潸芟	鱔扇膳禪擅疝訕繕汕贍煽善閃單陝
抉	鴃掘鱖決獗譎蹶劂腳倔玨角攫爵孓崛觼覺蕨訣厥絕嚼噱	倔蹶嗟
車	拘疽沮鋸駒狙居俱蛆	橘拒坼菊撤徹懼鋸扯巨炬颶鞠莒遽澈跼齟掣倨劇苣桔屨局句具鉅聚踞舉據沮轍掬瞿距足侷俱咀矩
四	泗伺兕嗣俟巳食耜祀駟賜寺似飼肆姒	嘶絲思斯廝死私司鷥撕
雪	削血穴	血靴削穴噱薛學
濺	餞澗尖劍鑒閒堅毽艱菅諫箭緘僭踐韉艦件健湔建殲肩間檻見煎姦監賤縑薦腱奸兼漸鑑鍵箋	餞澗鑒劍儉尖閒堅毽艱減菅諫箭緘僭踐韉柬艦件健湔建撿簡殲瞼肩筧揀間檻繭見煎姦剪鹼檢監賤縑薦腱奸囝漸兼鑑鍵箋
纔	裁財才材	蔡採綵睬彩採猜菜踩
釘	盯丁叮訂定仃酊錠	盯頂丁叮訂定仃酊鼎錠
衆	中種重仲	忠盅腫衷終鍾
詹	譫佔氈霑瞻沾	嶄湛站暫展戰顫佔盞佔斬輾綻棧蘸
敔	雨語與宇庾噢齬圉禹予嶼羽圄	瘉澦域妤娛瘀馭獄逾峪昱燠褕蝓竽雩渝覦預漁迂語於與紆煜慾芋育餘餘俞歟堉鬱豫毓虞裕盂禦隅籲嫗榆喻愚魚玉欲譽禺熨輿癒寓愈愉諭御谷鬱淤腴臾遇諛圩聿尉瑜予萸浴於
刑	行硎型陘形邢	醒性腥興倖杏姓省幸悻猩馨惺星
視	室恃螫筮奭勢嗜舐豉市士事仕拭識試世釋柿逝是適侍示飾軾誓弒氏式噬使	濕詩十施屎師史匙提矢射食碩拾蝕駛塒屍噓時什溼豕獅失始蝨實石使
州	啁舟洲週粥周	妯縐皺軸帚胄咒宙肘冑籀晝紂
坼	撤徹掣澈轍	車扯
後	逅厚候後堠鱟	猴吼篌侯喉
茱	誅硃銖蛛豬諸朱藷侏珠株	主軸杼薴註築柱矚囑朮築屬燭煮鑄住渚助竹竺佇蛀拄箸貯駐躅逐注祝
咪	瞇	密糜迷麋謎糸弭靡瀰米蜜冪覓泌敉汨祕彌謐
痊	荃蜷銓卷權全詮犬泉佺拳踡	券畎圈甽犬勸
菔	氟縛匐夫蝠紼扶芾幅孚弗輻紱袱福浮伏符拂涪怫彿服芙俘	富馥覆附膚俯鈇複府夫腑腐頫甫阜腹賻副傅復釜敷付撫斧孵赴婦莆趺輔咐父麩脯賦負駙伕訃
洗	鰓徙喜璽	細悉禧行谿羲繫席嬉晰蟋惜昔吸釐唏曦隙希褶蹊稀淅溪襲矽習畦奚係翕犧譆熙夕攜烯析西蓆熄兮檄嘻僖蜥晞棲息錫系媳膝汐戲犀熹潟歙
玀	騾羅螺籮蘿鑼儸囉邏鏍	烙珞駱洛酪咯絡雒囉犖裸落
瑾	覲謹饉緊錦僅儘	盡金燼晉矜噤津禁僅勁儘筋襟覲縉觔斤浸進近巾今
賡	更粳羹庚耕	更耿埂梗亙哽
椰	耶爺琊	葉耶噎冶業野曄射也頁謁鄴靨夜咽拽
莎	娑鯊裟煞簑沙殺梭杉砂嗦縮唆紗蓑	鎖傻所霎瑣廈索煞
嘐	梟逍囂哮消削硝銷霄驍簫蕭瀟宵	效笑小嘯校肖傚酵孝學篠曉
僧		
臧	贓髒臢	藏臟葬奘
蜩	條佻調迢	頫眺挑覜窕跳
狙	車駒俱拘疽鋸沮居蛆	苣炬颶具桔巨鉅倨劇遽屨距俱侷掬聚據齟咀莒舉懼踞瞿橘跼局句菊鋸沮足鞠拒矩
殮	鍊戀瀲斂練煉鏈楝	簾蓮聯簾鰱濂連奩漣憐鐮廉臉
竄	爨篡	
坡	波陂潑	叵珀迫鄱剖破樸婆泊魄粕頗醱
潟	翕戲夕隙係繫矽系汐歙細	攜烯嬉蓆膝惜璽洗溪析媳棲息蟋羲錫蹊昔褶曦淅悉熹禧犀行蜥稀希吸習徙晰畦兮鰓熙釐喜谿譆犧唏晞嘻西席奚熄襲僖檄
豌	彎蜿灣莞剜	萬玩蜿宛碗莞輓汍婉頑晚娩腕綰皖惋挽丸完
求	毬裘梂酋仇囚球泅	丘龜鰍秋蚯邱鞦
周	啁州洲週粥舟	妯縐皺軸帚胄咒宙肘冑籀晝紂
純	醇鶉脣淳	春蠢
鉀	夏賈假甲胛	稼加架家茄駕嘉賈假價嫁葭頰傢豭佳戛迦袈莢痂挾夾浹
瑛	纓應嬰罌英鷹嚶鶯瓔櫻膺鸚	瑩景郢迎營映贏盈熒應縈嬴穎塋楹蠅瀛硬影螢
博	卜鈸蔔鉑駁箔荸脖搏檗渤帛薄白柏膊勃泊伯舶	玻菠薄亳般薜擘蘗簸檗剝跛缽播撥
賄	會彙蟲彗穢繪燴蕙潰匯卉虺燬毀諱惠慧悔晦誨喙	蛔會彙蟲彗詼燴潰蕙繪穢輝匯茴揮卉虺回燬麾徽灰毀諱惠迴墮恢暉慧悔晦誨喙
重	湩種仲崇衆蟲眾中	憧充終舂種衷忠寵鐘沖盅忪腫衝鍾中塚踵
稔	荏忍	刃衽妊紉人仞兒軔任仁壬韌認飪賃
苗	描瞄	緲杪藐繆廟杳渺妙邈眇秒
宰	載仔	災栽載再哉在
艷	豔晏研堰焰嚥諺彥雁沿燕驗饜釅贗厭咽淹燄宴唁硯	閻癌儼菸簷衍魘掩湮醃郾咽殷巖炎延研偃妍兗眼奄煙簷胭沿燕鹽鼴醃顏筵巖厭嚴淹言焉演嫣
瓣	半姅伴辦扮絆拌	頒搬斑扳舨版板般瘢阪班鈑闆
簡	瞼揀筧柬繭儉囝剪減撿鹼檢	餞澗尖劍鑒閒堅毽艱菅諫箭緘僭踐韉艦件健湔建殲肩間檻見煎姦監賤縑濺薦腱奸兼漸鑑鍵箋
魑	嗤蚩癡癡笞吃喫	赤熾翅褫啻尺恥呎踟侈匙敕叱栘齒弛持馳斥池飭遲墀
搽	察查擦茶	詫岔喳叉剎插差
駑	奴	弩努怒
焊	瀚旱憾銲撼悍捍頷翰漢汗頜	韓鼾寒罕函含蚶榦酣涵和喊汗
儔	酬稠仇疇綢愁躊籌裯鯈惆	溴抽臭醜醜
午	嫵舞五侮武捂伍鵡憮	無巫毋勿騖寤軏圬屋梧誤惡物汙堊烏吾兀誣務鎢塢悟霧吳鼯於蕪晤嗚戊蜈亡污唔
錠	定釘訂	盯頂丁叮釘鼎酊仃
刻	科顆軻喀剋克苛恪嗑蝌磕緙棵稞柯蚵可課窠瞌溘客髁	科顆軻坷喀剋克殼苛恪嗑蝌磕緙柯稞蚵棵可課渴窠咳瞌溘客髁
形	行硎型陘刑邢	醒性腥興倖杏姓省幸悻猩馨惺星
聊	嘹潦寥撩寮繚遼燎僚療	料撩暸了燎瞭廖
嚶	纓應嬰罌瑛英鷹鶯瓔櫻膺鸚	瑩景郢迎營映贏盈熒應縈嬴穎塋楹蠅瀛硬影螢
楹	瑩縈嬴迎營塋贏蠅瀛盈螢熒	纓罌景郢鶯櫻映膺鸚嬰應瑛英鷹嚶瓔穎硬影
銷	簫宵霄嘐逍硝消梟削蕭驍哮囂瀟	曉校嘯小傚學笑酵孝肖效篠
刮	瓜蝸括聒呱颳	掛卦褂寡
噫	漪伊壹咿一揖醫衣依	蟻藝屹肄軼刈誼囈迤移縊逸以彝溢佾已夷沂宜劓疫頤疑乙懿鎰毅義訑迆蛇邑億液役佚儀易羿倚裔尾弋咦姨蜴椅驛飴弈旖譯帟翌異益偯栘臆遺亦艾腋曳議詣意繹怡貽憶掖浥翳矣圯胰奕一翼抑衣痍
鶸	篛若弱偌	
耙	灞琶爬霸扒壩伯罷爸杷	鈸芭把杷吧琶趴拔扒怕跋啪帕疤捌巴靶叭八笆葩罷
胚	壞呸	珮裴培轡配陪賠沛佩
啊	阿	阿
訓	迅徇潠汛巽遜訊殉馴蕈	徇循潯勛尋醺燻勳旬洵璿詢巡荀薰馴
徉	烊鍚佯揚瘍洋颺羊楊昜暘陽煬	泱養仰鴦怏殃央秧癢樣漾恙氧鞅煬
編	砭邊鞭蝙	辯扁遍貶變汴匾褊卞弁釆辨辮便
嫡	迪狄嘀笛犒荻的敵鏑滌芽翟	氐娣邸柢第地砥遞棣締帝的牴低抵弟蒂詆滴底諦
繭	瞼揀筧柬簡儉囝剪減撿鹼檢	餞澗尖劍鑒閒堅毽艱菅諫箭緘僭踐韉艦件健湔建殲肩間檻見煎姦監賤縑濺薦腱奸兼漸鑑鍵箋
鼇	熬鏖翱嗷遨聱敖	凹澳懊奧媼襖拗傲
綑	捆梱	睏髡琨困焜坤錕昆崑
緹	題堤蹄啼隄提	悌屜體剃嚏剔涕梯踢替銻逖惕
豫	芋與馭御喻育瘉寓禺鬱尉癒諭玉澦語煜欲谷裕昱愈聿峪嫗籲預浴域獄毓遇堉慾譽禦熨俞燠	與魚諛宇雨雩竽禹予愚禺虞迂齬蝓噢盂圉逾褕圩瘀榆渝語萸漁瑜庾輿嶼歟於腴紆妤隅圄愉羽臾餘淤覦敔俞娛
腋	詣劓羿浥異益議藝軼意刈鎰縊肄逸憶抑艾佚奕翌衣佾誼億役翳懿一掖屹易裔繹液弋帟邑曳溢臆翼亦囈蜴驛毅義譯弈疫	咿儀揖怡飴咦依姨迆痍胰頤以遺噫移乙矣蛇衣伊夷誼尾漪圯蟻彝已壹一醫沂旖栘倚迤貽椅訑宜疑偯
靠	犒銬	考烤拷
慧	匯繪賄卉潰諱會彙晦誨喙彗惠穢燴蕙	蛔賄會蟲詼輝茴揮虺回麾燬徽灰毀迴墮恢暉悔誨
澹	誕氮蛋淡石旦擔憚彈但啖啗	簞丹擔耽撢單膽疸
秩	智制痔致製蛭躓窒質雉峙幟稚炙痣識置輊至滯摯知緻治志誌	徵植脂梔直摭之址質泜芝值胝躑枝吱祉祇肢擲支趾執祗職汁咫只殖織卮紙隻芷止蜘知姪指氏旨
犖	烙珞駱洛酪咯絡雒落	騾羅螺籮蘿玀鑼儸囉裸邏鏍
工	躬供宮龔釭紅蚣公攻恭共肱功弓	供鞏汞礦共廾拱貢
鴻	訌紅弘黌閎虹泓洪宏	鬨烘哄薨汞轟
恐	孔倥	崆倥硿控空
勗	敘恤畜洫絮酗婿蓄卹頊緒續旭序	墟胥籲戌許須徐訏鬚煦需虛咻栩噓
影	穎郢景	盈瑛嚶瓔楹迎櫻應纓嬴熒螢贏營嬰映瑩鸚鶯縈膺鷹罌蠅瀛英塋硬
篇	翩扁偏	遍片胼騙便駢
娜	鈉那納訥挪吶捺	諾那糯拿懦哪
鏨	贊瓚暫讚	咱簪偺
淒	悽柒妻欺戚棲溪萋七谿漆慼	歧琪齊琦耆棋騎妻祺豈綺棄磧祁乞啟祇期器祈訖枝迄起錡氣其淇愒旗麒臍畦鰭崎圻杞汽奇岐衹企稽亟泣契憩砌緝
谿	攜曦淅熹悉烯禧嬉犀萋膝行蜥淒稀希妻吸欺溪晰畦兮析熙柒釐棲譆漆犧慼蟋唏羲嘻悽晞西奚戚蹊七僖	歧琪齊蓆琦耆棋騎惜妻璽祺洗豈綺細棄磧祁乞係啟祇期器媳祈訖枝息迄起夕錫歙錡褶昔氣其淇愒旗系汐麒翕戲隙習徙臍畦鰭崎鰓圻杞汽奇岐衹矽喜企稽亟潟泣契繫席憩熄砌緝襲檄
禾	褐劾曷荷郃和嗑河閤閡涸闔盒盍翮核合紇貉何蓋	訶賀鶴赫暍郝嚇荷和呵喝
創	窗瘡囪闖愴	撞牀窗瘡囪闖搶愴幢
珠	諸誅朱茱株豬銖蛛硃侏藷	軸蛀躅鑄渚助拄箸術注主囑薴祝築朮貯柱竺杼屬煮燭駐註矚佇逐竹住
鈷	菰凸鴣鵠罟賈鼓穀估呱轂孤股谷滑沽蠱牯蛄瞽咕辜古詁姑骨家	菰凸鴣鵠僱罟賈鼓穀顧估僱呱故轂孤股告谷滑沽牯蠱蛄瞽咕辜錮古詁姑固骨家
俳	排牌徘	派拍啪湃
護	戶滬沍扈瓠互楛	鵠虎葫惚唬湖許呼瑚壺弧鬍乎囫糊狐胡蝴忽琥戲斛
問	紊抆聞文汶免	穩雯聞文瘟刎蚊塭溫紋吻玟
素	溯嗉訴塑速縮粟蓿宿夙肅簌	囌酥蘇俗甦穌
沬	媚袂妹瑁魅寐昧	楣每沒莓枚媒美黴眉玫鎂煤梅湄黴
瞳	童桐同僮潼銅彤峒	統慟桶筒恫痛通
訕	鱔扇善膳禪擅疝單繕汕贍煽	扇縿姍刪山舢煽跚羶杉衫珊潸閃芟陝
疼	謄籐滕騰	
媧	蛙窪挖哇呱	娃襪瓦
品		貧頻顰嬪瀕聘拼牝姘
韌	刃任軔認賃飪紉仞妊衽	壬忍荏稔人任兒仁
度	妒肚蠹踱惰舵咄跺杜渡鍍剁墮馱	讀朵督毒堵牘睹奪嘟鐸瀆犢賭髑都躲黷篤肚獨櫝多
毋	吾亡誣無鼯梧唔巫吳蕪蜈	武汙鵡晤騖巫侮悟塢誤誣務午五烏伍寤戊惡嗚嫵於物勿憮霧屋舞兀圬鎢捂軏污堊
啦	拉喇	落拉臘蠟喇邋剌辣
稅	蛻睡說	誰水
囉	騾羅螺籮蘿玀鑼儸邏鏍	騾珞羅螺咯絡儸裸邏烙駱洛籮酪蘿玀鑼雒犖落鏍
覆	富腹馥賻附副傅復付複赴婦咐父阜賦負駙訃	氟縛匐膚鈇俯府腑夫腐頫蝠紼扶甫幅芾孚弗輻紱福袱浮伏符菔釜敷拂涪撫怫斧孵莆趺輔彿服父麩脯芙伕俘
手	首守	獸綬瘦收狩壽授售受熟
質	智植制痔直致摭製蛭躓窒雉值躑擲峙幟稚執職炙痣識置輊至殖滯秩摯知姪緻治志誌	智徵制脂植痔梔直致摭之製蛭址躓窒泜雉芝值胝躑枝吱峙祉幟肢支祇稚執祗趾職炙痣識汁咫置輊只至殖織卮滯紙隻芷止蜘秩摯知姪擲氏緻治志指旨誌
歪		舀外
鄰	林淋遴痳燐轔琳磷鱗霖臨麟璘	吝凜藺賃躪懍
材	才纔財裁	踩睬猜採菜綵彩蔡
着	卓昭嘲濁遮招朝茁灼拙酌啄琢召	桌趙罩宅找爪摘折兆哲浙這蔗者沼轍照捉
柒	七漆萋戚淒棲谿悽慼欺溪妻	器憩旗啟祈豈琦琪汽耆麒企錡起杞臍齊磧泣祁騎砌亟枝祇契棋畦奇稽訖啓迄只崎淇緝綺祺其期棄圻乞衹氣愒歧岐鰭妻
屝	費痱廢芾肺沸怫吠	菲斐肥翡非腓妃飛扉誹啡霏匪
耽	擔丹簞單	啗擔蛋氮啖但誕疸澹淡旦憚彈膽石撢
緝	汽愒器企訖迄亟泣契憩妻砌磧氣棄	歧其淇旗琪齊萋琦耆麒棋淒騎妻祺欺臍溪豈綺畦鰭祁崎杞圻乞奇岐啟期柒祇衹祈棲谿稽枝漆慼悽起戚七錡
濃	儂膿噥農穠	弄
畿	畸姬其璣羈肌犄飢癘雞磯乩幾唧積箕幾奇譏激績期屐機嵇跡勣稽蹟基躋嘰居饑	洎棘疾暨忌祭集脊己騎藉芰劑幾記楫瘠覬紀計級極妓冀戢擊寄輯寂給薊及嫉際幾唧麂繼擠急伋薺吉季圾即稷髻霽技汲吃亟既悸躋籍繫岌濟鯽戟驥
惚	乎戲呼忽	瓠壺鬍蝴鵠琥許斛唬戶滬沍楛護狐互胡湖囫葫扈虎弧瑚糊
龐	徬膀旁螃	磅胖滂乓
涼	亮輛良糧粱量晾諒樑	亮輛良晾兩糧魎粱量倆諒樑
曖	噯璦隘艾礙愛	哀藹埃捱唉靄矮皚挨哎
嬴	瑩縈迎營楹塋贏蠅瀛盈螢熒	纓罌景郢鶯櫻映膺鸚嬰應瑛英鷹嚶瓔穎硬影
矣	蟻迆已椅以乙旖倚尾迤偯	劓羿浥益藝軼鎰姨痍肄頤憶遺佚翌伊夷一屹栘貽溢臆囈訑疑咿揖議意刈依噫移蛇役圯億沂繹弋迤腋毅譯儀詣怡咦縊逸抑漪彝懿壹醫液帟翼義疫飴異胰艾奕衣佾誼翳掖易裔邑曳亦蜴驛宜弈
當	儅擋噹襠盪鐺蕩	讜儅黨擋噹襠盪檔鐺蕩
臻	禎診貞真針楨斟珍砧偵榛甄箴	震陣娠鴆診枕縝鎮朕賑振疹
嗆	鎗槍鏘將搶羌腔	薔鎗戕槍彊鏘將強繈搶羌牆腔檣
訖	汽愒器企迄亟泣契憩妻砌緝磧氣棄	歧其淇旗琪齊萋琦耆麒棋淒騎妻祺欺臍溪豈綺畦鰭祁崎杞圻乞奇岐啟期柒祇衹祈棲谿稽枝漆慼悽起戚七錡
菟	兔吐	凸土荼塗酴圖禿徒餘突屠吐途
容	鎔蓉榕戎榮熔融絨溶茸嶸	茸冗
裴	陪培賠	珮壞轡配呸佩沛胚
聱	鼇熬鏖翱嗷遨敖	凹澳懊奧媼襖拗傲
諜	迭耋跌絰喋牒疊碟蝶	爹
翎	綾零蛉櫺昤菱鴒泠靈羚玲鈴苓伶齡聆陵凌	拎令另嶺領
娘	孃	釀
調	釣掉條弔佻吊蜩迢	挑叼凋鯛眺彫雕碉覜跳頫貂窕刁
藹	靄矮	哀皚埃捱噯唉艾哎礙璦隘挨愛曖
婿	序恤緒酗續卹蓄畜絮敘頊旭勗洫	鬚咻噓訏栩須戌胥墟籲煦虛需徐許
燴	諱惠晦喙蕙慧繪穢彙彗賄會卉匯誨潰	麾恢詼蟲茴暉毀墮灰揮燬賄虺輝悔回會徽迴蛔誨
離	罹麗蠡犁璃貍漓蜊喱梨籬犛驪狸釐黎	裏荔琍儷利厲痢例欐莉曆醴礫李勵鯉瀝慄禮隸理浬蒞釙蠣靂俚立粒礪壢唳力邐娌俐戾澧吏麗蠡鬲溧癘鋰笠裡哩歷酈
櫺	齡蛉菱玲翎聆昤鴒泠苓凌陵綾鈴靈羚零伶	領拎令另嶺
篁	韹湟隍磺蝗皇徨凰簧黃璜煌遑惶	幌肓謊洸荒慌晃恍
掛	掛卦褂	瓜蝸括刮寡聒呱颳
地	棣締第帝娣蒂的弟遞諦	氐笛嘀犒敵邸柢砥翟迪狄嫡的牴低抵滌芽荻詆鏑滴底
茲	淄錙緇貲諮姿孳孜資輜滋諮齜玆髭吱	仔訾字恣紫滓籽漬子孳梓自
瑭	醣糖搪堂塘膛棠唐鏜螳	燙湯躺趟帑倘淌儻鏜
蝕	塒時什碩拾射食十實石提	濕詩室恃施螫屎筮師史匙奭勢嗜舐豉矢市士事仕拭識試世釋柿逝是駛適噓屍侍示飾豕軾溼獅失誓弒始氏式蝨噬使視
黏	年	念輦碾唸拈廿攆輾撚捻涊
駛	矢史豕始屎使	濕詩室十恃施螫筮師匙提奭實勢嗜舐豉射市食士事仕拭碩拾識蝕試世釋柿逝是適噓屍塒侍示時什飾溼軾獅失誓弒氏式蝨噬石使視
鄂	愕詻鱷遏俄軛啞噩惡呃鍔顎扼餓厄堊萼	額俄蛾哦婀訛娥阿峨鵝蚵
昨	砟作	祚左作做座鑿坐佐柞
撾	抓	爪
錚	睜掙徵正箏癥猙爭崢蒸怔徵丁諍	政掙拯證証鄭正症幀整
倏	束數庶樹術戍恕述墅漱豎疏署曙	叔橾塾菽淑贖黍屬書輸熟殊數鼠藷樞梳暑孰蜀薯抒疏署蔬舒
瞋	琛	稱襯諶晨塵趁讖櫬宸陳娠忱疢臣辰沉沈
颺	烊鍚佯揚瘍洋羊楊徉昜暘陽煬	泱養仰鴦怏殃央秧癢樣漾恙氧鞅煬
靦	湎沔勉腆舔忝冕娩緬偭免	甜麵天恬田闐棉畋面綿填添眠
爽	塽	雙孀霜
槓	缸綱岡釭崗肛扛鋼剛	港崗槓缸綱港岡釭崗肛扛槓鋼剛
澗	餞鑒劍閒毽諫箭僭踐艦件健建間檻見監賤濺薦腱漸鑑鍵	尖儉堅艱減菅緘韉柬湔撿簡殲瞼肩筧間揀繭煎姦剪鹼監檢縑濺奸兼漸囝箋
擋	讜黨盪檔當蕩	讜黨儅噹襠檔盪當鐺蕩
脩	休修咻羞	溴袖宿朽嗅臭秀鏽繡岫
田	闐恬畋填甜	腆忝添靦天舔
理	裏澧蠡鋰禮俚浬李醴娌裡哩邐鯉	荔琍儷利厲痢貍例欐莉曆礫勵離釐黎罹瀝慄隸漓蒞梨犛釙蠣驪狸靂蜊立粒礪壢唳力戾俐吏麗蠡鬲溧璃犁癘笠喱籬哩歷酈
禪	鱔扇膳擅蟾訕疝嬋繕巉汕贍煽饞善澶讒孱潺蟬毚單纏	攙儳山鏟舢煽跚珊潸闡產陝懺扇姍縿刪剷摻諂羶杉衫閃芟羼
劇	拒懼鋸巨颶遽倨苣句屨具鉅聚踞據瞿距足炬俱	橘拘菊鋸居鞠莒跼疽齟桔局駒狙蛆舉車沮掬侷俱咀矩
抓	撾	爪
禱	導島倒搗	蹈盜悼導道到稻叨刀倒
壹	咿揖一噫醫依衣伊漪	劓羿浥益藝軼鎰姨痍肄頤憶遺矣佚翌夷一屹栘貽溢臆囈訑疑偯議意刈以移乙蛇役圯億蟻沂繹弋迤腋毅譯儀詣怡咦縊逸抑彝懿倚液帟翼義疫飴異迆胰艾奕衣佾誼尾翳已掖易裔旖邑曳椅亦蜴驛宜弈
損	榫筍	飧潠孫蓀
渴	坷可	科顆軻喀剋克殼苛恪嗑蝌磕緙柯稞蚵棵可課窠咳瞌溘客刻髁
赳	九韭灸久酒糾玖	究舊啾臼救舅咎疚糾就廄揪鳩柩
鑼	騾玀羅鏍儸邏螺囉蘿籮	裸落洛酪絡烙咯駱犖囉珞雒
尋	徇循潯旬洵璿詢巡荀馴	勳心薪訢巽芯馨蕈徇醺昕遜鋅新欣訓迅潠汛莘訊薰馴勛信燻辛殉釁
奸	縑肩間韉濺尖煎兼姦漸湔堅緘艱菅監殲箋	餞澗鑒劍儉閒毽減諫箭僭踐柬艦件健建撿簡瞼揀筧間檻繭見剪鹼檢監賤濺薦腱囝漸鑑鍵
錶	表婊	鏢鑣彪膘標鰾杓
基	唧跡畿屐居績犄饑譏羈激機乩積奇稽箕嘰躋蹟畸嵇其癘肌幾期雞璣磯飢姬勣	急唧霽髻疾脊寄際繼寂即繫楫伋稷擠吉薺技記擊忌騎及悸嫉汲覬己亟藉劑岌紀吃季瘠給借棘計級祭圾戟麂妓驥籍濟鯽輯幾芰戢集暨洎極薊系冀躋既
館	琯管莞	盥綸關貫鸛慣倌罐灌冠莞官鰥矜觀棺
鎔	容榮融絨蓉茸溶熔榕戎嶸	茸冗
湣	閩澠憫敏抿愍泯皿閔	岷玟民
澆	蛟礁鮫教嬌驕蕉姣膠交焦椒詨郊跤	攪醮矯嚼餃狡教剿叫覺轎較鉸勦腳僥窖絞繳校姣皎角
渠	劬麴瞿衢璩	趣蛐嶇取漆區曲趨齲屈瞿圈驅娶砠軀去蛆
鼎	酊頂	盯丁叮訂釘定仃酊錠
哭	骷枯窟	庫苦酷楛褲
柵	搾炸吒乍蚱砟咋詐	閘炸扎渣紮喳札眨查
殃	泱鞅央秧鴦	楊颺羊養昜漾洋鞅樣怏徉揚氧仰烊煬鍚瘍陽暘癢恙佯
券	勸	荃蜷銓卷權畎詮全犬甽圈泉佺痊拳踡
柯	軻窠科刻顆蚵苛瞌稞棵蝌磕	嗑課客恪溘坷渴剋髁可咳喀殼緙克刻
掖	詣劓羿浥異益議藝軼意刈鎰縊肄逸憶抑艾佚奕翌衣佾誼億役翳懿一屹易裔繹液弋帟邑腋曳溢臆翼亦囈蜴驛毅義譯弈疫	咿儀揖怡飴咦依姨迆痍胰頤以遺噫移乙矣蛇衣伊夷誼尾漪圯蟻彝已壹一醫沂旖栘倚迤貽椅訑宜疑偯
力	荔琍儷痢例利厲欐莉曆礫勵瀝慄隸蒞釙蠣靂立礪壢粒唳戾俐吏麗癘鬲溧笠歷酈	裏貍醴李離鯉釐黎罹禮漓理浬梨驪狸蜊俚娌邐澧麗蠡犁璃鋰喱籬犛裡哩
申	參信身呻莘深娠紳砷伸	脤甚慎沈滲沁蜃審瀋腎哂嬸神
毚	饞讒禪澶蟬潺孱蟾嬋單巉纏	懺剷摻諂攙儳鏟闡產羼
檮	洮桃濤萄陶燾淘逃啕	滔討濤絛套掏韜饕
冉	苒染髯	然燃髯
彤	童桐瞳同僮潼銅峒	統慟桶筒恫痛通
棠	醣搪膛鏜螳瑭堂糖塘唐	淌湯趟帑倘鏜儻燙躺
櫬	讖稱襯疢趁	晨諶塵宸陳娠忱琛臣瞋辰沉沈
窈	夭咬舀杳	要喲淆耀夭崤謠瑤僥鑰堯搖洮邀吆鷂榣腰樂餚姚麼遙餚窯藥拗妖曜爻
俯	脯撫斧府腑輔莆父釜腐頫甫	孚富拂夫芙敷父復袱蝠菔氟覆阜駙符複幅服馥傅鈇扶咐膚芾訃附輻腹俘賦伏匐賻彿副婦伕紼縛付涪浮趺福弗怫孵負麩紱赴
琛	瞋	稱襯諶晨塵趁讖櫬宸陳娠忱疢臣辰沉沈
堰	釅雁宴研艷硯嚥厭咽贗沿彥諺驗焰燄燕唁淹豔饜晏	言兗演研殷鹽菸奄顏咽巖厭閻簷沿眼湮煙偃魘郾延儼筵燕焉嫣嚴炎醃淹衍妍鼴掩癌胭
縞	搞攪槁杲稿	誥告篙睪羔糕高皋膏
學	穴	嘯梟薛酵銷瀟霄血小削蕭哮笑孝效簫曉嘐硝穴囂肖宵雪逍校消靴傚驍噱篠
挾	霞呷狎柙瑕黠諧頡遐擷洽邪勰鞋頰戛轄偕莢狹攜峽夾匣浹俠斜暇協脅	稼加鉀卸架洩歇家甲榭蝦茄蠍駕胛嘉寫屑血賈假廈楔蟹價下嚇邂嫁佳葭瞎傢豭契迦袈懈褻痂謝駭械燮夏解夾些瀉暇紲屜
允	隕	勻耘醞氳筠韻昀慍暈蘊紜雲芸運員熨孕
搪	醣膛棠鏜螳瑭堂糖塘唐	淌湯趟帑倘鏜儻燙躺
齜	淄錙緇貲諮茲姿孳孜資輜滋諮玆髭吱	仔訾字恣紫滓籽漬子孳梓自
汗	韓瀚寒旱憾銲函含榦撼悍焊頷涵捍翰漢頜	韓瀚含涵喊罕銲悍鼾憾函蚶焊漢寒旱榦撼酣頷捍和翰頜
徵	爭猙征諍址掙睜祉癥祇趾丁咫只蒸紙芷怔箏止崢錚指症旨正	政智制植脂幀痔梔直致摭之製蛭躓整掙質窒雉芝泜証值證胝躑枝吱峙祇幟肢支擲稚執祗職炙痣識汁置輊只症至殖織卮滯氏隻拯蜘秩摯知姪鄭緻治志誌正
酵	校嘯傚笑孝肖效	梟銷瀟霄小削蕭哮簫曉嘐硝囂學宵逍消驍篠
寓	芋與馭御喻育瘉禺鬱尉癒諭玉澦語煜欲谷裕昱愈聿峪嫗籲預豫浴域獄毓遇堉慾譽禦熨俞燠	與魚諛宇雨雩竽禹予愚禺虞迂齬蝓噢盂圉逾褕圩瘀榆渝語萸漁瑜庾輿嶼歟於腴紆妤隅圄愉羽臾餘淤覦敔俞娛
怛	瘩答達韃靼	瘩答搭大打褡躂
玩	汍惋萬頑腕丸完	萬蜿宛碗灣莞輓汍婉頑晚腕剜娩綰皖彎惋挽豌丸完
桃	檮逃燾啕淘洮陶萄濤	韜絛討套饕掏濤滔
顎	愕詻鱷遏俄軛啞噩惡呃鍔餓扼鄂厄堊萼	額俄蛾哦婀訛娥阿峨鵝蚵
哮	簫宵霄嘐逍硝消梟削蕭驍囂銷瀟	曉校嘯小傚學笑酵孝肖效篠
捆	綑梱	困錕睏崑焜坤琨昆髡
價	稼賈假架嫁駕	鉀加家甲茄胛嘉賈假噶佳葭傢頰豭戛迦袈莢軋痂尬夏嘎挾夾浹
踡	蜷卷詮犬銓佺荃全權痊泉拳	圈甽犬勸畎券
葭	嘉痂袈茄夾加豭傢佳家迦	架假夏鉀頰稼甲挾駕價浹賈莢戛夾嫁胛
供	躬龔宮釭紅蚣公攻恭共工肱功弓貢	拱龔鞏紅廾肱功躬蚣公礦共釭貢宮攻恭汞工弓
璀		橇催萃翠悴瘁崔粹脆摧淬衰
西	悉禧行谿羲嬉晰釐蟋吸唏曦希蹊稀淅溪畦奚犧譆熙攜烯析兮嘻僖蜥晞棲膝犀熹	細繫席昔惜洗隙褶襲矽習鰓翕係夕蓆熄檄璽息汐系媳錫戲潟徙喜歙
魎	倆兩	諒樑晾粱良糧量涼輛亮樑
愒	汽器愾企訖迄亟泣契咳憩妻慨砌緝磧棄氣	歧琪齊琦耆棋騎妻揩祺溪豈綺祁乞啟祇期祈棲枝漆慼起楷慨錡其淇旗凱萋麒淒欺臍畦鰭愷崎圻杞奇岐衹柒谿稽開悽剴戚七
犄	畸姬畿其璣羈肌飢癘雞磯乩幾唧積箕幾奇譏激績期屐機嵇跡勣稽蹟基躋嘰居饑	洎棘疾暨忌祭集脊己騎藉芰劑幾記楫瘠覬紀計級極妓冀戢擊寄輯寂給薊及嫉際幾唧麂繼擠急伋薺吉季圾即稷髻霽技汲吃亟既悸躋籍繫岌濟鯽戟驥
戀	瀲煉楝斂鏈鍊殮練	憐漣奩簾蓮濂鐮臉聯鰱連廉
略	掠	
詔	召棹趙照兆肇罩炤櫂晁	釗召著朝昭招嘲沼找爪晁
細	隙翕係系汐繫戲潟夕歙矽	悉禧行谿羲席嬉晰昔蟋洗惜吸釐唏曦希褶蹊稀淅溪襲習畦奚鰓犧譆熙攜烯西析蓆熄兮檄嘻僖蜥晞棲璽息錫媳膝犀熹徙喜
蜢	艋猛懵錳	甍蒙矇檬夢盟虻孟朦萌懵濛
攏	隴壟	聾窿籠龍矓隆瓏朧嚨
咄	墮馱度剁踱跺惰舵	鐸奪躲多朵
攬	覽欖纜懶	蘭攔爛斕纜襤瀾嵐藍籣濫闌婪籃欄
縊	屹藝肄軼刈誼囈逸佾溢劓疫懿鎰毅義邑億液佚役易羿弋裔蜴驛弈帟譯翌異益臆亦艾腋曳詣議意繹憶掖浥翳奕一抑翼衣	漪尾咦姨椅壹蟻飴旖誼偯迤栘移以彝夷已遺沂宜咿醫頤伊噫疑乙怡貽揖訑迆蛇矣圯胰儀一衣痍倚依
撲	撲噗鋪僕	莆暴誧蒲璞普樸釙葡僕菩濮曝瀑圃鋪溥脯匍譜浦埔蹼
緲	渺杪邈秒杳藐眇	描瞄妙苗繆廟
煞	莎殺廈沙鯊砂霎紗裟杉	莎殺廈沙傻鯊砂霎紗裟杉
六	陸溜餾霤	榴瘤泵劉留瀏硫溜鉚柳琉流遛
橙	呈懲誠承丞乘城成程盛澄	騁秤逞瞠撐稱
抑	詣劓羿浥異益議藝軼意刈鎰縊肄逸憶艾佚奕翌衣佾誼億役翳懿一掖屹易裔繹液弋帟邑腋曳溢臆翼亦囈蜴驛毅義譯弈疫	咿儀揖怡飴咦依姨迆痍胰頤以遺噫移乙矣蛇衣伊夷誼尾漪圯蟻彝已壹一醫沂旖栘倚迤貽椅訑宜疑偯
態	太泰汰	跆颱薹苔臺擡檯胎
蹂	柔鞣揉	肉
梓	仔訾紫滓籽子	恣淄漬錙緇貲諮茲字子姿孳資孜輜滋諮齜玆髭自吱
溺	暱膩逆泥匿睨	尼你霓妳倪泥擬旎呢怩妮
嶼	與圄庾齬羽噢圉宇雨予禹語敔	芋與馭御喻魚育諛雩予竽瘉愚禺虞迂鬱寓尉蝓癒盂逾褕諭玉圩澦瘀榆渝語煜漁欲谷瑜萸輿裕歟於昱愈腴紆聿妤峪嫗隅籲預豫娛域愉浴臾獄毓餘遇淤堉慾覦譽禦熨俞燠
叮	盯丁釘酊仃	頂訂釘鼎定酊錠
壁	庇埤幣裨箄襞篦蔽鄙必弊斃比蹕碧詖鉍賁陛避畢嗶闢璧臂敝痺愎泌睥婢薜閉祕弼俾	逼鄙匕筆鼻沘比妣彼
訐	捷劫拮櫛桔截詰節羯傑竭桀睫擷孑結潔頡傑碣	姊階芥皆解街嗟戒揭疥界偕藉誡結姐借介接屆
枕	賑鎮疹鴆陣振朕診娠震縝	賑陣箴偵針鎮斟振真診臻鴆禎榛砧貞娠楨疹朕珍甄震縝
謨	磨摹模摩糢蘑魔膜	默麼沒秣漠陌膜磨末抹寞摸脈貊墨茉歿驀沫莫
愛	曖噯艾礙璦隘	靄哀藹埃捱哎矮挨唉皚
遍	辯變汴卞弁釆片辨辮便騙	扁編蝙匾鞭便邊褊偏胼貶砭篇翩駢
襖	媼	拗鏖凹傲熬鼇澳奧敖遨翱嗷聱懊
餉	響享饗想	祥像湘詳襄嚮降翔庠鄉鑲瓖橡巷廂象箱香項向相
洲	啁舟州週粥周	妯縐皺軸帚胄咒宙肘冑籀晝紂
鶉	淳醇純脣脣	蠢春
週	粥舟周啁洲州	胄帚軸妯縐冑紂宙晝咒肘皺籀
靨	拽曄頁射咽夜鄴葉謁業	也噎琊椰野爺冶耶
艾	礙詣劓羿浥異益議藝軼意刈鎰縊曖肄逸憶抑佚毅奕翌愛衣佾誼億役翳懿一掖屹易裔繹液弋帟隘邑腋曳溢臆翼亦噯囈蜴驛璦義譯弈疫	咿儀揖怡藹埃飴捱咦依姨唉靄迆痍胰頤以噫遺移乙矣蛇矮衣伊夷誼尾漪挨蟻圯彝已壹一醫沂哎旖倚栘迤皚貽哀椅訑宜疑偯
抨	烹砰澎	棚彭捧蓬朋篷鵬膨硼碰澎
陡	蚪抖鬥枓	讀逗痘竇都鬥兜豆脰
岌	棘戢疾擊輯寂集脊及嫉藉唧急伋吉圾即楫瘠汲吃亟級極籍	洎璣羈暨忌肌祭脊己騎芰雞磯乩劑積幾記績期屐機嵇跡覬紀蹟基計妓居冀畸姬畿其寄給犄薊飢癘際幾唧箕麂繼擠薺奇譏激季稷髻霽技勣稽既悸躋繫嘰濟鯽戟驥饑
嘛	痲麼麻嗎蟆	螞碼痲麼瑪麻嬤媽罵嗎馬蟆
詐	搾炸柵吒乍砟咋蚱	閘炸扎渣紮喳札眨查
墊	靛鈿澱店奠電惦玷佃殿甸	點典滇碘癲顛巔
袞	輥鯀滾	棍
筏	罰法閥伐乏砝	法琺伐髮發
遷	纖牽簽搴鉛愆千謙嵌韆籤騫縴仟阡	倩潛鈐欠黔淺箝乾幹遣前歉鉗塹譴虔縴錢
駒	車拘疽沮鋸狙居俱蛆	橘拒菊懼鋸巨炬颶鞠莒遽跼齟倨劇苣桔屨局句具鉅聚踞舉據沮掬瞿距足侷俱咀矩
颳	括蝸呱刮聒瓜	掛掛卦褂寡
瞌	軻窠科柯刻顆蚵苛稞棵蝌磕	嗑課客恪溘坷渴剋髁可咳喀殼緙克刻
慈	疵祠詞瓷茨雌辭磁	疵刺伺次雌廁賜此差
審	哂嬸沈瀋	慎身沁深脤甚呻砷參滲蜃莘娠申紳伸信腎神
簸	薄亳薜擘蘗檗跛播	卜鈸博蔔鉑駁箔荸脖玻菠搏蘗檗跛播渤帛薄亳般白柏缽撥膊薜勃泊伯舶剝擘
鄹	鄒啁陬	揍走驟奏
票	剽驃漂	飄漂瓢縹嫖瞟
闆	板舨鈑阪版	搬般瓣拌斑扮頒辦瘢姅絆班扳半伴
篦	弊璧必敝鉍薜嗶痺箄襞避臂斃庇畢俾愎陛碧賁泌鄙蹕蔽詖埤闢閉弼婢祕比壁睥幣裨	彼鄙筆逼匕比沘鼻妣
輔	脯撫斧府腑莆父俯釜腐頫甫	孚富拂夫芙敷父復袱蝠菔氟覆阜駙符複幅服馥傅鈇扶咐膚芾訃附輻腹俘賦伏匐賻彿副婦伕紼縛付涪浮趺福弗怫孵負麩紱赴
悖	貝鋇倍背焙輩狽備臂邶憊被孛蓓	杯盃北揹卑背俾碑悲裨
顏	沿嚴言炎鹽簷妍筵延巖閻癌研	釅雁宴兗演研艷殷硯嚥菸奄咽厭贗沿眼湮彥諺煙偃魘驗堰郾焰儼燄燕焉嫣唁醃淹衍豔鼴饜掩胭晏
鯀	輥滾袞	棍
佚	屹藝肄軼刈誼囈縊逸佾溢劓疫懿鎰毅義邑億液役易羿弋裔蜴驛弈帟譯翌異益臆腋亦艾曳詣議意繹憶掖浥翳奕一抑翼衣	漪尾咦姨椅壹蟻飴旖誼偯迤栘移以彝夷已遺沂宜咿醫頤伊噫疑乙怡貽揖訑迆蛇矣圯胰儀一衣痍倚依
痙	竟鏡徑靖敬競淨逕勁靜境	莖驚頸涇景井粳睛鯨精警更荊菁憬兢經阱璟晶旌京
讓		瓤嚷攘禳壤
缸	鋼岡綱崗槓剛扛釭肛	崗槓港
闈	危維帷微巍韋唯惟圍濰為桅違薇幃	尾娓魏衛胃蔚痿緯萎威未遺渭為崴味穌煨逶餵偽葦位慰偉洧謂鮪偎褽尉喂畏猥諉委
疊	迭耋跌絰喋牒碟諜蝶	爹
蓿	塑簌肅宿縮速粟嗉訴溯素夙	俗蘇囌酥甦穌
試	室恃螫筮奭勢嗜舐豉市士事仕拭識世釋柿逝是適侍示飾軾誓弒氏式噬使視	濕詩十施屎師史匙提矢射食碩拾蝕駛塒屍噓時什溼豕獅失始蝨實石使
缽	撥玻菠般播剝	荸亳搏帛簸薜伯蔔博脖勃跛舶泊鉑膊擘渤箔薄駁播檗白蘗鈸柏
啁	鄹粥舟周鄒週洲州陬	胄帚軸妯驟縐奏冑紂揍宙晝走咒肘皺籀
臂	庇倍鋇埤幣貝裨箄襞焙篦背孛備蔽鄙悖必弊斃比被蹕碧詖輩鉍憊賁陛避畢壁嗶闢璧愎敝痺泌睥婢邶薜狽閉祕蓓弼俾	杯裨彼碑背鄙筆悲比妣逼北卑盃匕揹沘鼻俾
燻	勛薰醺勳	汛殉潯巡徇循潠迅訓遜馴訊尋詢璿洵荀巽蕈旬
懇	肯齦墾啃	
饜	豔晏研堰焰嚥諺彥雁沿燕驗釅贗厭咽淹艷燄宴唁硯	閻癌儼菸簷衍魘掩湮醃郾咽殷巖炎延研偃妍兗眼奄煙簷胭沿燕鹽鼴醃顏筵巖厭嚴淹言焉演嫣
皮	啤埤枇毗陂陴疲脾裨沘罷琵紕鼙鈹	媲劈匹屁僻癖壞仳紕被霹譬披鈹闢否批丕痞疋
仄	側	則擇澤賊責怎笮嘖窄咋
喀	嗑課哈客恪溘剋髁咖可克緙刻	軻哈坷稞渴棵磕咖可卡咳殼窠柯科刻顆苛蚵瞌蝌
鎊	旁傍蚌謗棒磅	榜傍膀幫邦綁梆
鵲	闋雀巧恪闕悄榷卻怯確殼愀	憔譙俏殼蹺缺翹竅鞘瞧鍬闕僑瘸峭喬樵誚橋撬橇敲
吧	笆琶疤捌芭巴扒罷叭八杷	鈸芭把杷琶拔霸扒壩耙跋疤捌巴靶爸叭八笆灞伯罷
忍	稔荏	刃任軔壬認賃飪韌紉兒仞人仁妊衽
洹	桓還環澴鍰梡寰	渙幻歡換緩喚宦患奐豢皖煥瘓梡
浚	雋郡峻駿濬俊蕈菌竣	鈞龜窘軍君均
睏	困	捆髡綑琨焜坤錕昆梱崑
省	醒	昇陞行杏繩勝型馨姓形邢笙牲腥甥硎生賸性倖悻聖盛升惺星聲興乘幸剩澠猩陘刑
拮	捷劫櫛桔截詰節羯訐傑竭桀睫擷孑結潔頡傑碣	姊階芥皆解街嗟戒揭疥界偕藉誡結姐借介接屆
老	姥佬	癆酪絡牢烙撈嘮勞
閭	櫚驢	鋁綠律呂縷褸膂氯旅婁侶濾屢慮履率
溧	慄儷麗礫礪唳痢歷靂力慄立蒞癘壢戾曆琍吏笠粒例利厲釙荔欐俐酈隸蠣勵瀝鬲莉	禮喱澧醴麗犁哩鯉犛貍籬黎娌璃浬釐離理驪邐李鋰梨狸裡罹裡漓蠡蜊俚
驃	漂剽票	飄縹瓢漂嫖瞟
浩	顥鎬涸號好昊耗鄗皓	蠔蚵嗥鶴號郝蒿好毫貉濠豪嚎壕
躍	曜越粵刖悅玥藥說耀月軏樂鑰籥嶽閱	約曰
釉	幼鼬誘宥右柚祐有侑莠又囿佑	遊幽黝猶猷遊攸油悠由牖鈾有郵友疣莠酉尤優魷憂
羞	咻修脩休	袖溴秀岫繡臭朽嗅宿鏽
陷	莧霰憲腺限羨現獻峴蜆線餡僩縣	賢蘚閒祆秈暹涎鮮纖先嫻銑險仙蜆顯癬嫌弦啣閑絃掀銜鹹舷姍
霎	廈煞	莎殺沙煞傻鯊砂紗裟杉
諭	裕瘉澦禦域籲嫗馭喻獄玉欲譽禺熨峪昱燠癒寓愈御谷鬱預語遇與煜慾芋育聿尉俞堉鬱豫浴毓	妤娛瘀宇逾褕竽蝓雨雩渝覦迂漁於語紆與噢齬餘餘俞歟羽虞盂隅榆敔愚魚圉禺禹嶼輿愉圄淤腴臾諛庾圩瑜予萸於
猶	鈾遊油尤由郵魷疣猷	囿佑悠誘憂幼攸友侑優又祐柚幽莠酉右牖宥黝有釉鼬
呱	颳菰括孤鴣哇挖蝸沽刮蛄咕蛙辜窪鈷估姑媧聒瓜家	凸鵠瓦褂僱娃罟賈鼓穀顧估僱故轂股掛告谷襪滑蠱牯寡瞽掛卦錮古詁鈷固骨
帕	怕	葩琶爬趴扒耙啪杷
津	金觔巾禁斤襟今筋矜浸	晉饉噤燼覲進儘僅禁瑾近勁謹盡緊縉錦浸
究	舊救咎臼舅廄就柩疚	赳酒玖糾灸九韭揪久鳩啾
北		鋇倍貝杯裨焙碑背孛備悖悲被輩憊卑盃臂邶狽揹蓓俾
褓	葆堡飽寶保	鉋鑤爆報刨豹雹暴包鮑抱褒胞苞薄
硫	榴瘤泵留劉瀏琉流遛	餾霤六陸溜鉚柳
搆	購構雊垢遘媾夠詬	勾狗句枸鉤溝苟
佐	左	昨作座鑿砟做祚柞坐
訂	錠定釘	盯頂丁叮釘鼎酊仃
璿	潯巡懸漩還徇循馴尋詢旋縣洵荀玄旬	燻鉉汛漩徇炫絢醺渲潠諼喧馴選勛旋巽蕈殉煖暄薰軒晅宣迅訓遜萱眩壎訊勳
紊	抆聞文汶問免	穩雯聞文瘟刎蚊塭溫紋吻玟
賽	塞	鰓塞腮
片	遍騙	扁便偏胼篇翩駢
鬢	儐臏殯	檳豳瀕濱繽賓儐彬
棺	綸關官冠莞鰥矜觀倌	盥貫管鸛慣罐琯冠灌莞觀館
赴	富父復覆阜駙複傅咐訃腹附賦賻副婦付負馥	孚拂斧夫芙敷莆父袱腐蝠菔氟腑撫符幅輔服鈇俯釜扶甫膚芾輻伏俘匐彿頫伕紼脯縛府浮涪趺福弗怫孵麩紱
琴	擒禽芹勤秦噙	嶔寢欽沁侵親撳
鏈	瀲煉楝斂鍊戀殮練	憐漣奩簾蓮濂鐮臉聯鰱連廉
難	男楠喃南	楠南囝男喃赧
諫	件檻劍健僭見艦漸毽濺踐監箭間閒薦腱建鍵餞鑑鑒澗賤薦	箋縑兼姦韉漸殲奸囝艱柬檢簡濺減筧監間肩尖湔剪鹼瞼繭堅菅緘撿揀儉煎
蓬	膨彭朋澎棚鵬篷硼	捧澎抨碰烹砰
槳	獎蔣講	醬絳僵江薑彊疆姜將強繮漿韁匠降
盪	擋當蕩	黨儅噹鐺擋讜襠當檔
弊	庇埤幣裨箄襞篦蔽鄙必斃比蹕碧詖鉍賁陛避畢壁嗶闢璧臂敝痺愎泌睥婢薜閉祕弼俾	逼鄙匕筆鼻沘比妣彼
匾	貶褊扁	辯編遍蝙變汴邊鞭卞弁釆辨辮砭便
咎	廄究舊救臼舅柩就疚	九揪韭啾赳鳩灸久酒糾玖
灰	麾恢輝徽揮暉詼墮	蛔賄會彙蟲彗潰燴繪蕙穢匯茴卉虺回燬毀諱惠迴慧悔晦誨喙
時	塒什碩拾射食十蝕實石提	濕詩室恃施螫屎筮師史匙奭勢嗜舐豉矢市士事仕拭識試世釋柿逝是駛適噓屍侍示飾豕軾溼獅失誓弒始氏式蝨噬使視
邕	擁鄘傭臃雍慵庸壅	擁踴泳傭永湧勇傭甬蛹臃用俑詠湧壅恿
表	婊錶	標鰾膘杓鏢鑣彪
珍	禎榛箴斟真診偵砧貞針楨甄臻	賑鎮疹鴆陣枕振朕診娠震縝
浦	普溥圃譜誧埔	撲菩蒲脯濮璞曝噗莆瀑樸匍鋪釙暴葡蹼僕
翰	瀚旱憾銲撼悍焊捍頷漢汗頜	韓鼾寒罕函含蚶榦酣涵和喊汗
擘	亳蘗簸薜播檗薄	荸搏般帛簸蔔伯博脖勃菠跛舶剝泊鉑膊渤箔薄玻撥駁播檗白鈸缽柏
褥	入孺辱茹	燸如濡汝嚅女辱蠕孺乳儒茹
京	晶鯨睛莖更精荊經粳菁兢驚旌涇	靜競井淨警敬勁痙頸鏡阱憬璟竟景徑逕靖境
氟	縛匐夫蝠紼扶芾幅孚弗輻紱袱福浮伏符菔拂涪怫彿服芙俘	富馥覆附膚俯鈇複府夫腑腐頫甫阜腹賻副傅復釜敷付撫斧孵赴婦莆趺輔咐父麩脯賦負駙伕訃
你	擬妳旎	尼妮霓呢溺怩倪逆匿暱泥睨膩
蘑	膜摩磨模糢謨魔摹	抹墨脈漠沒麼歿膜末貊默茉莫磨摸陌沫寞驀秣
紐	忸扭鈕	拗妞牛
紉	刃軔認賃飪韌任仞妊衽	壬忍荏稔人任兒仁
羶	扇姍縿刪山舢煽跚杉衫珊潸芟	鱔扇膳禪擅疝訕繕汕贍煽善閃單陝
飲	隱引蔭印胤尹癮聽蚓縯	淫蔭霪聽殷胤印尹吟因癮鄞簷湮隱垠夤銀陰慇氤姻蚓縯引齦音茵寅
堆		碓醉嘴最兌罪隊蕞對
搬	頒斑扳般瘢班	半姅舨版板阪伴辦扮瓣絆鈑闆拌
巧	悄雀愀鵲	憔譙俏殼蹺翹竅鞘瞧鍬僑峭喬樵誚橋撬橇敲
映	應硬	穎盈瑛嚶瓔楹迎櫻應纓嬴熒螢贏營嬰瑩鸚鶯縈膺鷹罌蠅瀛郢英景塋影
螞	瑪碼嗎馬	痲媽麻罵嘛嗎蟆嬤麼
差	疵釵拆雌剎喳叉岔詫插	祠詞察雌儕豺茶查伺廁叉岔柴此插疵搽瓷次辭賜茨剎喳慈詫刺磁
初	出齣	杵絀櫥跦楮觸矗楚廚黜除鋤歜畜雛處躇礎怵褚芻儲
英	瑛嚶瓔嬰鸚鶯應膺櫻纓鷹罌	穎盈楹迎應嬴熒螢贏營映瑩縈瀛蠅郢景塋硬影
搜	餿蒐颼	嗾嗽藪叟擻
攻	躬供宮龔釭紅蚣公恭共工肱功弓	供鞏汞礦共廾拱貢
怔	癥諍爭徵丁猙掙箏睜崢錚症蒸正	政整拯掙幀証鄭證症正
巷	向橡象像項鄉嚮相	香餉翔鄉相饗詳降廂鑲響祥瓖箱湘庠想襄享
莽	蟒	氓芒茫盲忙杗
佺	蜷卷詮犬銓踡荃全權痊泉拳	圈甽犬勸畎券
癌	嚴言炎鹽簷妍顏筵延巖閻沿研	釅雁宴兗演研艷殷硯嚥菸奄咽厭贗沿眼湮彥諺煙偃魘驗堰郾焰儼燄燕焉嫣唁醃淹衍豔鼴饜掩胭晏
橘	跼菊掬鞠侷桔局	拒拘懼鋸巨颶居莒遽疽齟倨劇苣屨句具鉅聚踞駒狙蛆舉車據沮瞿距足炬俱咀矩
寸	吋	村存皴忖
匆	樅聰從囪蔥	從叢淙
評	平馮枰蘋瓶萍屏憑坪	娉乒
姐	解姊	睫傑節櫛芥竭揭潔捷頡疥階擷戒結桔孑藉接羯皆桀借劫偕拮碣界嗟解訐介街屆詰誡截
弛	持馳墀池遲栘踟匙	飭喫褫赤癡斥叱呎翅魑吃敕蚩侈啻尺笞熾齒恥嗤
疥	戒芥界藉誡解借介屆	捷階拮皆桔街截詰節傑桀揭孑頡接碣姊劫櫛解嗟羯訐竭睫偕擷結潔姐傑
蟾	饞讒禪澶蟬潺孱毚嬋單巉纏	懺剷摻諂攙儳鏟闡產羼
忖		皴寸吋村存
萄	檮逃桃燾啕淘陶洮濤	韜絛討套饕掏濤滔
吾	亡誣無毋鼯梧唔巫吳蕪蜈	武汙鵡晤騖巫侮悟塢誤誣務午五烏伍寤戊惡嗚嫵於物勿憮霧屋舞兀圬鎢捂軏污堊
述	數漱墅術豎恕庶曙樹束倏署戍疏	鼠黍署輸數薯贖梳菽暑舒叔淑蜀書藷殊疏塾屬橾抒蔬樞熟孰
瀰	靡謎彌麋糜迷	弭密糸米蜜咪靡汨敉祕覓祕冪瞇謐泌
諺	釅雁宴研艷硯嚥厭咽贗沿彥驗堰焰燄燕唁淹豔饜晏	言兗演研殷鹽菸奄顏咽巖厭閻簷沿眼湮煙偃魘郾延儼筵燕焉嫣嚴炎醃淹衍妍鼴掩癌胭
藕	耦偶嘔	甌嘔區噢歐毆鷗
塒	拾石碩什蝕十射實食提時	拭豕恃軾是匙溼獅氏蝨使視失蝨豉噓仕噬誓筮施室嗜屍逝屎舐式屍適柿飾奭士詩螫弒市示試始勢侍世史師濕識矢事駛釋
七	漆萋淒戚棲谿悽柒慼欺溪妻	器憩旗啟祈豈琦琪汽耆麒企錡起杞臍齊磧泣祁騎砌亟枝祇契棋畦奇稽訖啓迄只崎淇緝綺祺其期棄圻乞衹氣愒歧岐鰭妻
惋	萬腕玩	玩蜿宛碗灣莞輓汍婉頑娩晚剜綰皖彎挽豌丸完
沮	車莒拘疽齟咀鋸矩駒狙居俱蛆舉	橘拒拘菊懼鋸巨炬颶居鞠莒遽跼疽齟倨劇苣桔屨局句具鉅聚踞駒狙蛆舉車據掬瞿距足侷俱咀矩
愣	楞	蔆冷稜楞
渺	緲杪藐杳邈眇秒	苗繆廟描瞄妙
麵	面	湎棉沔勉靦綿冕娩眠緬偭免
募	慕穆墓木目沐睦苜幕暮牧	牡模拇姥姆母畝
耄	懋貌貿帽瑁茂冒	髦泖錨毛茆卯貓茅矛
臏	殯儐鬢	繽彬瀕豳儐濱檳賓
馳	持墀池遲栘弛踟匙	飭喫褫赤癡斥叱呎翅魑吃敕蚩侈啻尺笞熾齒恥嗤
賴	籟睞癩瀨	徠萊來
柚	幼鼬誘宥右祐有侑莠又囿佑釉	遊幽黝猶猷遊攸油悠由牖鈾有郵友疣莠酉尤優魷憂
檬	朦虻萌蒙濛甍盟矇懵	夢孟蜢錳艋猛懵
俘	孚拂夫芙袱蝠菔氟符幅服扶芾輻伏匐彿紼縛浮涪福弗怫紱	富斧夫敷莆父復腐覆阜腑撫駙複輔傅鈇俯釜甫膚咐訃附腹賦賻副頫婦伕脯府付趺孵麩負馥赴
哀	埃挨唉哎	靄皚藹曖捱噯艾矮礙璦愛隘
褚	處儲杵礎楚楮	矗齣出畜黜鋤儲除絀跦廚怵雛處櫥歜躇觸初芻
匍	莆葡脯蒲菩濮璞樸僕釙蹼樸	普埔鋪浦誧僕溥暴撲撲譜瀑圃曝噗
蔬	輸舒橾抒梳書樞殊疏	鼠漱黍庶束署戍曙數薯術贖菽述暑叔淑恕蜀藷疏塾屬墅豎樹倏熟孰
廿	念唸	輦碾黏拈攆年輾撚捻涊
滇	巔顛癲	奠甸店點碘典靛玷佃惦電鈿澱殿墊
儳	懺羼	攙禪蟾嬋巉鏟饞剷摻諂讒澶孱潺蟬毚單纏闡產
籀	胄晝宙咒縐皺冑紂	粥軸帚舟妯周肘啁週洲州
晉	噤進覲燼儘僅禁勁盡縉近浸	金謹錦浸饉覲瑾矜津禁斤襟緊觔巾僅儘今筋
扇	善芟煽珊鱔疝禪山潸羶舢汕繕膳跚縿刪杉擅單訕衫贍姍	善芟煽珊鱔山禪疝潸羶舢汕繕陝跚膳縿刪杉擅單訕衫贍姍閃
啖	誕氮蛋淡石旦擔憚彈但澹啗	簞丹擔耽撢單膽疸
涮		拴閂栓
篷	蓬膨彭朋澎棚鵬硼	捧澎抨碰烹砰
貲	淄錙緇諮茲姿孳孜資輜滋諮齜玆髭吱	仔訾字恣紫滓籽漬子孳梓自
咱	砸偺雜	匝瓚紮暫讚贊簪鏨
駱	落洛酪絡烙咯犖珞雒	裸鑼騾玀羅鏍儸邏螺囉蘿籮
危	薇圍唯違濰桅惟幃維帷闈巍爲韋微為	葦魏畏褽偽崴慰緯尉猥諉煨謂逶鮪僞遺渭威偎萎喂尾餵痿未位委胃洧穌蔚衛味娓偉為
烤	考拷	犒靠銬
與	芋馭御喻育宇雨予禹瘉寓譽禺鬱尉齬噢癒圉諭玉澦煜語欲谷庾裕嶼昱愈聿峪嫗籲預豫圄域浴羽獄毓遇堉慾敔禦熨俞燠	諛虞鬱尉癒逾玉語漁谷輿於愈聿妤隅羽獄淤堉榆譽覦瘀熨宇雩竽愚寓蝓萸昱紆峪預豫域愉臾遇慾禦俞娛芋馭御喻魚育雨予禹瘉迂齬噢圉褕諭澦渝瑜庾裕嶼腴嫗籲餘圄敔禺盂圩煜欲歟毓浴燠
妹	瑁昧魅袂媚沬寐	媒玫每眉黴梅楣枚鎂美莓煤沒湄
櫛	捷劫拮桔截詰節羯訐傑竭桀睫擷孑結潔頡傑碣	姊階芥皆解街嗟戒揭疥界偕藉誡結姐借介接屆
父	富斧莆復腐覆阜腑撫駙複輔傅俯釜甫咐訃附腹賦賻副頫婦脯府付負馥赴	孚富拂斧夫芙莆敷復袱腐蝠菔氟覆阜撫腑符駙複幅輔服馥傅鈇俯釜扶甫膚咐芾訃附輻腹俘賦伏匐賻彿副頫婦伕紼脯縛府付涪浮趺福弗怫孵負麩紱赴
寫	血	卸洩歇榭蠍屑諧頡楔擷邪蟹邂勰鞋契褻懈偕謝駭攜械燮解挾斜些瀉協紲脅屜
燸	儒茹嚅濡蠕如孺	女茹入汝乳褥辱孺
醇	鶉脣淳純	春蠢
銑	鮮險蘚蜆顯癬	莧陷限賢獻閒祆秈暹涎鮮纖霰先嫻線仙蜆嫌弦啣閑腺羨絃餡僩掀銜鹹舷憲現峴姍縣
鹽	沿嚴言炎簷妍顏筵延巖閻癌研	釅雁宴兗演研艷殷硯嚥菸奄咽厭贗沿眼湮彥諺煙偃魘驗堰郾焰儼燄燕焉嫣唁醃淹衍豔鼴饜掩胭晏
枰	屏瓶坪評憑萍平馮蘋	娉乒
藺	吝躪賃	痳霖麟鱗林凜鄰燐淋磷懍轔遴臨琳璘
悟	鎢誤惡戊勿塢霧騖物寤軏堊兀晤務	無巫毋圬屋梧嫵惡舞汙烏吾誣鎢吳五侮鼯於蕪捂鵡憮嗚蜈午亡武伍污唔
鰓	腮璽徙洗喜塞	攜烯嬉蓆膝惜溪細析賽係媳棲息蟋羲夕錫蹊歙褶昔曦淅悉熹禧系犀汐行翕蜥稀戲隙希吸習晰畦兮熙釐矽譆谿塞犧唏晞嘻西潟繫席奚熄襲僖檄
疤	笆吧捌芭巴扒叭八	吧鈸灞琶拔霸靶壩耙把伯跋罷爸杷
閑	嫌嫻舷銜閒絃啣鹹涎賢鹹弦	僩纖峴餡顯限莧銑暹秈癬現險霰腺祆姍羨鮮憲仙獻蜆陷掀縣先線蘚
弁	遍釆辯辮辨卞變汴便	褊鞭扁砭邊蝙編貶匾
妤	盂隅娛榆愚魚逾禺輿愉褕竽蝓雩渝覦腴漁臾於諛圩餘餘瑜俞予歟萸於虞	瘉澦域瘀宇馭獄峪昱燠雨預迂語紆與煜齬慾噢芋育俞堉鬱豫羽毓裕禦籲嫗敔喻玉欲圉譽禺禹熨嶼癒寓愈諭圄御谷鬱淤遇庾聿尉予浴
額	哦蛾蚵俄娥峨鵝訛	厄呃扼惡萼顎詻婀堊阿軛噩餓鱷愕啞鄂俄遏鍔
甌	歐區鷗毆嘔	偶藕耦嘔噢
醜	丑	惆籌溴躊裯仇疇愁臭鯈稠酬綢抽儔
源	沅轅垣圓爰緣袁園援元騵原湲媛員猿	怨院鳶苑宛鴛願淵遠冤媛
弼	弊璧必敝鉍薜嗶痺箄襞避臂斃庇畢愎俾陛碧賁泌鄙蹕篦蔽詖埤闢閉婢祕比壁睥幣裨	彼鄙筆逼匕比沘鼻妣
誦	訟頌宋送	淞崧悚慫嵩忪鬆聳
稼	賈假架價嫁駕	鉀加家甲茄胛嘉賈假葭頰傢豭佳戛迦袈莢痂夏挾夾浹
俸	縫諷奉鳳	瘋峯豐諷逢豐馮楓縫鋒烽蜂風封
囌	蘇酥甦穌	塑肅粟訴素俗蓿簌宿縮速嗉溯夙
男	楠難喃南	囝難赧
仍		扔
腐	脯撫斧府腑輔莆父俯釜頫甫	孚富拂夫芙敷父復袱蝠菔氟覆阜駙符複幅服馥傅鈇扶咐膚芾訃附輻腹俘賦伏匐賻彿副婦伕紼縛付涪浮趺福弗怫孵負麩紱赴
自	孳漬字恣	仔訾淄玆子錙輜籽滓資孳茲吱梓貲孜姿髭紫諮滋緇齜
擂	雷淚嫘縲羸鐳累類	雷壘淚耒漯儡嫘縲羸蕾勒鐳磊累類
幌	恍洸謊晃	凰遑湟肓黃篁晃慌簧韹煌蝗隍皇徨荒璜惶磺
玻	撥菠般剝缽播	卜鈸博蔔鉑駁箔荸脖搏蘗檗跛播渤帛薄亳白柏膊薜勃泊簸伯舶擘
穆	慕募墓木目沐睦苜幕暮牧	牡模拇姥姆母畝
物	鎢誤惡戊勿悟塢霧騖寤軏堊兀晤務	無巫毋圬屋梧嫵惡舞汙烏吾誣鎢吳五侮鼯於蕪捂鵡憮嗚蜈午亡武伍污唔
打		大靼躂搭達韃瘩褡答怛
滷	魯虜鹵櫓擄	鱸廬路僇嚕爐露錄鷺穋氯陸臚顱賂鑪瀘戮麓盧碌蘆鹿祿
禎	診貞真針楨斟臻珍砧偵榛甄箴	震陣娠鴆診枕縝鎮朕賑振疹
癟		彆鱉別
殊	輸舒橾抒梳書蔬樞疏	鼠漱黍庶束署戍曙數薯術贖菽述暑叔淑恕蜀藷疏塾屬墅豎樹倏熟孰
踹		揣
亮	輛量晾諒涼	良兩糧魎粱量倆涼樑
圓	沅轅垣爰緣湲袁園援元騵原源媛員猿	怨院鳶苑宛鴛願淵遠冤媛
潤	閏	
仲	湩種重衆眾中	終種忠鐘盅忪腫衷鍾中塚踵
介	解芥借屆疥誡戒界藉	睫傑節櫛竭姐揭潔捷姊頡擷階結桔孑接羯皆桀劫偕拮碣嗟解訐街詰截
檠	傾晴擎情	青慶罄卿親蜻傾輕磬鯖氫頃請清
朧	聾窿籠龍矓隆瓏嚨	隴攏壟
懼	拒鋸巨颶遽倨劇苣句屨具鉅聚踞據瞿距足炬俱	橘拘菊鋸居鞠莒跼疽齟桔局駒狙蛆舉車沮掬侷俱咀矩
檔	擋黨讜	儅擋噹襠盪當鐺蕩
箄	弊璧必敝鉍薜嗶痺襞避臂斃庇畢俾愎陛碧賁泌鄙蹕篦蔽詖埤闢閉弼婢祕比壁睥幣裨	彼鄙筆逼匕比沘鼻妣
撓	橈呶鐃	腦鬧瑙惱
譟	皁噪竈造躁燥	澡遭藻鑿早蚤糟棗
癸	鬼軌詭晷	鱖跪鮭皈規傀貴桂閨龜圭珪瑰櫃歸
渭	位慰魏胃衛蔚謂未褽遺尉喂畏為味穌餵偽	尾娓維痿緯萎威韋唯惟濰圍桅為崴煨薇逶幃葦危偉洧帷鮪微巍偎闈猥諉違委
檗	搏荸亳帛簸薜伯蔔博脖勃舶泊鉑膊擘渤箔薄駁播白蘗鈸柏	搏亳荸般帛簸薜蔔伯博脖勃菠跛膊鉑剝泊舶擘渤箔薄撥玻駁播白蘗鈸缽柏
燧	誶碎穗邃歲隧遂祟	髓隨隋綏睢雖
逛		光洸獷胱廣
鉅	炬苣颶懼具巨踞瞿倨劇遽屨距俱聚據句鋸足拒	莒咀舉桔疽橘蛆跼車駒俱拘狙侷掬菊局鋸沮鞠居齟矩
耐	奈	氖奈奶迺乃
鶯	瑛嚶英瓔嬰鸚應膺櫻纓鷹罌	穎盈楹迎應嬴熒螢贏營映瑩縈瀛蠅郢景塋硬影
踞	炬苣颶懼具巨瞿鉅倨劇遽屨距俱聚據句鋸足拒	莒咀舉桔疽橘蛆跼車駒俱拘狙侷掬菊局鋸沮鞠居齟矩
枉	罔網往魍惘輞	旺尢妄忘王汪亡望
伸	參信身申呻莘深娠紳砷	脤甚慎沈滲沁蜃審瀋腎哂嬸神
災	哉栽	宰載仔再在
勃	卜鈸博蔔鉑駁箔荸脖搏檗渤帛薄白柏膊泊伯舶	玻菠薄亳般薜擘蘗簸檗剝跛缽播撥
峴	現僩霰腺餡羨憲獻限蜆莧陷縣線	纖涎顯嫌銑舷銜暹啣鹹秈癬嫻險祆姍閒閑絃鮮鹹仙弦蜆掀先賢蘚
疫	詣劓羿浥異益議藝軼意刈鎰縊肄逸憶抑艾佚奕翌衣佾誼億役翳懿一掖屹易裔繹液弋帟邑腋曳溢臆翼亦囈蜴驛毅義譯弈	咿儀揖怡飴咦依姨迆痍胰頤以遺噫移乙矣蛇衣伊夷誼尾漪圯蟻彝已壹一醫沂旖栘倚迤貽椅訑宜疑偯
禧	攜曦淅悉熹烯犀嬉膝行蜥稀希吸溪畦晰兮析熙釐棲譆谿犧蟋唏羲晞嘻西奚蹊僖	系汐蓆翕戲隙惜習璽徙洗細鰓係媳矽喜息潟夕繫席錫熄歙襲昔檄褶
即	急唧疾脊寂楫伋吉擊及嫉汲亟岌藉吃瘠借棘圾級籍輯戢集極	唧霽髻寄脊跡際繼冀繫屐居績稷擠犄薺饑譏技記忌羈騎機乩激積覬己悸劑紀季奇給稽既箕計嘰祭戟麂妓蹟躋驥濟鯽畸嵇幾其肌芰期飢癘雞暨洎璣基薊系磯畿姬勣
束	數漱墅術豎恕庶曙樹倏署述戍疏	鼠黍署輸數薯贖梳菽暑舒叔淑蜀書藷殊疏塾屬橾抒蔬樞熟孰
霪	垠夤吟銀鄞齦淫簷寅	癮聽胤印飲因尹茵音湮姻陰縯慇氤蔭殷隱引蚓
弱	篛若偌鶸	
梡	桓渙還幻換鍰喚宦患奐豢環煥洹澴瘓款寰	桓寬渙還幻歡髖換鍰緩喚宦患奐豢環皖澴洹煥瘓寰
笮	則擇澤賊責嘖窄咋	仄側怎
媚	瑁妹昧魅袂沬寐	媒玫每眉黴梅楣枚鎂美莓煤沒湄
慟	痛	瞳同銅峒桐僮桶彤恫通潼筒童統
鉗	潛鈐黔箝乾幹前虔錢	倩淺鉛謙韆嵌歉纖愆遣籤塹搴仟千牽欠簽遷騫譴縴阡
寶	葆飽褓堡保	抱鉋刨雹包報胞薄鑤豹爆褒苞鮑暴
筵	炎延研閻妍癌簷沿簷鹽顏巖嚴言巖	豔堰焰儼諺菸雁驗衍魘掩湮醃贗郾咽艷殷硯晏偃研兗眼嚥奄彥煙胭沿燕鼴醃饜釅厭淹燄焉演嫣宴唁
糊	囫狐鵠胡鬍蝴葫壺湖弧斛瑚	戶滬虎沍扈乎瓠忽惚互琥唬戲護楛許呼
芷	徵止紙趾祇只指祉旨咫址	雉秩幟蛭志氏脂值肢執祇峙枝治支制質祗之芝誌姪稚窒植織梔泜痣智緻胝滯汁吱致置痔摭至摯製輊躑躓蜘直擲識知隻炙只職卮殖
悶	懣燜	捫燜門懣們
礬	藩煩釩蕃樊繁凡帆墦	犯反返蕃梵泛番汎幡販翻飯繙範氾帆
毓	裕瘉澦禦域籲嫗馭喻獄玉欲譽禺熨峪昱燠癒寓愈諭御谷鬱預語遇與煜慾芋育聿尉俞堉鬱豫浴	妤娛瘀宇逾褕竽蝓雨雩渝覦迂漁於語紆與噢齬餘餘俞歟羽虞盂隅榆敔愚魚圉禺禹嶼輿愉圄淤腴臾諛庾圩瑜予萸於
水		誰蛻說稅睡
症	政爭徵丁猙掙箏怔睜幀証鄭證蒸正	政爭徵猙諍整掙睜證癥丁蒸拯怔箏崢錚鄭正
格	革隔膈合鬲蛤閤閣咯鎘骼郃葛	個戈胳割鉻鴿箇歌疙各葛擱哥
髡	琨焜坤錕昆崑	睏捆綑困梱
釣	掉吊調弔	叼凋鯛彫雕碉貂刁
黍	數薯鼠屬暑蜀署藷	漱庶束署戍曙輸數術贖梳菽述舒叔淑恕書殊疏塾橾墅抒豎樹蔬倏樞熟孰
沁	腎蜃滲甚撳脤慎	砷信秦申擒伸呻禽身噙侵琴紳參欽芹沈哂審甚勤親瀋莘寢嶔娠深嬸神
褊	扁貶匾	遍辯辮辨卞弁編蝙邊變汴釆鞭砭便
紜	耘雲勻筠雲昀芸	韻允員孕熨運隕暈醞慍蘊氳
鯉	裏澧蠡鋰禮俚理浬李娌裡醴邐哩	荔琍儷利厲痢貍例欐莉曆礫勵離釐黎罹瀝慄隸漓蒞梨犛釙蠣驪狸靂蜊立粒礪壢唳力戾俐吏麗蠡鬲溧璃犁癘笠喱籬哩歷酈
許	咻栩虎琥唬煦	訏鵠葫墟扈卹惚婿序湖需洫呼戶瑚胥壺虛弧徐恤緒鬍沍酗乎瓠畜絮護頊互籲鬚噓囫糊狐須胡滬蝴續蓄忽戌敘戲旭楛勗斛
尢	汪	往望魍旺妄亡惘王網枉罔輞忘
題	緹隄蹄啼堤提	梯悌銻剔涕踢惕替嚏剃逖體屜
淋	鄰林遴痳燐轔琳磷鱗霖臨麟璘	吝凜藺賃躪懍
醉	蕞罪最	堆嘴
彷	訪倣舫仿紡	放防妨芳坊肪枋房方
彪	標膘杓鏢鑣	婊錶表鰾
溪	悉禧行淒谿悽羲嬉晰釐蟋吸漆唏曦希慼蹊稀淅欺畦奚戚犧柒譆熙攜烯西析七兮嘻僖蜥晞棲熹膝犀萋妻	憩席錡臍騎祇鰓翕訖蓆淇祺器祈豈琪昔惜麒齊泣襲枝係稽夕崎熄檄棄錫愒歧徙喜細啟企耆隙磧褶祁砌亟習奇啓迄綺其圻乞璽息氣岐系鰭歙旗繫琦汽洗起杞矽契棋畦只緝期衹汐媳戲潟妻
勺	數蟀率碩韶爍杓妁芍鑠朔帥	少捎哨紹說燒梢邵稍召
躑	直擲執姪質摭職植值殖	雉秩幟止蛭志芷氏脂址肢祇祉峙枝治支制質紙之祗芝誌稚窒織梔咫泜痣智緻胝滯汁吱致置痔摯至製輊躓蜘識知徵隻炙只趾指卮旨
僕	撲蒲菩脯濮璞莆樸匍鋪釙葡蹼噗	莆暴誧蒲璞撲普樸釙葡僕菩濮曝瀑圃鋪溥噗脯匍譜浦埔蹼
牧	慕穆募墓木目沐睦苜幕暮	牡模拇姥姆母畝
酩	瞑名螟明茗冥鳴銘暝	命暝
燼	覲縉浸盡晉進噤近禁僅勁儘	饉金矜緊津僅禁儘筋襟覲觔斤浸謹瑾錦巾今
五	嫵舞午侮武捂伍鵡憮	無巫毋勿騖寤軏圬屋梧誤惡物汙堊烏吾兀誣務鎢塢悟霧吳鼯於蕪晤嗚戊蜈亡污唔
頊	敘恤畜洫絮酗婿蓄卹緒勗續旭序	墟胥籲戌許須徐訏鬚煦需虛咻栩噓
蚩	嗤癡魑癡笞吃喫	赤熾翅褫啻尺恥呎踟侈匙敕叱栘齒弛持馳斥池飭遲墀
帥	數蟀率碩爍妁鑠勺朔	摔衰說甩
伐	罰法閥筏乏發砝	罰法閥琺筏乏髮發砝
氦	亥嗨駭害	還咳嗨海孩骸
賑	震陣娠鴆枕鎮朕振	禎枕診貞縝真針楨斟疹臻珍砧偵榛甄箴
刊	戡堪勘看	砍檻崁看侃坎瞰勘
磋	蹉撮搓	措錯嵯厝挫銼撮
杓	鏢鑣勺彪芍膘標韶	錶哨燒鰾少召表邵紹捎稍婊梢
陪	裴賠培	珮轡配胚沛壞佩呸
蔔	荸搏帛駁伯博檗脖勃白鈸膊鉑泊舶柏渤箔薄	玻撥亳般簸薜播檗菠蘗跛缽剝擘薄
堅	縑肩間韉濺奸尖煎兼姦漸湔緘艱菅監殲箋	餞澗鑒劍儉閒毽減諫箭僭踐柬艦件健建撿簡瞼揀筧間檻繭見剪鹼檢監賤濺薦腱囝漸鑑鍵
愆	簽阡嵌仟縴鉛千騫謙牽搴遷韆籤	乾欠前塹縴遣黔歉倩箝虔潛淺鈐譴錢鉗
鞋	諧挾頡擷偕斜邪攜勰協脅	卸洩歇榭蠍寫屑血楔蟹邂契褻懈謝駭械燮解些瀉紲屜
霹	批劈披丕匹壞紕被鈹	啤媲埤陂脾裨匹屁琵僻枇癖疲仳紕譬陴鼙鈹闢否毗痞沘疋罷皮
咆	庖刨炮袍匏	砲拋泡炮跑皰
排	牌徘俳	派拍湃啪
綿	眠棉	沔靦娩勉麵冕偭湎面緬免
睛	晶鯨莖京更精荊經粳菁兢驚旌涇	靜競井淨警敬勁痙頸鏡阱憬璟竟景徑逕靖境
忙	氓芒茫盲杗	蟒莽
捌	笆吧疤芭巴扒叭八	吧鈸灞琶拔霸靶壩耙把伯跋罷爸杷
箇	鉻各個	郃哥歌咯格戈骼疙個鎘蛤擱割胳革隔閣膈閤鬲葛鴿
濾	慮率氯綠律	呂閭鋁褸履驢膂屢旅婁侶縷櫚
峪	裕瘉澦禦域籲嫗馭喻獄玉欲譽禺熨昱燠癒寓愈諭御谷鬱預語遇與煜慾芋育聿尉俞堉鬱豫浴毓	妤娛瘀宇逾褕竽蝓雨雩渝覦迂漁於語紆與噢齬餘餘俞歟羽虞盂隅榆敔愚魚圉禺禹嶼輿愉圄淤腴臾諛庾圩瑜予萸於
泅	仇毬酋求裘球梂囚	蚯丘邱龜秋鞦鰍
娩	皖沔靦婉勉蜿冕宛碗挽偭莞湎晚輓緬免綰	萬麵面玩蜿灣莞汍眠綿棉頑腕剜彎惋豌丸完
塘	醣搪膛棠鏜螳瑭堂糖唐	淌湯趟帑倘鏜儻燙躺
汴	遍釆辯辮辨卞弁變便	褊鞭扁砭邊蝙編貶匾
挪	娜	懦糯諾
碌	鷺穋氯路僇陸鹿祿露錄賂戮麓	鑪魯虜盧瀘鹵鱸廬蘆嚕臚櫓擄爐滷顱
遨	鼇熬鏖翱嗷聱敖	凹澳懊奧媼襖拗傲
梗	哽耿埂	亙耕庚更羹粳賡
蝨	濕屍噓詩失獅溼施虱師	室十恃螫屎筮史匙提奭勢嗜舐豉矢射市食噬士事仕拭碩拾識蝕試世釋柿逝是駛適塒侍示時什飾豕軾誓弒始氏式實石使視
盞	展斬嶄輾	棧站沾瞻綻霑湛暫佔蘸顫詹譫氈戰
窄	責嘖笮則賊澤咋擇	仄債齋宅側責齊摘祭怎寨翟
告	固顧錮估誥故僱	咕攪鼓鴣牯鵠穀滑家稿古骨罟股皋賈估蛄鈷菰呱蠱谷姑凸孤搞縞轂羔詁膏辜篙槁睪高沽糕杲瞽
屎	矢史豕始使駛	濕詩室十恃施螫筮師匙提奭實勢嗜舐豉射市食士事仕拭碩拾識蝕試世釋柿逝是適噓屍塒侍示時什飾溼軾獅失誓弒氏式蝨噬石使視
飯	犯汎梵泛販範氾	藩煩反釩蕃礬返樊番繁幡翻凡繙墦帆
躺	儻帑淌倘	醣搪膛湯鏜趟棠螳燙瑭堂糖塘唐
找	沼爪	櫂詔釗罩趙着招肇兆著朝炤召棹嘲照昭晁
醺	燻勛薰勳	汛殉潯巡徇循潠迅訓遜馴訊尋詢璿洵荀巽蕈旬
峯	豐諷風鋒楓封蜂烽瘋	俸諷逢縫馮鳳奉
逸	詣劓羿浥異益議藝軼意刈鎰縊肄憶抑艾佚奕翌衣佾誼億役翳懿一掖屹易裔繹液弋帟邑腋曳溢臆翼亦囈蜴驛毅義譯弈疫	咿儀揖怡飴咦依姨迆痍胰頤以遺噫移乙矣蛇衣伊夷誼尾漪圯蟻彝已壹一醫沂旖栘倚迤貽椅訑宜疑偯
袒	坦毯	探碳覃貪罈歎談坍攤癱嘆炭彈曇痰潭譚灘壇檀
產	鏟剷闡諂	讒孱摻蟬毚單儳饞攙蟾潺澶羼嬋禪巉懺纏
涸	蓋盍荷皓貉禾曷盒閡顥褐閤好耗昊嗑浩合郃河和翮紇闔鄗核劾鎬何號	毫濠嚇和訶喝壕蠔嚎荷暍赫貉蒿嗥郝蚵豪賀鶴好號呵
莠	幼黝鼬誘宥右柚祐牖有侑友酉又囿佑釉	遊黝由牖郵友疣又尤優憂幼幽猶猷攸遊鼬誘宥油悠右柚祐鈾有侑酉囿佑魷釉
端	耑	短緞段斷鍛
伴	半姅辦扮瓣絆拌	頒搬斑扳舨版板般瘢阪班鈑闆
蛆	拘趨鋸驅砠居疽曲蛐區屈圈駒狙軀車嶇沮瞿俱	橘拒取菊懼鋸渠娶巨炬颶鞠趣劬莒遽漆跼曲齟齲倨劇衢苣桔屨去局句具鉅聚麴踞璩舉據沮掬瞿距足侷俱咀矩
愎	弊璧必敝鉍薜嗶痺箄襞避臂斃庇畢俾陛碧賁泌鄙蹕篦蔽詖埤闢閉弼婢祕比壁睥幣裨	彼鄙筆逼匕比沘鼻妣
綺	起杞乞啟豈稽	歧琪齊琦耆棋騎妻祺溪棄磧祁祇期器祈棲訖枝漆迄慼錡氣其淇愒旗萋麒淒欺臍畦鰭崎圻汽奇岐衹柒企谿亟悽泣契憩戚砌七緝
蠡	禮澧喱醴麗鯉犁哩犛貍籬黎娌璃浬釐離理邐驪李鋰梨狸裡罹漓裡蜊俚	儷澧醴哩歷靂力慄立黎溧娌琍璃粒離理利厲邐狸俐蠣漓俚莉鬲慄禮喱麗犁鯉礫礪唳犛痢貍籬蒞癘壢戾曆吏笠浬釐例釙荔驪欐李鋰梨裡罹隸酈裡勵瀝蜊
銻	涕悌屜剃替逖嚏惕	剔題梯堤蹄踢啼體隄緹提
妳	你擬旎	尼妮霓呢溺怩倪逆匿暱泥睨膩
然	髯燃	苒冉髯染
布	埠佈鈽不怖部步簿	卜捕補不埔哺
急	唧疾脊即寂楫伋吉擊及嫉汲亟岌藉吃瘠借棘圾級籍輯戢集極	唧霽髻寄脊跡際繼冀繫屐居績稷擠犄薺饑譏技記忌羈騎機乩激積覬己悸劑紀季奇給稽既箕計嘰祭戟麂妓蹟躋驥濟鯽畸嵇幾其肌芰期飢癘雞暨洎璣基薊系磯畿姬勣
吝	躪賃藺	鄰凜林淋遴痳燐轔琳磷鱗霖懍臨麟璘
碳	嘆探炭歎	探覃貪罈坦談坍袒攤癱毯彈曇痰潭譚灘壇檀
娣	締遞諦帝弟的地棣蒂第	滴低鏑荻迪底的嘀狄敵氐牴砥柢犒翟滌芽邸笛抵詆嫡
隕	允	勻耘醞氳筠韻昀慍暈蘊紜雲芸運員熨孕
勳	燻勛薰醺	巽洵詢巡蕈徇潯旬遜訓迅潠循汛訊璿馴尋殉荀
黌	訌泓弘閎洪宏紅虹鴻	薨烘哄鬨汞轟
衝	憧充沖舂	憧充舂崇重沖蟲寵
伺	寺似兕食耜祀廁泗嗣次巳駟賜飼肆四俟刺姒	祠詞雌思鷥此疵瓷嘶辭廝差茨絲撕斯慈死私磁司
魍	惘往網罔枉輞	望汪亡王旺妄尢忘
稀	悉禧行谿羲嬉晰釐蟋吸唏曦希蹊淅溪畦奚犧譆熙攜烯西析兮嘻僖蜥晞棲膝犀熹	細繫席昔惜洗隙褶襲矽習鰓翕係夕蓆熄檄璽息汐系媳錫戲潟徙喜歙
欲	芋與馭御喻育瘉寓禺鬱尉癒諭玉澦語煜谷裕昱愈聿峪嫗籲預豫浴域獄毓遇堉慾譽禦熨俞燠	與魚諛宇雨雩竽禹予愚禺虞迂齬蝓噢盂圉逾褕圩瘀榆渝語萸漁瑜庾輿嶼歟於腴紆妤隅圄愉羽臾餘淤覦敔俞娛
肢	脂梔之泜芝胝枝吱祇支祗汁只卮織隻蜘知氏	智徵制植痔直致摭製蛭址躓質窒雉值躑擲峙祉幟祇趾稚執職炙痣識咫置輊只至殖滯紙芷止秩摯知姪指緻治志旨誌
簽	阡嵌仟縴愆鉛千騫謙牽搴遷韆籤	乾欠前塹縴遣黔歉倩箝虔潛淺鈐譴錢鉗
巴	笆吧疤捌芭扒叭八	吧鈸灞琶拔霸靶壩耙把伯跋罷爸杷
甽	犬畎	蜷卷犬權圈詮銓勸踡佺全荃券泉痊拳
兜	都	讀逗痘竇陡抖鬥蚪豆脰枓
兔	吐菟	土荼凸屠禿餘吐塗徒突途圖酴
隍	韹湟磺蝗皇徨凰篁簧黃璜煌遑惶	幌肓謊洸荒慌晃恍
寧	檸獰嚀擰凝	佞濘擰
澠	閩繩憫敏抿愍泯皿閔湣	岷生乘賸玟昇民剩勝升牲省笙甥聖盛聲陞
請	頃	親擎蜻傾輕檠清氫情青頃鯖晴磬卿慶罄
鰍	蚯丘邱龜秋鞦	仇毬酋泅求裘球梂囚
幣	庇埤裨箄襞篦蔽鄙必弊斃比蹕碧詖鉍賁陛避畢壁嗶闢璧臂敝痺愎泌睥婢薜閉祕弼俾	逼鄙匕筆鼻沘比妣彼
裯	酬稠儔仇疇綢愁躊籌鯈惆	溴抽臭醜醜
翻	蕃番幡繙帆	藩釩飯範返蕃泛樊墦反販帆氾犯煩礬梵汎繁凡
棟	凍胴動恫洞	東董咚冬懂鼕
庫	酷褲	苦骷窟枯哭楛
捷	睫傑節櫛竭潔頡擷結桔孑羯桀劫拮碣訐詰截	芥姐揭姊疥階戒結藉接皆借偕界嗟解介街屆誡
崤	洮淆謠榣瑤僥餚姚遙餚窯堯搖爻	邀要喲耀夭咬吆鷂杳舀腰樂窈麼鑰藥妖拗曜
磐	盤蹣般胖蟠槃踫	叛拚潘判盼攀畔
鞅	養泱仰鴦殃氧央秧癢	鍚佯仰瘍鴦洋怏颺楊羊徉央秧樣漾恙煬烊養泱揚殃癢昜暘氧陽
蘗	涅亳簸囁齧薜鎳播檗鑷臬聶孽擘躡薄	荸搏般帛簸蔔伯博脖勃菠跛舶剝泊鉑膊渤箔薄玻撥駁播檗白鈸缽柏捏
柱	助薴駐箸祝註注蛀佇鑄杼住	諸逐軸朱躅茱硃渚拄蛛誅術主囑珠豬築朮貯竺侏藷屬煮燭矚株銖竹
若	弱偌惹鶸篛	熱
璩	劬渠麴衢瞿	趨嶇去娶取趣瞿漆蛆屈齲圈砠曲區蛐軀驅
銬	犒靠	考烤拷
啻	赤熾翅斥飭敕叱	褫尺恥蚩癡呎踟侈匙癡吃栘齒弛持馳嗤池魑遲墀笞喫
蛟	教礁澆跤姣驕郊鮫嬌焦膠詨交椒蕉	教較餃勦姣轎皎狡窖腳繳僥鉸攪角校絞叫矯剿覺醮嚼
汝	女乳辱	燸儒茹入嚅濡蠕如褥辱孺
涿	棹捉桌	擢濁卓濯琢鐲著酌拙灼斫茁啄
胭	奄菸煙燕醃湮醃厭咽淹焉殷嫣	豔閻癌堰焰儼諺雁簷驗衍魘掩贗郾咽艷硯巖炎延晏研偃妍兗眼嚥彥簷沿燕鹽鼴饜顏釅筵巖厭嚴淹燄言宴演唁
猷	鈾遊郵猶疣遊尤油魷由	幼幽黝攸鼬誘悠宥右柚牖祐有侑莠友又酉囿佑優憂釉
梂	仇毬酋泅求裘球囚	蚯丘邱龜秋鞦鰍
疽	車駒俱狙拘鋸沮居蛆	苣炬颶具桔巨鉅倨劇遽屨距俱侷掬聚據齟咀莒舉懼踞瞿橘跼局句菊鋸沮足鞠拒矩
弘	訌泓黌閎洪宏紅虹鴻	薨烘哄鬨汞轟
呀	鴨煆押鴉丫壓	啞疋亞蚜芽衙訝涯牙軋雅押氬
饕	滔濤絛掏韜	洮桃討濤萄陶燾套檮淘逃啕
摩	膜蘑磨模糢謨魔摹	抹墨脈漠沒麼歿膜末貊默茉莫磨摸陌沫寞驀秣
城	呈懲誠承丞橙乘成程盛澄	騁秤逞瞠撐稱
鄧	凳嶝磴蹬瞪	等登燈
戡	看勘刊堪	侃坎看檻瞰勘砍崁
琺	法	發乏法筏砝伐髮閥罰
擺	百佰襬	白敗拜
休	咻羞脩修	袖溴秀岫繡臭朽嗅宿鏽
躉	盹	鈍蹲囤頓惇遁燉噸墩沌盾盹敦
譴	淺遣	倩乾鉛謙韆嵌歉錢纖潛愆籤塹搴仟千牽欠簽前遷鉗騫鈐黔箝幹虔縴阡
蛀	助薴駐箸祝註注柱佇鑄杼住	諸逐軸朱躅茱硃渚拄蛛誅術主囑珠豬築朮貯竺侏藷屬煮燭矚株銖竹
寺	泗四伺兕嗣俟巳食耜祀駟賜似飼肆姒	嘶絲思斯廝死私司鷥撕
崛	鴃掘鱖抉決獗譎蹶劂腳倔玨角攫爵孓觼覺蕨訣厥絕嚼噱	倔蹶嗟
獎	槳蔣講	醬絳僵江薑彊疆姜將強繮漿韁匠降
慄	荔例琍儷痢利厲欐莉曆礫栗勵瀝隸蒞釙蠣靂立礪壢粒唳力戾俐吏麗癘鬲溧笠歷酈	裏貍醴李離鯉釐罹黎禮漓理浬梨驪狸蜊俚邐娌澧麗蠡犁璃鋰喱籬犛裡哩
禿		酴土凸屠菟餘吐塗徒兔突途圖荼
趟	燙	醣淌搪膛帑鏜湯棠螳儻倘瑭堂糖塘唐躺
嗑	課蓋盍剋荷貉禾髁曷盒閡褐閤合河郃翮和溘恪客紇闔核可劾喀緙克刻何涸	軻嚇訶稞渴荷咳殼柯蚵瞌鶴賀呵和喝坷棵暍磕赫可科窠郝刻苛顆蝌
洋	楊鍚徉颺揚瘍暘陽羊烊煬昜佯	怏漾煬殃泱養癢氧鞅仰央秧樣鴦恙
喟	匱愧餽簣潰	夔葵窺睽盔虧魁揆傀奎逵
淳	醇鶉脣純	春蠢
潠	遜殉汛馴徇訊巽蕈訓迅	燻巡潯損榫徇筍薰循醺蓀孫飧馴勛尋詢璿洵荀勳旬
曉	小篠	嘯梟酵銷瀟霄削蕭哮笑孝效簫嘐硝囂學肖宵逍校消傚驍
馬	螞碼嗎瑪	痲媽麻罵嘛嗎蟆嬤麼
嘆	碳探炭歎	探覃貪罈坦談坍袒攤癱毯彈曇痰潭譚灘壇檀
拉	啦喇	落啦臘蠟喇邋剌辣
氧	養鞅仰癢	楊颺羊泱養央昜漾殃洋鞅樣鴦怏徉揚秧烊煬鍚瘍陽暘恙佯
偷		頭透投
握	齷斡渥沃臥	窩我倭萵渦
辦	半姅伴扮瓣絆拌	頒搬斑扳舨版板般瘢阪班鈑闆
鍾	終忠鐘盅忪衷中	湩種仲重衆腫眾中塚踵
三	參	散糝傘
蠅	嬴盈瑩楹熒塋瀛縈螢迎贏營	穎瑛嚶瓔櫻應纓嬰映鸚鶯膺鷹罌郢英景硬影
煮	屬拄矚主囑貯渚	諸逐軸朱蛀躅茱鑄硃助蛛箸誅術注珠豬薴祝築朮柱竺杼侏藷燭駐註佇株銖竹住
帑	躺倘淌儻	燙瑭糖搪塘膛唐鏜螳湯醣趟堂棠
鹵	滷魯擄櫓虜	蘆路盧露臚鑪鹿鱸麓戮顱僇爐碌氯嚕鷺廬陸錄穋祿瀘賂
買		麥脈霾賣邁埋
腎	脤甚慎滲沁蜃	參甚沈信身紳呻深審瀋娠莘哂申嬸砷伸神
系	細寄際繫繼薺隙技記忌騎劑矽紀季翕係計祭妓夕濟鯽汐戲潟冀既歙	羲席曦擊淅溪己奚鰓圾譆籍蓆畸兮蜥晞飢唧脊嬉居晰績昔惜唏譏襲吃借稽犧西攜烯熄檄嘻幾集錫徙喜行谿釐吉褶蹊及機習奇棘箕熙析其雞璽息基犀熹急悉禧疾跡即寂擠蟋洗吸希激稀嫉積畦給嘰級輯肌僖期棲極媳膝
苯	畚本	奔笨賁
藩	蕃樊墦凡煩礬釩繁帆	氾繙犯範泛梵番販反汎蕃飯翻範返幡帆
唷		
廬	鑪盧瀘鱸蘆爐臚顱	虜路僇嚕擄露錄鷺穋氯陸櫓滷賂戮麓魯鹵碌鹿祿
孀	雙霜	爽塽
褪		囤臀豚飩吞屯
憧	衝沖充舂	衝寵崇蟲蟲重
浸	金噤晉覲勁縉矜津燼禁斤襟今觔巾僅盡儘近筋進	金噤謹錦晉饉覲瑾勁縉矜津燼禁斤襟緊今觔巾僅盡儘近筋進
爛	纜濫	蘭覽攔斕纜襤瀾欖嵐藍籣攬闌婪籃懶欄
艙	蒼傖倉滄	藏
援	沅轅垣圓爰緣湲袁園元騵原源媛員猿	怨院鳶苑宛鴛願淵遠冤媛
爲	衛薇位喂僞尉維胃未味違遺慰蔚微桅謂圍唯危魏巍畏	委偉尾葦威偎萎緯
建	餞澗鑒劍閒毽諫箭僭踐艦件健間檻見監賤濺薦腱漸鑑鍵	尖儉堅艱減菅緘韉柬湔撿簡殲瞼肩筧間揀繭煎姦剪鹼監檢縑濺奸兼漸囝箋
關	綸倌官冠莞鰥矜觀棺	盥貫管鸛慣罐琯冠灌莞觀館
沫	膜末貊莫磨陌默墨驀秣脈茉寞漠沒歿	膜抹蘑摩摸磨模糢謨魔摹麼
鯨	晶睛莖京更精荊經粳菁兢驚旌涇	靜競井淨警敬勁痙頸鏡阱憬璟竟景徑逕靖境
隆	聾窿籠龍矓瓏朧嚨	隴攏壟
淑	叔贖菽熟塾孰	鼠漱黍庶束署戍曙輸數薯術梳述暑舒蜀恕書藷殊疏屬橾墅抒豎樹蔬倏樞
鏜	醣湯瑭糖搪堂塘膛棠唐螳	燙瑭躺糖搪塘帑膛淌唐儻螳湯醣趟堂棠倘
羋	咩	篾蔑滅
免	紊沔靦聞勉文冕汶偭湎問娩緬抆	眠雯穩綿面聞麵文瘟刎棉蚊塭溫紋吻玟
胎	苔	泰汰跆颱薹苔臺太態擡檯
嘹	聊潦寥撩寮繚遼燎僚療	料撩暸了燎瞭廖
顆	窠科柯軻蚵稞棵瞌蝌磕刻苛	緙咳坷喀恪剋可嗑殼溘課克渴客刻髁
羿	屹藝肄軼刈誼囈縊逸佾溢劓疫懿鎰毅義邑億液佚役易弋裔蜴驛弈帟譯翌異益臆腋亦艾曳詣議意繹憶掖浥翳奕一抑翼衣	漪尾咦姨椅壹蟻飴旖誼偯迤栘移以彝夷已遺沂宜咿醫頤伊噫疑乙怡貽揖訑迆蛇矣圯胰儀一衣痍倚依
吵	炒	超潮剿巢朝抄勦鈔嘲晁
垮		胯誇跨
拱	鞏汞礦共廾	躬供宮龔釭紅蚣公攻恭共工肱功弓貢
聘	牝	貧頻顰嬪瀕品拼姘
釧	串	船舛穿傳川喘
蟆	痲麻嗎嘛麼	瑪嬤痲媽麻螞罵馬嘛嗎碼麼
菁	莖驚涇粳睛鯨精更荊兢經晶旌京	竟頸景靖井痙競淨勁警靜鏡徑憬敬阱璟逕境
婉	皖娩蜿宛碗挽莞晚輓綰	汍剜玩彎惋萬蜿豌灣莞頑腕丸完
膳	汕善擅繕單扇訕疝禪煽贍鱔	芟閃扇陝羶衫跚縿山煽珊潸姍刪舢杉
低	滴氐	氐笛嘀娣犒敵邸柢第地砥遞翟迪棣締帝狄嫡的牴抵滌弟芽荻蒂詆鏑底諦
互	戶滬沍扈瓠護楛	鵠虎葫惚唬湖許呼瑚壺弧鬍乎囫糊狐胡蝴忽琥戲斛
苓	齡蛉菱櫺玲翎聆昤鴒泠凌陵綾鈴靈羚零伶	領拎令另嶺
恢	麾輝徽揮灰暉詼墮	蛔賄會彙蟲彗潰燴繪蕙穢匯茴卉虺回燬毀諱惠迴慧悔晦誨喙
啡	菲霏妃扉非飛	菲吠肥誹芾斐腓匪費屝怫翡痱廢沸肺
詞	疵祠瓷茨雌辭慈磁	疵刺伺次雌廁賜此差
選		晅萱絢懸還渲漩炫旋壎玄眩煖璿鉉宣暄諼軒喧縣
揖	咿壹一噫醫依衣伊漪	劓羿浥益藝軼鎰姨痍肄頤憶遺矣佚翌夷一屹栘貽溢臆囈訑疑偯議意刈以移乙蛇役圯億蟻沂繹弋迤腋毅譯儀詣怡咦縊逸抑彝懿倚液帟翼義疫飴異迆胰艾奕衣佾誼尾翳已掖易裔旖邑曳椅亦蜴驛宜弈
霞	峽黠挾轄呷遐匣洽狎柙斜瑕狹暇俠	夏廈下嚇暇蝦瞎
賃	刃吝任藺軔認飪躪韌紉仞妊衽	凜痳荏稔磷任仁淋遴忍燐轔鄰林琳鱗臨璘壬霖兒懍人麟
最	蕞罪醉	堆嘴
湧	擁泳踴永勇甬蛹臃俑詠湧壅恿擁泳踴永湧勇甬蛹臃俑詠壅恿	擁鄘傭臃邕雍慵用庸壅傭擁鄘傭臃邕雍慵用庸壅傭
師	濕屍噓詩失獅溼施蝨	室十恃螫屎筮史提匙奭實勢嗜舐豉矢射市食士事仕拭碩拾識蝕試世釋柿逝是駛適塒侍示時什飾豕軾誓弒始氏式噬石使視
濬	雋浚郡峻駿俊蕈菌竣	鈞龜窘軍君均
丘	龜鰍秋蚯邱鞦	毬裘梂酋仇囚球泅求
氯	慮鷺穋率綠路律僇碌濾鹿陸祿露錄賂戮麓	呂虜履鱸廬嚕屢爐擄旅櫚鋁臚櫓婁侶滷顱縷鑪瀘褸驢閭魯盧鹵膂蘆
疝	鱔扇善膳禪擅訕單繕汕贍煽	扇縿姍刪山舢煽跚羶杉衫珊潸閃芟陝
下	暇廈夏嚇	霞峽黠挾轄呷遐匣洽狎柙斜瑕狹暇蝦俠瞎
呢	尼霓倪泥怩妮	你溺暱膩妳逆泥擬旎匿睨
怏	養樣漾恙煬	鍚烊養泱佯瘍仰揚鴦洋颺楊羊殃央徉秧癢昜暘鞅氧煬陽
鷗	甌區毆歐嘔	耦噢藕嘔偶
咋	則柵擇澤搾砟詐笮乍搾炸賊責嘖吒窄蚱	仄紮查閘眨炸側喳札怎扎渣
鸛	貫盥慣觀罐冠灌	館棺琯關觀莞矜倌管官鰥冠綸
哩	裏澧蠡鋰禮俚理浬李娌裡醴邐鯉	荔琍儷利厲痢貍例欐莉曆醴礫李勵離鯉黎釐罹瀝慄禮漓隸理浬蒞梨釙蠣驪狸靂俚蜊立粒礪壢唳力邐娌俐戾澧吏麗蠡鬲溧璃犁癘鋰笠喱籬犛裡歷酈
纖	鮮掀先牽欠鉛謙仙嵌遷祆籤歉秈暹姍千	莧陷淺限賢獻閒蘚錢涎鮮霰潛嫻銑險線遣蜆顯癬嫌弦啣閑腺羨絃前鉗餡僩銜鹹舷黔幹憲現峴譴縣
炮	咆砲庖刨泡袍皰匏	咆砲拋庖泡刨跑袍皰匏
扒	笆吧琶爬疤捌芭巴耙叭八杷	鈸把杷吧琶趴拔霸怕耙壩跋啪帕靶爸灞葩伯罷
醬	絳彊將強匠降	獎僵江薑槳疆蔣講姜將繮漿韁
壞	批劈披丕匹胚壞呸霹紕被鈹	啤媲埤陂陪賠脾裨匹屁琵僻槐枇癖疲配沛佩淮仳紕懷譬培徊陴鼙鈹闢珮否裴毗轡踝沘痞疋罷皮
鰱	簾聯蓮簾濂奩連漣憐鐮廉	鍊戀殮瀲斂練煉鏈楝臉
團	糰	湍
倉	蒼傖艙滄	藏
米	靡敉弭	靡瀰謎泌密糜糸祕汨瞇咪迷蜜麋冪彌謐覓
區	甌蛐嶇嘔曲趨屈瞿圈歐驅砠軀毆鷗蛆	趣劬耦嘔取漆曲噢麴齲藕瞿渠娶衢偶璩去
閂	栓拴	涮
腴	盂妤隅娛榆愚魚逾禺輿愉褕竽蝓雩渝覦漁臾於諛圩餘餘瑜俞予歟萸於虞	瘉澦域瘀宇馭獄峪昱燠雨預迂語紆與煜齬慾噢芋育俞堉鬱豫羽毓裕禦籲嫗敔喻玉欲圉譽禺禹熨嶼癒寓愈諭圄御谷鬱淤遇庾聿尉予浴
戢	棘疾擊輯寂集脊及嫉藉唧急伋吉圾即楫瘠汲吃亟級極籍岌	洎璣羈暨忌肌祭脊己騎芰雞磯乩劑積幾記績期屐機嵇跡覬紀蹟基計妓居冀畸姬畿其寄給犄薊飢癘際幾唧箕麂繼擠薺奇譏激季稷髻霽技勣稽既悸躋繫嘰濟鯽戟驥饑
夭	要妖吆杳邀窈咬腰喲舀麼	吆藥餚洮淆腰麼瑤崤要妖搖窈樂爻舀鷂姚榣杳僥遙謠耀邀堯拗曜窯咬鑰喲
犀	悉禧行谿羲嬉晰釐蟋吸唏曦希蹊稀淅溪畦奚犧譆熙攜烯西析兮嘻僖蜥晞棲膝熹	細繫席昔惜洗隙褶襲矽習鰓翕係夕蓆熄檄璽息汐系媳錫戲潟徙喜歙
長	瘴嫦徜掌場漲償常嘗脹嚐賬仗幛障裳杖腸丈萇帳	瘴蟑獐氅掌場悵漲彰漳暢脹鯧敞賬娼昌猖唱仗幛廠璋樟章障杖丈帳張倡倀
痔	雉秩幟蛭稚窒志痣智緻滯致置至摯峙製輊躓治知識制質炙誌	姪止植織梔咫泜氏芷脂胝值汁址吱肢執摭祇祉躑枝蜘直支擲知徵隻質紙趾只之指祗職芝旨卮殖
首	手守	獸綬瘦收狩壽授售受熟
膜	墨脈魔漠沒歿末貊蘑默糢茉摹莫摩磨陌沫模寞驀謨秣	抹墨脈魔漠沒麼歿末貊蘑默糢茉摹莫摩磨摸陌沫模寞驀謨秣
暢	倡悵唱	嫦徜氅場償常嘗嚐鯧敞娼昌猖廠裳腸萇長倡倀
肓	荒慌	韹湟隍磺謊蝗皇徨凰篁晃恍幌洸簧璜黃煌遑惶
剖	叵頗	珀裒迫鄱波陂破樸潑婆泊坡魄粕醱
黃	凰隍遑皇徨簧惶璜湟篁韹煌磺蝗	幌恍慌荒謊肓洸晃
叛	判拚盼畔	胖潘踫磐般蹣蟠攀盤槃
戳		輟啜齪綽
功	躬供宮龔紅蚣公攻恭共工肱釭弓	供鞏汞礦共廾拱貢
磕	窠科柯軻顆蚵稞棵瞌蝌刻苛	緙咳坷喀恪剋可嗑殼溘課克渴客刻髁
肅	溯嗉訴塑速縮粟蓿宿素夙簌	囌酥蘇俗甦穌
剽	驃漂票	飄縹瓢漂嫖瞟
蚜	衙涯牙押芽	啞鴨亞疋訝軋煆雅鴉押呀丫壓氬
耀	越玥藥月軏嶽閱要悅樂鷂粵拗曜刖說躍鑰籥	約吆餚洮淆腰麼瑤崤要妖搖窈爻舀姚榣杳僥遙謠邀堯窯夭咬喲曰
元	沅轅垣圓爰緣湲袁園援騵原源媛員猿	怨院鳶苑宛鴛願淵遠冤媛
詮	蜷卷犬銓踡佺荃全權痊泉拳	圈甽犬勸畎券
鑿	祚作做座坐柞	蚤噪作遭燥竈皁譟躁澡砟佐藻棗早造昨左糟
瘩	靼躂搭達韃褡答怛	大靼躂搭打達韃褡答怛
盛	呈賸懲誠承丞橙乘剩城勝成程聖澄	笙昇牲騁聲陞省甥秤繩逞澠勝瞠生撐升稱
彈	覃淡罈談蛋啖誕憚啗曇痰潭譚擔氮但澹壇旦檀石	探碳貪撢歎坦坍袒攤丹癱嘆簞毯炭耽灘擔單膽疸
晁	潮釗棹巢朝昭肇罩炤詔召著趙照招兆嘲櫂	昭肇炤超著趙照鈔找吵釗棹朝罩勦沼爪詔抄召兆招嘲剿櫂炒
據	拒懼鋸巨颶遽倨劇苣句屨具鉅聚踞瞿距足炬俱	橘拘菊鋸居鞠莒跼疽齟桔局駒狙蛆舉車沮掬侷俱咀矩
校	教醮嘯傚窖叫覺轎笑酵較孝肖效	攪礁澆梟矯餃嚼焦銷跤瀟蕉嬌狡教霄小剿削蕭交椒哮郊較勦鉸簫曉嘐硝腳僥絞膠繳囂學蛟鮫宵驕逍消姣驍詨皎角篠
丞	呈成澄乘誠懲程城承盛橙	稱瞠撐逞騁秤
啕	洮桃濤萄陶燾檮淘逃	滔討濤絛套掏韜饕
阻	組俎詛祖	卒嗾租族足
燈	登	等凳嶝磴蹬瞪鄧
砭	鞭邊蝙編	遍褊辯辮辨扁卞弁貶變汴匾釆便
短		耑緞段斷端鍛
牀	撞幢	窗瘡囪創闖搶愴
法	罰閥琺筏伐乏髮發砝	罰閥琺筏伐乏髮發砝
版	舨板阪鈑闆	頒搬斑半扳姅班般瘢伴辦扮瓣絆拌
寄	霽髻際繼繫稷薺技記忌騎悸覬劑紀季計祭妓驥濟鯽芰暨洎薊系冀躋既	急唧疾脊跡即寂楫屐居伋績擠吉犄饑譏擊羈機及乩嫉積激己汲藉亟岌吃瘠奇給稽借棘箕級圾嘰戟麂躋蹟籍濟輯畸嵇幾其肌期集戢飢雞極癘璣基磯畿姬勣
鑄	助薴駐箸祝註注蛀柱佇杼住	諸逐軸朱躅茱硃渚拄蛛誅術主囑珠豬築朮貯竺侏藷屬煮燭矚株銖竹
鎰	屹藝肄軼刈誼囈縊逸佾溢劓疫懿毅義邑億液佚役易羿弋裔蜴驛弈帟譯翌異益臆亦艾腋曳詣議意繹憶掖浥翳奕一抑翼衣	漪尾咦姨椅壹蟻飴旖誼偯迤栘移以彝夷已遺沂宜咿醫頤伊噫疑乙怡貽揖訑迆蛇矣圯胰儀一衣痍倚依
罹	喱璃釐離麗犁犛驪貍籬狸梨黎漓蠡蜊	儷澧醴哩歷靂力慄立溧娌琍粒理利厲邐俐蠣蠡俚莉鬲慄禮麗鯉礫礪唳痢蒞癘壢戾曆吏笠浬例釙荔欐李鋰裡隸酈裡勵瀝
教	礁醮澆焦跤蕉嬌交叫椒覺轎郊較窖膠蛟鮫驕校姣詨	攪礁醮澆矯嚼餃焦跤蕉嬌狡剿交椒叫覺轎郊較勦鉸腳僥窖絞膠繳蛟鮫驕校姣詨皎角
牲	笙昇聲陞甥勝生升	賸省繩乘剩澠勝聖盛
擊	急唧疾脊即寂楫伋吉及嫉汲亟岌藉吃瘠借棘圾級籍輯戢集極	唧霽髻寄脊跡際繼冀繫屐居績稷擠犄薺饑譏技記忌羈騎機乩激積覬己悸劑紀季奇給稽既箕計嘰祭戟麂妓蹟躋驥濟鯽畸嵇幾其肌芰期飢癘雞暨洎璣基薊系磯畿姬勣
鏘	鎗槍嗆將搶腔羌	牆嗆彊戕繈檣搶薔強
婀	阿	愕詻鱷哦鍔蛾扼峨蚵厄遏軛俄啞訛噩惡呃額顎娥鄂餓鵝堊萼
玄	還漩璿懸旋縣	選喧晅渲漩眩諼煖炫軒萱壎鉉絢旋宣暄
典	碘點	靛滇鈿店澱奠電墊殿癲玷顛佃巔惦甸
巳	賜祀泗兕肆食飼伺嗣似耜寺駟姒俟四	撕司廝絲斯鷥私思嘶死
莢	戛挾夾浹頰	稼鉀加架家甲茄駕胛嘉賈假價嫁葭豭傢佳迦袈痂夏夾
瑟	穡嗇塞圾澀色	
唁	釅雁宴研艷硯嚥厭咽贗沿彥諺驗堰焰燄燕淹豔饜晏	言兗演研殷鹽菸奄顏咽巖厭閻簷沿眼湮煙偃魘郾延儼筵燕焉嫣嚴炎醃淹衍妍鼴掩癌胭
沘	筆鄙陂疲脾匕皮妣埤彼陴枇鈹比罷琵紕毗啤鼙裨	劈必璧仳嗶壞逼斃俾陛賁批闢鄙蹕篦媲匹埤祕鈹被比屁紕幣疋弊披譬鉍敝薜痺否箄僻避襞臂庇癖畢愎碧泌蔽丕霹痞詖闢閉弼婢壁睥裨鼻
姍	秈扇纖縿祆刪鮮山舢仙煽跚羶衫杉珊潸掀暹先芟	峴餡涎煽限莧銑舷銜啣陝鱔現扇膳疝訕羨鮮鹹獻陷縣賢僩禪擅繕汕贍嫌顯單鹹癬嫻險霰腺閒絃閑憲弦蜆善閃線蘚
實	塒時什碩拾射食十蝕石提	濕詩室恃施螫屎筮師史匙奭勢嗜舐豉矢市士事仕拭識試世釋柿逝是駛適噓屍侍示飾豕軾溼獅失誓弒始氏式蝨噬使視
枓	陡鬥蚪抖	豆讀鬥竇痘脰都兜逗
咿	漪伊壹噫一揖醫衣依	蟻藝屹肄軼刈誼囈迤移縊逸以彝溢佾已夷沂宜劓疫頤疑乙懿鎰毅義訑迆蛇邑億液役佚儀易羿倚裔尾弋咦姨蜴椅驛飴弈旖譯帟翌異益偯栘臆遺亦艾腋曳議詣意繹怡貽憶掖浥翳矣圯胰奕一翼抑衣痍
瓜	蝸括刮聒呱颳	掛卦褂寡
香	廂瓖鑲箱湘襄鄉相	橡餉翔鄉嚮相向象饗詳降響祥像巷庠想項享
矓	聾龍窿籠嚨隆瓏朧	攏壟隴
餃	攪狡鉸腳僥絞剿姣繳矯較勦皎角	礁醮澆嚼焦跤蕉嬌教交叫椒覺轎郊較窖膠蛟鮫驕校姣詨
似	泗四伺兕嗣俟巳食耜祀駟賜寺飼肆姒	嘶絲思斯廝死私司鷥撕
貂	刁凋叼彫碉鯛雕	掉釣吊調弔
拓	柝唾	妥託駝脫馱佗跎橢拖陀鴕沱
蔗	浙這宅鷓	赭者遮蜇着轍哲褶摘摺謫著螫折輒懾
順	舜瞬	盾吮
蕭	簫宵霄嘐逍硝消梟削驍哮囂銷瀟	曉校嘯小傚學笑酵孝肖效篠
粳	莖驚涇睛鯨精庚更荊菁兢經羹晶耕旌賡京	竟頸景靖梗勁靜警更徑埂哽井痙亙淨競鏡憬耿敬阱璟逕境
劑	霽髻寄際繼繫稷薺技記忌騎悸覬紀季計祭妓驥濟鯽芰暨洎薊系冀躋既	急唧疾脊跡即寂楫屐居伋績擠吉犄饑譏擊羈機及乩嫉積激己汲藉亟岌吃瘠奇給稽借棘箕級圾嘰戟麂躋蹟籍濟輯畸嵇幾其肌期集戢飢雞極癘璣基磯畿姬勣
圳	俊	尊遵樽撙
愍	閩澠憫敏抿泯皿閔湣	岷玟民
薄	卜鈸博蔔鉑駁箔荸脖搏蘗檗播渤帛亳白柏膊雹薜勃泊簸伯舶擘	抱刨鈸博蔔鉑保駁苞暴箔荸脖玻胞菠搏蘗檗跛播渤葆鉋包帛報亳鑤褓般擘白豹柏寶鮑缽膊飽堡薜勃泊簸褒舶爆伯剝撥
崖		
顓	磚專耑	囀賺撰僎篆轉傳
疇	籌惆躊裯仇愁稠鯈酬綢儔	醜抽溴臭
穗	遂碎祟誶隧歲燧邃	綏髓隨隋雖睢
不	埠佈鈽布怖部步簿	佈卜怖埠鈽捕布補埔部步簿哺
豪	蠔蚵嗥鶴號毫貉濠嚎壕	顥鎬涸號郝浩昊蒿好耗鄗皓
弋	屹藝肄軼刈誼囈縊逸佾溢劓疫懿鎰毅義邑億液佚役易羿裔蜴驛弈帟譯翌異益臆腋亦艾曳詣議意繹憶掖浥翳奕一抑翼衣	漪尾咦姨椅壹蟻飴旖誼偯迤栘移以彝夷已遺沂宜咿醫頤伊噫疑乙怡貽揖訑迆蛇矣圯胰儀一衣痍倚依
啜	輟綽齪	戳
兒	爾壬二人而任仁耳	荏賃稔邇貳而任衽爾忍認餌紉軔飪仞妊耳洱二韌刃
丟		
喻	芋與馭御育瘉寓禺鬱尉癒諭玉澦語煜欲谷裕昱愈聿峪嫗籲預豫浴域獄毓遇堉慾譽禦熨俞燠	與魚諛宇雨雩竽禹予愚禺虞迂齬蝓噢盂圉逾褕圩瘀榆渝語萸漁瑜庾輿嶼歟於腴紆妤隅圄愉羽臾餘淤覦敔俞娛
恣	字漬孳自	仔訾紫滓籽淄錙緇貲梓諮茲子姿孳資孜輜滋諮齜玆髭吱
嵌	纖牽簽搴鉛愆千謙韆遷籤騫縴仟阡	倩潛鈐欠黔淺箝乾幹遣前歉鉗塹譴虔縴錢
釐	悉禧行貍谿羲嬉晰離蟋黎罹吸唏曦希漓蹊犛稀梨淅溪驪狸畦奚蜊犧譆熙攜烯西析兮麗嘻蠡犁僖璃蜥晞棲喱膝犀熹籬	儷席曆醴鯉瀝靂鰓翕立礪蓆麗鬲琍利厲例莉礫昔惜蒞襲係壢唳夕娌熄檄溧笠錫哩徙喜裏荔痢細欐勵隙慄禮理褶釙習戾蠡鋰璽息裡系歙繫李洗隸浬蠣矽俚粒力邐俐澧吏癘汐媳戲潟歷酈
鱖	獗蹶劂桂角孓訣掘鴃抉決譎跪貴腳倔玨攫崛爵觼覺櫃蕨厥絕噱嚼	蹶鮭皈嗟規傀倔鬼閨龜圭癸珪軌詭瑰晷歸
亭	庭蜓婷廷停霆	汀梃廳聽挺艇
噢	雨語與宇庾敔齬圉禹予嶼嘔羽圄	瘉澦域妤藕娛瘀馭獄逾峪昱燠褕蝓竽雩渝覦預漁迂語於毆與紆耦煜慾芋育甌餘歐餘鷗俞歟堉鬱豫毓虞裕盂禦隅籲嫗榆喻愚魚玉欲偶譽禺熨區輿嘔癒寓愈愉諭御谷鬱淤腴臾遇諛圩聿尉瑜予萸浴於
燙	趟	醣淌搪膛帑鏜湯棠螳儻倘瑭堂糖塘唐躺
喉	篌猴侯	逅吼厚候後堠鱟
放		房坊妨防彷訪枋倣芳舫肪紡仿方
公	躬供宮龔釭紅蚣攻恭共工肱功弓	供鞏汞礦共廾拱貢
凳	嶝磴蹬瞪鄧	等登燈
段	緞鍛斷	端耑短
橋	樵憔譙翹僑喬瞧	雀巧蹺鍬俏峭誚鵲翹竅悄鞘撬橇殼敲愀
酣	和蚶鼾	韓瀚含涵喊罕銲悍憾函焊漢寒旱榦撼頷捍翰汗頜
岐	歧淇其琪旗齊琦耆麒棋騎祺臍畦鰭祁崎圻奇衹祇期祈枝錡	愒萋淒妻欺溪豈綺磧棄杞乞汽啟柒器棲企訖谿稽漆慼亟迄悽泣起契憩戚砌七緝氣
志	智制痔致製蛭躓窒質雉峙幟稚炙痣識置輊至滯秩摯知緻治誌	徵植脂梔直摭之址質泜芝值胝躑枝吱祉祇肢擲支趾執祗職汁咫只殖織卮紙隻芷止蜘知姪指氏旨
頗	叵剖	珀迫鄱波陂破樸潑婆泊坡魄粕醱
挫	厝錯撮措銼	搓蹉磋撮嵯
擎	傾檠晴情	請親傾蜻輕清氫頃青鯖磬卿慶罄
樓	婁螻嘍髏	簍漏陋鏤瘺摟露
蔣	獎槳講	醬絳僵江薑彊疆姜將強繮漿韁匠降
督	都嘟	讀度妒蠹毒堵牘鍍睹瀆犢渡賭髑黷篤肚獨杜櫝
僎	賺撰篆轉傳	磚囀專耑轉顓
另	令	零菱泠靈鴒齡聆綾拎蛉櫺羚玲鈴苓陵領昤嶺伶凌翎
爐	鑪盧瀘鱸廬蘆臚顱	虜路僇嚕擄露錄鷺穋氯陸櫓滷賂戮麓魯鹵碌鹿祿
菅	箋監間尖肩縑湔兼姦堅韉漸殲奸緘艱濺煎	件檻劍健僭見艦毽漸諫囝檢柬簡濺減筧踐監箭間閒薦腱鍵剪建鹼瞼繭餞鑑鑒澗賤撿揀儉薦
擢	鐲著酌濁卓拙濯斫灼琢啄茁	棹涿捉桌
隴	攏壟	聾龍矓窿籠嚨隆瓏朧
揭	皆街階偕結接嗟	睫傑節櫛芥竭姐潔捷姊頡疥擷戒結桔孑藉羯桀借劫拮碣界解訐介屆詰誡截
血	寫削雪穴	卸洩歇薛榭蠍屑諧頡楔擷蟹邪邂勰鞋契褻懈穴偕學謝駭攜械燮解挾雪靴斜些噱瀉協紲脅屜
舨	板闆鈑阪版	搬般瓣拌斑扮頒辦瘢姅絆班扳半伴
漿	僵江薑疆姜將繮韁	獎絳彊槳蔣講將強醬匠降
邈	緲渺杪秒杳藐眇	描瞄妙苗繆廟
瘁	橇萃翠悴粹脆淬	催璀崔摧衰
碧	庇埤幣裨箄襞篦蔽鄙必弊斃比蹕詖鉍賁陛避畢壁嗶闢璧臂敝痺愎泌睥婢薜閉祕弼俾	逼鄙匕筆鼻沘比妣彼
肩	縑間韉濺奸尖煎兼姦漸湔堅緘艱菅監殲箋	餞澗鑒劍儉閒毽減諫箭僭踐柬艦件健建撿簡瞼揀筧間檻繭見剪鹼檢監賤濺薦腱囝漸鑑鍵
已	蟻迆椅以乙矣旖倚尾迤偯	劓羿浥益藝軼鎰姨痍肄頤憶遺佚翌伊夷一屹栘貽溢臆囈訑疑咿揖議意刈依噫移蛇役圯億沂繹弋迤腋毅譯儀詣怡咦縊逸抑漪彝懿壹醫液帟翼義疫飴異胰艾奕衣佾誼翳掖易裔邑曳亦蜴驛宜弈
桂	跪貴櫃鱖	晷龜皈歸詭閨鮭癸規圭珪瑰鬼傀軌
霧	鎢誤惡戊勿悟塢騖物寤軏堊兀晤務	無巫毋圬屋梧嫵惡舞汙烏吾誣鎢吳五侮鼯於蕪捂鵡憮嗚蜈午亡武伍污唔
築	燭軸術築朮躅竺逐竹	諸朱蛀茱鑄硃渚助拄箸誅注主囑珠豬薴祝貯柱杼侏藷屬煮駐註矚佇株銖蛛住
憬	頸景井阱璟警	竟驚涇靖粳睛精勁靜更徑兢晶旌京莖痙鯨競淨荊鏡菁敬經逕境
鏢	鑣彪膘標杓	表錶鰾婊
勣	畸姬畿其璣羈肌犄飢癘雞磯乩幾唧積箕幾奇譏激績期屐機嵇跡稽蹟基躋嘰居饑	洎棘疾暨忌祭集脊己騎藉芰劑幾記楫瘠覬紀計級極妓冀戢擊寄輯寂給薊及嫉際幾唧麂繼擠急伋薺吉季圾即稷髻霽技汲吃亟既悸躋籍繫岌濟鯽戟驥
坷	渴可	科顆軻喀剋克殼苛恪嗑蝌磕緙柯稞蚵棵可課窠咳瞌溘客刻髁
本	苯畚	奔笨賁
踟	持弛馳池匙遲墀栘	赤熾翅褫啻尺恥蚩癡呎侈癡叱敕吃齒斥嗤魑飭笞喫
呼	忽惚戲乎	鵠虎葫扈唬湖許瑚戶壺弧鬍沍瓠護互囫糊狐胡滬蝴琥楛斛
耶	噎琊椰爺	也噎曄琊冶鄴葉謁業拽椰頁野靨射夜咽爺
聾	隆窿籠龍矓瓏朧嚨	隴攏壟
祀	賜泗兕肆食飼巳伺嗣似耜寺駟姒俟四	撕司廝絲斯鷥私思嘶死
經	晶鯨睛莖京更精荊粳菁兢驚旌涇	靜競井淨警敬勁痙頸鏡阱憬璟竟景徑逕靖境
透		頭偷投
鳥	嬝裊	尿
幟	智制痔致製蛭躓窒質雉峙稚炙痣識置輊至滯秩摯知緻治志誌	徵植脂梔直摭之址質泜芝值胝躑枝吱祉祇肢擲支趾執祗職汁咫只殖織卮紙隻芷止蜘知姪指氏旨
轉	撰篆囀傳僎賺	耑撰磚囀篆傳顓僎專賺
刷		耍
涅	鑷蘗囁齧鎳孽聶臬躡	捏
栘	姨咦飴誼匙迤移弛馳夷彝遺沂宜遲頤疑怡貽踟訑蛇持胰圯儀一池墀痍	漪啻蟻藝屹肄軼刈誼囈迤齒縊以逸佾已溢嗤劓醫疫赤褫噫乙恥懿鎰呎毅揖義迆邑斥億液役佚易羿倚尾弋裔熾翅蜴椅壹驛弈尺蚩旖癡譯帟翌異敕益偯臆亦艾腋曳咿議詣魑飭意笞喫伊繹憶侈癡叱吃掖浥翳矣奕一翼抑衣依
鈔	勦超剿抄	潮炒巢吵朝嘲晁
受	獸狩壽授售瘦綬	守收手首熟
滕	籐籐謄疼騰	
詰	捷劫拮櫛桔截節羯訐傑竭桀睫擷孑結潔頡傑碣	姊階芥皆解街嗟戒揭疥界偕藉誡結姐借介接屆
忪	嵩鬆盅忠鍾中鐘衷鬆崧終淞	宋訟踵仲眾送塚誦悚頌湩中腫慫重聳塚種
銖	誅硃蛛豬諸朱藷茱侏珠株	主軸杼薴註築柱矚囑朮築屬燭煮鑄住渚助竹竺佇蛀拄箸貯駐躅逐注祝
跨	胯	垮誇
宇	與圄庾齬羽噢嶼圉雨予禹語敔	芋與馭御喻魚育諛雩予竽瘉愚禺虞迂鬱寓尉蝓癒盂逾褕諭玉圩澦瘀榆渝語煜漁欲谷瑜萸輿裕歟於昱愈腴紆聿妤峪嫗隅籲預豫娛域愉浴臾獄毓餘遇淤堉慾覦譽禦熨俞燠
竽	盂妤隅娛榆愚魚逾禺輿愉褕蝓雩渝覦腴漁臾於諛圩餘餘瑜俞予歟萸於虞	瘉澦域瘀宇馭獄峪昱燠雨預迂語紆與煜齬慾噢芋育俞堉鬱豫羽毓裕禦籲嫗敔喻玉欲圉譽禺禹熨嶼癒寓愈諭圄御谷鬱淤遇庾聿尉予浴
橫	恆桁衡	哼恆桁衡亨
蠍	歇些	攜蟹協斜邪駭挾懈燮諧楔鞋洩頡血紲脅邂榭屜解洩寫屑卸械瀉謝褻契偕擷勰
洌	冽烈獵裂列劣鬣捩	咧
麒	歧淇其琪旗齊琦耆棋騎祺臍畦鰭祁崎圻奇岐衹祇期祈枝錡	愒萋淒妻欺溪豈綺磧棄杞乞汽啟柒器棲企訖谿稽漆慼亟迄悽泣起契憩戚砌七緝氣
陲	垂捶槌錘箠椎綞鎚	炊吹
派	湃	排俳牌徘拍啪
包	胞褒苞	抱葆鉋刨雹報飽薄鑤堡褓保豹爆寶鮑暴
祗	肢祇織梔枝泜蜘支氏知隻只之脂胝芝卮汁吱	雉秩幟止蛭志芷值址執祇祉峙治制紙質誌姪稚窒植咫痣智緻滯致置痔摭至摯製輊躑躓直擲知識徵只炙趾指職旨殖
萌	朦虻蒙檬濛甍盟矇懵	夢孟蜢錳艋猛懵
妊	衽刃紉韌認仞飪軔任賃	仁荏稔壬人忍兒任
嚴	沿言炎鹽簷妍顏筵延巖閻癌研	釅雁宴兗演研艷殷硯嚥菸奄咽厭贗沿眼湮彥諺煙偃魘驗堰郾焰儼燄燕焉嫣唁醃淹衍豔鼴饜掩胭晏
須	鬚噓訏胥墟戌籲虛需	咻卹婿序許洫煦徐恤緒酗畜絮頊栩續蓄敘旭勗
蹄	緹題隄啼堤提	梯悌銻剔涕踢惕替嚏剃逖體屜
肫	屯諄	準準
巉	饞讒禪澶蟬潺孱蟾毚嬋單纏	懺剷摻諂攙儳鏟闡產羼
江	僵薑疆姜將繮漿韁	獎絳彊槳蔣講將強醬匠降
訾	仔紫滓籽子梓	恣淄漬錙緇貲諮茲字子姿孳資孜輜滋諮齜玆髭自吱
漆	趣七谿棲慼淒柒悽戚娶萋溪妻欺去	器取憩旗啟趨祈豈渠驅娶砠琦琪汽耆麒劬企錡起杞曲臍齲齊磧泣祁騎衢砌亟枝祇蛐契棋畦區奇麴訖屈稽迄啓圈軀只璩崎淇蛆緝嶇綺祺其期棄圻乞瞿氣衹愒歧岐鰭妻
遘	購構雊垢媾夠詬搆	勾狗句枸鉤溝苟
螺	鑼騾玀羅鏍儸邏囉蘿籮	裸落洛酪絡烙咯駱犖囉珞雒
頸	景井阱憬警璟	靜競精荊淨兢京旌敬經粳勁菁驚痙涇晶鏡鯨睛莖竟更徑逕靖境
罰	法閥筏伐乏砝	法琺伐髮發
林	鄰淋遴痳燐轔琳磷鱗霖臨麟璘	吝凜藺賃躪懍
鋤	除芻儲廚雛櫥跦躇	怵齣杵褚絀觸初出矗儲歜楚畜黜處楮礎
識	智制室恃螫痔筮致奭製勢嗜舐蛭豉躓市質窒雉士緻事仕拭峙幟稚誌炙痣置輊試世釋柿逝是至適滯侍示飾軾秩摯誓弒知氏式治志噬使視	濕詩徵植脂駛十施梔屎直師摭匙提之史旨矢址射食質泜芝值胝躑枝吱祉祇肢擲支趾執祗碩職拾汁蝕咫只殖織卮塒噓屍紙隻芷時什溼獅豕止失蜘知姪始氏指蝨實石使
裝	莊妝樁	壯撞狀奘
榕	鎔蓉戎榮容熔融絨溶茸嶸	茸冗
笞	嗤蚩癡魑癡吃喫	赤熾翅褫啻尺恥呎踟侈匙敕叱栘齒弛持馳斥池飭遲墀
釀		娘孃
婢	弊璧必敝鉍薜嗶痺箄襞避臂斃庇畢愎俾陛碧賁泌鄙蹕篦蔽詖埤闢閉弼祕比壁睥幣裨	彼鄙筆逼匕比沘鼻妣
狽	鋇背倍臂貝輩備孛悖憊邶焙蓓被	碑背杯北卑裨揹悲盃俾
莧	現僩霰峴腺餡羨憲獻限蜆陷縣線	纖涎顯嫌銑舷銜暹啣鹹秈癬嫻險祆姍閒閑絃鮮鹹仙弦蜆掀先賢蘚
霜	雙孀	塽爽
玥	粵越嶽耀閱悅躍月樂鑰刖軏嶽藥曜籥說	曰約
遲	持馳墀池栘弛踟匙	飭喫褫赤癡斥叱呎翅魑吃敕蚩侈啻尺笞熾齒恥嗤
繫	洎暨系寄忌汐祭翕薊戲騎隙芰際劑細繼薺係記季稷髻霽矽技紀覬既潟夕悸計躋濟歙妓鯽驥冀	璣烯疾嬉脊惜乩璽積洗幾析績機屐楫跡嵇基錫極級居曦熹悉擊犀給犄蜥稀及飢希幾麂伋擠奇熙汲喜稽勣犧籍躋席奚熄僖攜棘羈蓆肌集膝己藉磯雞溪期媳瘠棲蹟息蟋羲蹊褶昔畸戢姬淅畿其禧輯寂行嫉癘吸習唧徙箕畦晰兮急鰓吉激譏圾釐即譆谿吃亟唏嘻晞西岌嘰濟戟襲檄饑
蝠	孚拂夫芙袱菔氟符幅服扶芾輻伏俘匐彿紼縛浮涪福弗怫紱	富斧夫敷莆父復腐覆阜腑撫駙複輔傅鈇俯釜甫膚咐訃附腹賦賻副頫婦伕脯府付趺孵麩負馥赴
哦	額俄蛾訛娥峨鵝蚵	詻愕鱷遏喔俄軛啞噩惡呃鍔顎婀餓扼阿鄂厄萼堊
追	隹椎錐	贅綴墜惴
菲	啡誹霏斐妃匪扉翡非飛	肥誹肺匪費非廢沸吠芾斐妃屝痱啡霏腓扉怫翡飛
杞	起乞啟豈稽綺	歧琪齊琦耆棋騎妻祺溪棄磧祁祇期器祈棲訖枝漆迄慼錡氣其淇愒旗萋麒淒欺臍畦鰭崎圻汽奇岐衹柒企谿亟悽泣契憩戚砌七緝
卞	遍釆辯辮辨弁變汴便	褊鞭扁砭邊蝙編貶匾
翹	樵憔譙蹺俏峭誚橋僑竅鞘撬殼喬瞧	憔雀譙俏鵲殼愀蹺竅鞘悄瞧巧鍬僑峭喬樵誚橋撬橇敲
插	叉差喳	搽察剎岔詫差茶查
蕩	盪擋當	讜黨儅擋噹襠檔當鐺
湩	眾仲中重種	踵盅忠鍾衷塚終忪中腫鐘塚種
斑	頒搬扳般瘢班	半姅舨版板阪伴辦扮瓣絆鈑闆拌
乍	搾炸柵吒蚱砟咋詐	閘炸扎渣紮喳札眨查
惕	悌銻涕替剃逖嚏屜	體題隄梯緹剔蹄踢啼堤提
秧	殃泱鞅央鴦	楊颺羊養昜漾洋鞅樣怏徉揚氧仰烊煬鍚瘍陽暘癢恙佯
圖	酴凸餘突塗徒屠途荼	土禿菟吐兔
痺	弊璧必敝鉍薜嗶箄襞避臂斃庇畢俾愎陛碧賁泌鄙蹕篦蔽詖埤闢閉弼婢祕比壁睥幣裨	彼鄙筆逼匕比沘鼻妣
葩	啪趴	耙怕扒杷琶爬帕
菜	採蔡	踩睬猜採纔材才綵財裁彩
乏	罰法閥筏伐砝	法琺伐髮發
蓋	褐劾曷概丐荷禾郃何嗑溉河閤閡涸闔盒鈣盍翮核合紇貉和	垓訶赫鶴賀暍郝賅嚇改和荷該呵喝
熟	叔贖淑菽塾孰	獸鼠漱黍守狩庶束署首戍曙輸數薯術手梳壽售述瘦暑舒收蜀恕書藷受殊綬疏屬橾墅抒豎樹蔬倏授樞
招	釗晁着著朝嘲昭召	櫂找詔罩趙肇兆沼炤爪召棹照著晁
咻	脩煦休修栩許羞	敘溴絮袖朽蓄徐鬚需勗岫續噓序墟胥恤畜洫秀酗婿籲鏽卹戌須緒頊訏宿嗅臭虛繡旭
萬	腕玩惋	玩蜿宛碗灣莞輓汍婉頑娩晚剜綰皖彎挽豌丸完
歇	些蠍	卸洩榭寫屑血諧頡楔擷邪蟹邂勰鞋契褻懈偕謝駭攜械燮解挾斜瀉協紲脅屜
髯	然苒染冉燃	然苒染冉燃
按	菴暗岸黯案	鞍庵安鵪俺諳銨氨
甚	脤慎什滲沁蜃腎舌蛇神	攝涉葉慎捨身沁哂深麝社脤沈舍射呻神砷參滲拾設蜃賒瀋莘申紳娠伸信歙審腎嬸奢赦
債	祭責寨	齋宅窄齊摘翟
琶	耙扒杷吧罷爬	跋笆伯吧芭帕耙疤怕壩啪巴八把靶霸葩叭扒鈸捌爸罷拔灞趴
顫	棧站綻湛暫佔蘸戰	斬嶄沾瞻展盞輾霑佔詹譫氈
叻	樂垃肋勒	了
釜	頫斧莆輔甫父脯俯府撫腑腐	氟縛匐馥覆附膚鈇複夫蝠紼扶芾幅紱袱賻傅付拂涪赴彿服賦芙俘訃富阜孚弗輻福浮腹伏符菔副復敷怫婦孵趺咐父麩負伕駙
藉	芥棘戢疾擊輯寂集脊疥及嫉誡唧急伋吉解圾即楫瘠汲吃亟戒界級極籍岌借介屆	洎拮皆璣桔暨祭脊桀揭乩劑積幾劫績機屐跡嵇嗟紀覬基居傑冀給犄飢孑幾麂接繼擠奇季解稷髻霽技稽勣既悸繫躋擷結潔鯽捷羈忌節肌己騎芰磯雞頡櫛記期羯訐蹟竭計妓畸階姬畿其寄街截詰傑薊際癘唧箕碣姊薺激譏睫偕嘰濟姐戟驥饑
辯	遍變汴卞弁釆辨辮便	扁鞭蝙編匾邊褊貶砭
寥	聊嘹潦撩寮繚遼燎僚療	料撩暸了燎瞭廖
棉	眠綿	沔靦娩勉麵冕偭湎面緬免
屹	詣劓羿浥異益議藝軼意刈鎰縊肄逸憶抑艾佚奕翌衣佾誼億役翳懿一掖易裔繹液弋帟邑腋曳溢臆翼亦囈蜴驛毅義譯弈疫	咿儀揖怡飴咦依姨迆痍胰頤以遺噫移乙矣蛇衣伊夷誼尾漪圯蟻彝已壹一醫沂旖栘倚迤貽椅訑宜疑偯
前	潛鈐黔箝乾幹鉗虔錢	倩淺鉛謙韆嵌歉纖愆遣籤塹搴仟千牽欠簽遷騫譴縴阡
僚	聊嘹潦寥撩寮繚遼燎療	料撩暸了燎瞭廖
雋	倦卷郡峻濬眷俊圈絹浚駿狷蕈竣菌	卷窘捐捲鐫娟鈞龜圈身軍涓鵑君均
瀲	鍊戀殮斂練煉鏈楝	簾蓮聯簾鰱濂連奩漣憐鐮廉臉
柑	乾幹尷甘坩疳肝竿杆桿	敢淦幹橄榦桿感稈趕贛
濡	燸儒茹嚅蠕如孺	女茹入汝乳褥辱孺
郭	蟈堝鍋	幗裹摑過果國猓槨
景	穎郢井阱憬警璟影頸	靜盈瑛嚶瓔競楹精荊淨迎兢櫻應纓旌京嬴敬熒螢經粳勁贏菁驚痙營涇嬰晶鏡鯨映莖睛瑩鸚鶯縈膺竟鷹罌蠅瀛英更塋徑硬逕靖境
疸	撢膽	簞誕丹淡蛋石憚彈但啖啗氮旦擔耽單澹
赤	啻飭熾敕翅斥叱	喫褫遲癡弛踟匙持呎馳池魑吃栘蚩侈尺笞墀齒恥嗤
楫	棘戢疾擊輯寂集脊及嫉藉唧急伋吉圾即瘠汲吃亟級極籍岌	洎璣羈暨忌肌祭脊己騎芰雞磯乩劑積幾記績期屐機嵇跡覬紀蹟基計妓居冀畸姬畿其寄給犄薊飢癘際幾唧箕麂繼擠薺奇譏激季稷髻霽技勣稽既悸躋繫嘰濟鯽戟驥饑
麥	賣脈邁	買埋霾
涕	悌銻惕替剃逖嚏屜	體題隄梯緹剔蹄踢啼堤提
鐸	奪多	墮馱咄度剁踱跺惰舵躲多朵
衢	劬渠麴瞿璩	趨嶇去娶取趣瞿漆蛆屈齲圈砠曲區蛐軀驅
蹕	弊璧必敝鉍薜嗶痺箄襞避臂斃庇畢俾愎陛碧賁泌鄙篦蔽詖埤闢閉弼婢祕比壁睥幣裨	彼鄙筆逼匕比沘鼻妣
贛	淦幹榦	乾竿甘疳柑尷感幹桿橄坩敢桿稈肝趕
蜃	腎滲甚沁脤慎	哂砷信審甚瀋申莘伸呻娠深身嬸紳參神沈
匐	氟縛夫蝠紼扶芾幅孚弗輻紱袱福浮伏符菔拂涪怫彿服芙俘	富馥覆附膚俯鈇複府夫腑腐頫甫阜腹賻副傅復釜敷付撫斧孵赴婦莆趺輔咐父麩脯賦負駙伕訃
紆	淤迂瘀	瘉澦妤域娛宇馭獄逾昱峪燠褕蝓竽雨雩渝覦預漁語於與煜齬噢慾芋育餘餘俞歟堉鬱豫羽虞毓裕盂禦隅籲嫗榆敔喻愚魚玉欲圉譽禺熨禹嶼輿癒寓愈愉諭圄御谷鬱腴遇臾諛庾圩聿尉瑜予萸於浴
覓	泌密糸汨蜜祕冪謐	靡瀰米謎敉糜弭瞇咪迷麋彌
囫	瑚壺鬍鵠蝴胡糊湖葫弧斛狐	瓠互琥虎扈許惚唬乎戲呼戶忽滬楛沍護
祖	組俎詛阻	卒嗾租族足
昤	齡蛉菱櫺玲翎聆鴒泠苓凌陵綾鈴靈羚零伶	領拎令另嶺
詨	教礁澆跤姣驕郊鮫嬌焦膠交椒蛟蕉	教較餃勦姣轎皎狡窖腳繳僥鉸攪角校絞叫矯剿覺醮嚼
毅	詣劓羿浥異益議藝軼意刈鎰縊肄逸憶抑艾佚奕翌衣佾誼億役翳懿一掖屹易裔繹液弋帟邑腋曳溢臆翼亦囈蜴驛義譯弈疫	咿儀揖怡飴咦依姨迆痍胰頤以遺噫移乙矣蛇衣伊夷誼尾漪圯蟻彝已壹一醫沂旖栘倚迤貽椅訑宜疑偯
楛	瓠互苦戶滬沍護扈	壺鬍窟鵠蝴琥酷許哭斛惚唬戲呼枯狐骷胡湖囫葫弧虎瑚乎忽糊庫褲
鏽	袖溴秀岫繡臭嗅宿	咻脩休朽宿羞修
獸	瘦狩壽授售受綬	守收手首熟
爭	癥諍徵丁猙掙箏怔睜崢錚症蒸正	政整拯掙幀証鄭證症正
展	盞斬嶄輾	棧站沾瞻綻霑湛暫佔蘸顫詹譫氈戰
啟	起杞乞豈稽綺	歧琪齊琦耆棋騎妻祺溪棄磧祁祇期器祈棲訖枝漆迄慼錡氣其淇愒旗萋麒淒欺臍畦鰭崎圻汽奇岐衹柒企谿亟悽泣契憩戚砌七緝
敷	伕夫鈇趺孵麩膚	孚富拂斧夫芙莆父復袱腐蝠菔氟覆阜撫腑符駙複幅輔服馥傅俯釜扶甫咐芾訃附輻腹俘賦伏匐賻彿副頫婦紼脯縛府付涪浮福弗怫負紱赴
賢	嫌銜嫻鹹舷啣弦閑閒絃涎	莧陷限獻蘚祆秈暹鮮纖霰先銑險線仙蜆顯癬腺羨餡僩掀憲現峴姍縣
咦	姨飴疑怡貽誼訑迤蛇栘移彝夷遺沂圯胰儀宜一痍頤	漪蟻藝屹肄軼刈誼囈迤縊以逸佾已溢劓醫疫噫乙懿鎰毅揖義迆邑億液役佚易羿倚尾弋裔蜴椅壹驛弈旖譯帟翌異益偯臆亦艾腋曳咿議詣意伊繹憶掖浥翳矣奕一翼抑衣依
贊	暫瓚讚鏨	簪偺咱
賊	責窄嘖笮則澤咋擇	仄怎側
諍	睜掙徵錚正箏癥猙爭崢蒸怔徵丁	政掙拯證証鄭正症幀整
弭	靡敉米	謎彌密糸蜜咪糜靡汨祕覓瀰祕冪麋瞇謐泌迷
雍	擁鄘傭臃邕慵庸壅	擁踴泳傭永湧勇傭甬蛹臃用俑詠湧壅恿
婊	表錶	鏢鑣彪膘標鰾杓
幽	悠優攸憂	囿佑誘幼友侑又祐猶疣鈾柚遊莠油由酉魷右牖宥黝有釉郵尤猷鼬
炭	碳嘆探歎	探覃貪罈坦談坍袒攤癱毯彈曇痰潭譚灘壇檀
絆	半姅伴辦扮瓣拌	頒搬斑扳舨版板般瘢阪班鈑闆
餡	莧陷霰憲腺限羨現獻峴蜆線僩縣	賢蘚閒祆秈暹涎鮮纖先嫻銑險仙蜆顯癬嫌弦啣閑絃掀銜鹹舷姍
途	酴凸餘突塗徒屠圖荼	土禿菟吐兔
酬	籌惆躊裯仇疇愁稠鯈綢儔	醜抽溴臭
跟	根	亙艮
丸	汍玩完頑	萬玩蜿宛碗灣莞輓婉晚娩腕剜綰皖彎惋挽豌
誹	匪斐菲翡	菲吠肥啡飛霏芾妃腓扉費屝怫痱廢非沸肺
黑	嘿	嘿
盲	氓芒忙茫杗	蟒莽
眺	頫覜跳	挑條佻調迢蜩窕
心	薪訢莘昕鋅辛新芯馨欣	信釁尋芯
檜	筷劊會塊膾儈快	
宗	鬃綜縱棕蹤	綜糉從總縱傯
秈	纖祆姍暹掀鮮先仙	僩峴餡涎顯限嫌莧銑舷銜啣鹹癬現霰險嫻腺閒鮮閑絃羨鹹憲獻弦蜆陷縣線賢蘚
綴	贅墜惴	追椎錐隹
錢	潛鈐黔箝乾幹前鉗虔	倩淺鉛謙韆嵌歉纖愆遣籤塹搴仟千牽欠簽遷騫譴縴阡
邢	形行硎型陘刑	醒性腥興倖杏姓省幸悻猩馨惺星
渚	主囑貯屬拄煮矚	軸杼薴註築柱諸朱茱銖朮築燭鑄住助竹竺佇蛀藷侏硃誅蛛箸駐躅逐注豬祝株珠
瑪	螞碼嗎馬	痲媽麻罵嘛嗎蟆嬤麼
垣	緣媛源員原轅園圓援騵猿湲元爰袁沅	宛院苑媛願淵願冤鴛鳶怨遠
躊	酬稠儔仇疇綢愁籌裯鯈惆	溴抽臭醜醜
了	料暸燎遼瞭	聊嘹撩勒廖潦垃肋樂叻寥僚療料寮繚遼燎瞭
阬	吭鏗坑	
爹		迭耋跌絰喋牒疊碟諜蝶
雯	文聞紋玟蚊	紊抆刎汶文聞問吻瘟溫穩免塭
惴	墜綴贅	追隹椎錐
鍔	愕詻鱷遏俄軛啞噩惡呃顎餓扼鄂厄堊萼	額俄蛾哦婀訛娥阿峨鵝蚵
孽	鎳聶臬蘗涅躡囁鑷齧	捏
抹		墨脈魔漠沒麼歿膜末貊蘑默糢茉摹莫摩磨摸陌沫模寞驀謨秣
鼠	數薯屬暑黍蜀署藷	漱庶束署戍曙輸數術贖梳菽述舒叔淑恕書殊疏塾橾墅抒豎樹蔬倏樞熟孰
很	狠	痕恨
朱	諸誅珠茱株豬銖蛛硃侏藷	軸蛀躅鑄渚助拄箸術注主囑薴祝築朮貯柱竺杼屬煮燭駐註矚佇逐竹住
喫	嗤蚩癡魑癡笞吃	赤熾翅褫啻尺恥呎踟侈匙敕叱栘齒弛持馳斥池飭遲墀
撤	澈坼徹掣轍	車扯
墟	須胥訏鬚需虛籲戌噓	敘恤畜絮洫蓄婿酗卹許緒頊徐煦勗咻栩續旭序
趴	葩啪	琶爬扒怕耙帕杷
術	漱軸庶束署戍曙數述恕築疏燭墅豎樹倏逐竹	諸鼠黍朱蛀署鑄住輸數薯助拄贖注梳主珠囑菽豬暑舒祝叔淑蜀書貯柱藷殊疏塾屬煮橾駐抒蔬株蛛樞熟孰
沌	鈍燉囤噸頓盾遁盹	蹲躉墩敦惇盹
鄞	垠夤吟銀齦淫簷寅霪	癮聽胤印飲因尹茵音湮姻陰縯慇氤蔭殷隱引蚓
庭	蜓亭婷廷停霆	汀梃廳聽挺艇
計	霽髻寄際繼繫稷薺技記忌騎悸覬劑紀季祭妓驥濟鯽芰暨洎薊系冀躋既	急唧疾脊跡即寂楫屐居伋績擠吉犄饑譏擊羈機及乩嫉積激己汲藉亟岌吃瘠奇給稽借棘箕級圾嘰戟麂躋蹟籍濟輯畸嵇幾其肌期集戢飢雞極癘璣基磯畿姬勣
煖	萱喧暖壎暄軒晅宣諼	鉉懸漩還炫絢渲眩選旋縣璿玄
廝	撕司絲斯鷥私思嘶	賜祀泗肆兕食飼巳嗣伺耜似寺駟姒俟思死四
濁	卓灼濯着啄茁著斫拙琢擢酌鐲	桌涿捉棹
盤	胖踫磐般蹣蟠槃	拚潘畔叛攀判盼
步	埠佈鈽不怖部布簿	卜捕補不埔哺
敦	墩蹲惇	燉頓遁盾噸沌囤盹鈍躉
苟	狗枸	鉤遘夠雊媾句詬搆構購勾枸溝垢
糜	靡瀰謎迷麋彌	靡米泌敉密糸祕弭汨瞇咪蜜冪謐覓
迥	窘炯	
崑	髡琨焜坤錕昆	睏捆綑困梱
錄	鷺穋氯路僇碌陸鹿祿露賂戮麓	鑪魯虜盧瀘鹵鱸廬蘆嚕臚櫓擄爐滷顱
隨	隋	綏遂髓碎祟誶穗隧歲雖睢燧邃
圭	閨龜珪瑰鮭皈傀規歸	鬼桂鱖癸軌跪詭晷櫃貴
課	緙喀可恪剋嗑溘克客刻髁	窠科棵稞軻咳坷柯顆蚵可瞌蝌渴磕殼刻苛
釋	室恃螫筮奭勢嗜舐豉市士事仕拭識試世柿逝是適侍示飾軾誓弒氏式噬使視	濕詩十施屎師史匙提矢射食碩拾蝕駛塒屍噓時什溼豕獅失始蝨實石使
裸		洛騾絡烙鏍咯囉珞玀螺雒羅駱蘿籮落鑼酪儸邏犖
驕	蛟礁鮫教嬌蕉澆姣膠交焦椒詨郊跤	攪醮矯嚼餃狡教剿叫覺轎較鉸勦腳僥窖絞繳校姣皎角
梵	販氾汎犯範飯泛範	繙礬番反藩蕃墦樊凡煩翻釩返幡繁帆
誓	室恃螫筮奭勢嗜舐豉市士事仕拭識試世釋柿逝是適侍示飾軾弒氏式噬使視	濕詩十施屎師史匙提矢射食碩拾蝕駛塒屍噓時什溼豕獅失始蝨實石使
欺	七漆戚淒棲谿悽柒慼萋溪妻	器憩旗啟祈豈琦琪汽耆麒企錡起杞臍齊磧泣祁騎砌亟枝祇契棋畦奇稽訖啓迄只崎淇緝綺祺其期棄圻乞衹氣愒歧岐鰭妻
喧	暄宣晅萱煖諼壎軒	選縣渲漩眩玄炫絢璿鉉懸旋還
姬	畸畿其璣羈肌犄飢癘雞磯乩幾唧積箕幾奇譏激績期屐機嵇跡勣稽蹟基躋嘰居饑	洎棘疾暨忌祭集脊己騎藉芰劑幾記楫瘠覬紀計級極妓冀戢擊寄輯寂給薊及嫉際幾唧麂繼擠急伋薺吉季圾即稷髻霽技汲吃亟既悸躋籍繫岌濟鯽戟驥
廣	獷	洸胱逛光
蕨	鴃掘鱖抉獗決譎蹶劂腳倔玨角攫爵孓崛觼覺訣厥絕嚼噱	倔蹶嗟
籐	滕籐謄疼騰滕籐謄疼騰	
躅	軸竹朮築築燭竺逐	主杼薴註柱諸朱茱矚銖囑屬煮鑄住渚助佇蛀藷拄侏硃誅蛛箸貯駐注豬祝珠株
攀	潘	胖拚畔踫磐般蹣叛蟠槃盤判盼
麋	靡謎彌瀰糜迷	弭密糸米蜜咪靡汨敉祕覓祕冪瞇謐泌
鼕	冬東咚	胴洞董棟凍動懂恫
吉	急唧疾脊即寂楫伋擊及嫉汲亟岌藉吃瘠借棘圾級籍輯戢集極	唧霽髻寄脊跡際繼冀繫屐居績稷擠犄薺饑譏技記忌羈騎機乩激積覬己悸劑紀季奇給稽既箕計嘰祭戟麂妓蹟躋驥濟鯽畸嵇幾其肌芰期飢癘雞暨洎璣基薊系磯畿姬勣
諉	葦尾娓猥偉洧痿緯鮪萎委	魏衛胃蔚維萎威未韋唯遺惟渭濰圍桅為崴味穌煨薇逶餵幃偽慰位危謂帷微巍偎褽尉喂闈畏違委
潯	巡馴徇尋詢璿循荀洵旬	燻汛殉徇薰醺迅訓潠遜馴訊勛巽勳蕈
隙	細翕係系汐繫戲潟夕歙矽	悉禧行谿羲席嬉晰昔蟋洗惜吸釐唏曦希褶蹊稀淅溪襲習畦奚鰓犧譆熙攜烯西析蓆熄兮檄嘻僖蜥晞棲璽息錫媳膝犀熹徙喜
胞	褒包苞	抱葆鉋刨雹報飽薄鑤堡褓保豹爆寶鮑暴
蛹	壅永勇恿泳詠臃湧擁俑踊踴甬	壅庸傭邕臃雍擁鄘慵用
繮	將漿姜江僵疆	槳醬蔣強匠講獎降
啃	肯齦懇墾	
川	穿	船傳釧舛串喘
播	玻菠薄亳般薜擘蘗簸檗剝缽撥	卜鈸博蔔鉑駁箔荸脖玻菠搏蘗檗跛渤帛薄亳般白柏缽撥膊薜勃泊簸伯剝舶擘
嘶	絲思斯廝私司鷥撕	思寺似伺兕食耜祀泗嗣巳駟賜飼肆四俟死姒
鄘	擁傭臃邕雍慵庸壅	擁踴泳傭永湧勇傭甬蛹臃用俑詠湧壅恿
鑣	鏢彪膘標杓	表錶鰾婊
猓	槨果裹	鍋國蟈過堝摑幗郭
薦	餞澗鑒劍閒毽諫箭僭踐艦件健建間檻見監賤濺腱薦漸鑑鍵	尖儉堅艱減菅緘韉柬湔撿簡殲瞼肩筧間揀繭煎姦剪鹼監檢縑濺奸兼漸囝箋
騁	逞	呈稱乘澄丞懲橙秤瞠成撐誠城程承盛
筋	津金觔巾禁斤襟今矜浸	晉饉噤燼覲進儘僅禁瑾近勁謹盡緊縉錦浸
捕	卜埔補哺	埠佈鈽布不怖部步簿
看	戡刊瞰勘堪	戡刊砍檻崁侃堪坎瞰勘
眨	渣	閘搾炸柵渣吒紮乍喳札蚱砟咋詐查
甭		迸蹦崩繃
硃	誅銖蛛豬諸朱藷茱侏珠株	主軸杼薴註築柱矚囑朮築屬燭煮鑄住渚助竹竺佇蛀拄箸貯駐躅逐注祝
儅	噹鐺襠當	黨擋讜當蕩盪檔
鸞	巒灤鑾	卵亂
尹	癮聽飲縯隱蚓引	夤胤銀鄞印飲因齦茵淫簷音寅垠湮姻陰吟慇氤蔭殷隱霪
替	悌銻涕惕剃逖嚏屜	體題隄梯緹剔蹄踢啼堤提
蕞	罪最醉	堆嘴
銳	睿瑞	蕊
誠	呈懲承丞橙乘城成程盛澄	騁秤逞瞠撐稱
摸		抹墨脈魔漠沒麼歿膜末貊蘑默糢茉摹莫摩磨陌沫模寞驀謨秣
杳	緲窈渺杪邈夭咬秒舀藐眇	要喲淆耀夭崤廟謠瑤僥瞄鑰堯繆搖洮邀吆鷂榣腰樂餚姚描麼遙妙餚苗窯藥拗妖曜爻
牴	砥底柢邸抵詆氐	滴鏑荻締迪帝的嘀狄蒂氐弟諦犒翟笛芽低地敵第娣遞棣滌嫡
踴	擁泳永湧勇甬蛹臃俑詠湧壅恿	擁鄘傭臃邕雍慵用庸壅傭
膺	纓應嬰罌瑛英鷹嚶鶯瓔櫻鸚	瑩景郢迎營映贏盈熒應縈嬴穎塋楹蠅瀛硬影螢
鴿	胳割歌疙戈擱哥	革格隔個膈合鬲蛤鉻骼閤箇閣咯鎘各郃葛
杉	芟殺煽珊裟扇煞山紗潸羶舢莎沙跚砂縿刪鯊衫姍	善霎煽鱔扇廈煞疝禪汕繕陝膳擅單傻訕贍閃
跪	貴櫃桂鱖	晷龜皈歸詭閨鮭癸規圭珪瑰鬼傀軌
滬	戶沍扈瓠互護楛	鵠虎葫惚唬湖許呼瑚壺弧鬍乎囫糊狐胡蝴忽琥戲斛
汐	翕潟戲夕隙係繫矽系歙細	攜烯嬉蓆膝惜璽洗溪析媳棲息蟋羲錫蹊昔褶曦淅悉熹禧犀行蜥稀希吸習徙晰畦兮鰓熙釐喜谿譆犧唏晞嘻西席奚熄襲僖檄
婆	鄱	叵珀迫波陂破樸剖泊坡潑魄粕頗醱
誶	碎穗邃歲隧燧遂祟	髓隨隋綏睢雖
櫝	髑瀆讀犢黷牘毒獨	杜蠹堵睹篤賭度鍍嘟渡肚都督妒
敲	鍬橇蹺撬	憔雀譙俏鵲殼愀蹺翹竅鞘悄瞧巧僑峭喬樵誚橋撬
益	詣劓羿浥異議藝軼意刈鎰縊肄逸憶抑艾佚奕翌衣佾誼億役翳懿一掖屹易裔繹液弋帟邑腋曳溢臆翼亦囈蜴驛毅義譯弈疫	咿儀揖怡飴咦依姨迆痍胰頤以遺噫移乙矣蛇衣伊夷誼尾漪圯蟻彝已壹一醫沂旖栘倚迤貽椅訑宜疑偯
諛	盂妤隅娛榆愚魚逾禺輿愉褕蝓竽雩渝覦腴漁臾於圩餘餘瑜俞予歟萸於虞	瘉澦域瘀宇馭獄峪昱燠雨預迂語紆與煜齬慾噢芋育俞堉鬱豫羽毓裕禦籲嫗敔喻玉欲圉譽禺禹熨嶼癒寓愈諭圄御谷鬱淤遇庾聿尉予浴
颯	卅薩	灑撒
俗		溯嗉囌訴酥塑速縮粟甦蘇蓿宿素穌肅夙簌
業	葉曄射頁靨夜咽鄴謁拽	椰耶噎冶野也爺琊
箸	鑄住杼助註薴駐柱蛀注佇祝	主軸築朱諸茱矚銖囑朮築屬燭煮渚竹竺拄藷侏硃誅蛛貯躅逐豬珠株
入	褥孺辱茹	燸如濡汝嚅女辱蠕孺乳儒茹
捧		蓬膨彭朋澎棚鵬抨碰篷硼烹砰
柴	儕豺	拆差釵
靡	瀰米謎敉糜弭迷麋彌	密糜咪迷麋謎糸弭瞇瀰米蜜冪覓泌敉汨祕彌謐
娥	額俄蛾哦訛峨鵝蚵	詻愕鱷遏俄軛啞噩惡呃鍔顎婀餓扼阿鄂厄堊萼
炊	吹	錘鎚陲垂吹綞椎捶槌箠
篩		殺曬骰
桑	喪	嗓喪
烘	哄轟薨	鴻鬨哄紅訌弘汞黌閎虹泓洪宏
拯	整	政爭徵猙幀諍掙睜証證癥丁蒸怔箏崢錚鄭症正
胴	洞棟凍動恫	冬鼕董懂東咚
淹	釅雁宴研艷殷硯嚥菸奄咽厭贗沿湮彥諺煙驗堰焰燄燕焉嫣唁醃豔饜胭晏	言釅雁宴兗演研艷殷硯嚥鹽菸奄顏厭巖咽簷閻贗沿眼湮彥諺煙偃魘驗堰郾焰延筵儼燄燕焉嫣嚴炎唁醃衍豔妍鼴饜掩癌胭晏
扉	菲霏啡非妃飛	費菲痱斐屝肥翡沸腓誹吠怫廢肺芾匪
摺	蜇哲折摘懾輒謫轍褶	浙遮這著蔗螫赭鷓者宅
治	智制痔致製蛭躓窒質雉峙幟稚炙痣識置輊至滯秩摯知緻志誌	徵植脂梔直摭之址質泜芝值胝躑枝吱祉祇肢擲支趾執祗職汁咫只殖織卮紙隻芷止蜘知姪指氏旨
昇	勝升生牲笙甥聲陞	勝澠繩乘賸省聖盛剩
暸	了瞭	寮廖繚聊潦寥撩料療遼僚嘹燎瞭
嚕		滷擄臚鑪鱸戮麓顱爐鷺錄穋祿賂路蘆盧魯露鹵鹿櫓僇碌氯陸廬虜瀘
紮	閘炸札扎匝	柵喳搾扎砟詐砸咋乍查搾眨雜炸咱偺渣吒蚱
驢	閭櫚	呂慮率氯鋁褸履綠律濾膂屢旅婁侶縷
斤	津金觔巾禁襟今筋矜浸	晉饉噤燼覲進儘僅禁瑾近勁謹盡緊縉錦浸
繹	詣劓羿浥異益議藝軼意刈鎰縊肄逸憶抑艾佚奕翌衣佾誼億役翳懿一掖屹易裔液弋帟邑腋曳溢臆翼亦囈蜴驛毅義譯弈疫	咿儀揖怡飴咦依姨迆痍胰頤以遺噫移乙矣蛇衣伊夷誼尾漪圯蟻彝已壹一醫沂旖栘倚迤貽椅訑宜疑偯
娠	砷晨諶信塵賑申震伸呻身辰紳振參沉沈陣鴆枕朕莘宸陳深忱臣鎮	診滲貞真縝趁斟疹腎珍櫬砧疢沁榛偵瞋慎沈稱哂禎襯審枕甚楨針瀋臻讖蜃琛嬸甄脤神箴
籌	惆躊裯仇疇愁稠鯈酬綢儔	醜抽溴臭
諼	萱喧壎煖暄軒晅宣	鉉懸漩還炫絢渲眩選旋縣璿玄
誇	誇	胯垮跨
趕	敢橄感稈杆桿	淦柑乾幹尷榦甘桿疳坩肝竿贛
劍	餞澗鑒閒毽諫箭僭踐艦件健建間檻見監賤濺薦腱漸鑑鍵	尖儉堅艱減菅緘韉柬湔撿簡殲瞼肩筧間揀繭煎姦剪鹼監檢縑濺奸兼漸囝箋
型	形行硎陘刑邢	醒性腥興倖杏姓省幸悻猩馨惺星
葵	揆奎魁夔逵睽	虧餽愧簣潰盔匱喟窺傀
亟	棘戢愒疾擊輯寂集脊及嫉妻藉唧磧棄急伋汽吉圾器即楫瘠訖企汲吃迄泣契憩級極籍岌砌緝氣	歧洎璣暨祭耆脊乩祺劑積幾祁乞績祇機屐祈跡嵇紀覬枝漆基錡居冀旗萋給犄麒飢幾欺麂繼擠崎奇季柒稷髻霽技稽勣既悽悸繫躋七鯽琪羈齊忌琦肌己棋騎芰妻磯雞溪豈綺記啟期棲蹟慼起計妓畸姬畿其淇寄薊淒際癘臍唧箕畦鰭薺圻杞激譏岐衹谿戚嘰濟戟驥饑
輓	宛皖晚綰碗莞蜿娩婉挽	惋彎灣丸完莞頑腕蜿萬玩汍剜豌
漪	咿揖壹一噫醫依衣伊	劓羿浥益藝軼鎰姨痍肄頤憶遺矣佚翌夷一屹栘貽溢臆囈訑疑偯議意刈以移乙蛇役圯億蟻沂繹弋迤腋毅譯儀詣怡咦縊逸抑彝懿倚液帟翼義疫飴異迆胰艾奕衣佾誼尾翳已掖易裔旖邑曳椅亦蜴驛宜弈
誣	無巫毋圬屋梧惡汙吾烏鎢鼯於吳蕪嗚蜈亡污唔	無巫毋勿騖寤軏圬屋梧嫵誤惡舞物汙堊烏吾兀務鎢悟塢霧吳五侮於鼯蕪捂鵡憮晤嗚戊蜈午亡武伍污唔
艘	繅搔騷	嫂掃
蚵	軻哦毫濠稞蠔嚎貉蛾嗥柯峨瞌鶴俄訛壕棵磕額娥科窠刻苛鵝顆豪蝌號	愕詻鱷課渴鍔剋皓髁咳婀殼扼顥好耗厄昊嗑遏浩軛俄啞噩惡溘恪客呃坷鄗顎可蒿喀鎬郝緙克鄂阿餓刻號涸萼堊
鈿	電奠澱殿墊店甸靛玷佃惦	滇巔顛點碘典癲
丁	癥盯諍爭徵猙叮掙箏釘怔睜崢錚酊仃蒸正	錠政頂整拯掙鄭釘訂幀証鼎定證酊廳症正
拾	攝捨涉葉十麝提社舍射食碩設蝕塒時什歙實石赦	濕捨詩室恃施螫屎筮師史匙奭甚勢嗜舐豉矢市士蛇事仕拭賒識試世釋柿逝是氏適噓屍侍駛示什飾豕軾溼獅失誓弒始舌式蝨噬奢使視
鈴	綾零蛉櫺昤菱鴒泠靈羚玲苓伶齡聆陵凌翎	拎令另嶺領
由	鈾遊油尤猶郵魷疣猷	囿佑悠誘憂幼攸友侑優又祐柚幽莠酉右牖宥黝有釉鼬
篛	鶸若弱偌	
幕	慕穆募木目沐睦苜墓暮牧	牡模拇姥姆母畝
活		獲壑穫或惑夥濩貨禍火豁和霍擭
犯	汎梵泛販飯範氾	藩煩反釩蕃礬返樊番繁幡翻凡繙墦帆
璽	鰓徙洗喜	攜烯嬉蓆膝惜溪細析係媳棲息蟋羲夕錫蹊歙褶昔曦淅悉熹禧系犀汐行翕蜥稀戲隙希吸習晰畦兮熙釐矽譆谿犧唏晞嘻西潟繫席奚熄襲僖檄
裹	果猓槨	幗鍋蟈郭摑過堝國
詫	岔剎差	察搽查喳叉茶插差
嫩		
虜	魯鹵櫓擄滷	鱸廬路僇嚕爐露錄鷺穋氯陸臚顱賂鑪瀘戮麓盧碌蘆鹿祿
芭	笆吧疤捌巴扒叭八	吧鈸灞琶拔霸靶壩耙把伯跋罷爸杷
暴	抱鉋刨曝報瀑鑤豹爆鋪鮑	莆保苞誧撲蒲璞普胞樸釙葡僕菩葆濮包薄褓圃鋪寶溥噗脯雹飽堡匍褒譜浦埔蹼
姘	拼	頻品瀕聘嬪牝貧顰
崆	倥空硿	倥孔恐控空
鏖	鼇熬翱嗷遨聱敖	凹澳懊奧媼襖拗傲
削	簫宵霄血雪逍硝消嘐梟穴驍蕭哮囂銷瀟	曉雪校嘯靴小傚穴噱薛笑酵孝學肖效篠
梨	罹麗蠡犁璃貍漓蜊喱狸籬犛驪離釐黎	裏荔琍儷利厲痢例欐莉曆醴礫李勵鯉瀝慄禮隸理浬蒞釙蠣靂俚立粒礪壢唳力邐娌俐戾澧吏麗蠡鬲溧癘鋰笠裡哩歷酈
較	攪醮矯餃狡教剿叫覺轎鉸勦腳僥窖絞繳校姣皎角	攪礁醮澆矯嚼餃焦跤蕉嬌狡教剿椒交叫覺轎郊勦鉸腳僥窖絞膠繳蛟鮫驕校姣詨皎角
賂	鷺穋氯路僇碌陸鹿祿露錄戮麓	鑪魯虜盧瀘鹵鱸廬蘆嚕臚櫓擄爐滷顱
猴	篌侯喉	逅吼厚候後堠鱟
憾	瀚旱銲撼悍焊捍頷翰漢汗頜	韓鼾寒罕函含蚶榦酣涵和喊汗
曝	暴瀑鋪	普埔樸濮樸蹼誧溥菩圃噗匍葡鋪浦釙莆僕撲撲脯譜蒲璞僕
俚	禮澧醴浬理哩鯉邐李鋰裡裡蠡娌	儷哩歷靂力慄立溧黎琍粒璃離利厲狸俐蠣漓蠡莉鬲慄喱麗犁礫礪唳痢犛貍籬蒞癘壢戾曆吏笠釐例釙荔驪欐梨罹隸酈勵瀝蜊
易	詣劓羿浥異益議藝軼意刈鎰縊肄逸憶抑艾佚奕翌衣佾誼億役翳懿一掖屹裔繹液弋帟邑腋曳溢臆翼亦囈蜴驛毅義譯弈疫	咿儀揖怡飴咦依姨迆痍胰頤以遺噫移乙矣蛇衣伊夷誼尾漪圯蟻彝已壹一醫沂旖栘倚迤貽椅訑宜疑偯
閎	訌泓弘黌洪宏紅虹鴻	薨烘哄鬨汞轟
裳	腸嘗嫦嚐徜萇場長償常	氅場悵暢鯧湯敞觴娼昌猖唱殤廠傷晌賞尚倡倀上商
姻	湮殷音陰慇茵因氤	淫蔭霪聽胤印尹吟癮鄞簷飲隱垠夤銀蚓縯引齦寅
燮	蟹邂榭屜解洩屑駭卸械瀉懈謝褻契楔洩紲	攜協歇寫邪斜些挾諧蠍偕鞋擷頡血脅勰
期	唧旗祈跡屐琦居績琪耆犄麒錡饑譏臍齊祁羈騎機乩鰭積激枝祇棋畦奇稽箕嘰躋蹟只崎淇畸嵇祺幾肌其飢癘圻雞衹璣基歧岐磯畿姬勣	霽憩寄擊悸忌騎溪己藉紀瘠訖計圾籍洎躋既器唧脊豈楫稷慼泣覬劑吃季借稽戚祭麂驥鯽七幾集棄愒欺萋啟淒谿悽際伋企吉薺漆磧及砌亟啓棘迄妓濟綺芰戢乞氣薊系冀急髻疾繼繫寂即擠汽起杞技記嫉汲岌契給級柒戟輯緝暨極棲妻
亦	詣劓羿浥異益議藝軼意刈鎰縊肄逸憶抑艾佚奕翌衣佾誼億役翳懿一掖屹易裔繹液弋帟邑腋曳溢臆翼囈蜴驛毅義譯弈疫	咿儀揖怡飴咦依姨迆痍胰頤以遺噫移乙矣蛇衣伊夷誼尾漪圯蟻彝已壹一醫沂旖栘倚迤貽椅訑宜疑偯
九	赳酒玖糾灸韭久	舊究糾救咎臼舅疚廄就揪柩鳩啾
槌	陲垂捶錘箠椎綞鎚	炊吹
政	掙幀証鄭證症正	癥諍爭徵丁猙拯掙箏整怔睜崢錚蒸正
邊	編砭鞭蝙	辯扁遍貶變汴匾褊卞弁釆辨辮便
軼	屹藝肄刈誼囈縊逸佾溢劓疫懿鎰毅義邑億液佚役易羿弋裔蜴驛弈帟譯翌異益臆亦艾腋曳詣議意繹憶掖浥翳奕一抑翼衣	漪尾咦姨椅壹蟻飴旖誼偯迤栘移以彝夷已遺沂宜咿醫頤伊噫疑乙怡貽揖訑迆蛇矣圯胰儀一衣痍倚依
哇	蛙窪挖呱媧	娃襪瓦
揚	楊鍚徉颺瘍陽暘羊洋烊煬昜佯	怏漾煬殃泱養癢氧鞅仰央秧樣鴦恙
煆	丫押鴨呀壓鴉	訝啞衙涯雅亞蚜氬軋押芽牙疋
襤	斕藍闌欄籃攔籣瀾嵐蘭婪	攬欖爛懶濫覽纜
畫	樺話華劃化	樺花華猾滑劃嘩豁譁
至	智制痔致製蛭躓窒質雉峙幟稚炙痣識置輊滯秩摯知緻治志誌	徵植脂梔直摭之址質泜芝值胝躑枝吱祉祇肢擲支趾執祗職汁咫只殖織卮紙隻芷止蜘知姪指氏旨
盈	嬴瑩楹熒塋瀛縈螢迎贏營蠅	穎瑛嚶瓔櫻應纓嬰映鸚鶯膺鷹罌郢英景硬影
佑	囿柚侑宥有莠誘又釉祐幼右鼬	悠憂攸友優猶疣鈾遊幽莠油由酉魷牖有黝郵尤猷
議	詣劓羿浥異益藝軼意刈鎰縊肄逸憶抑艾佚奕翌衣佾誼億役翳懿一掖屹易裔繹液弋帟邑腋曳溢臆翼亦囈蜴驛毅義譯弈疫	咿儀揖怡飴咦依姨迆痍胰頤以遺噫移乙矣蛇衣伊夷誼尾漪圯蟻彝已壹一醫沂旖栘倚迤貽椅訑宜疑偯
閒	餞澗鑒劍賢毽諫箭涎僭踐嫻艦件健建嫌間啣弦檻閑見絃監賤銜鹹舷濺薦腱漸鑑鍵	莧陷限儉尖獻蘚祆堅艱秈暹減菅緘鮮纖霰箋先韉柬銑險線仙湔蜆顯撿簡殲癬瞼肩筧揀間繭腺羨煎姦剪餡鹼僩檢監掀縑濺憲奸囝漸峴現兼姍縣
稷	洎暨寄忌祭薊騎芰際劑繼薺記季髻霽技紀覬既悸計躋繫濟妓鯽驥冀	棘璣羈疾肌集脊己藉雞磯乩積幾績期屐機楫瘠嵇跡蹟基級極居戢畸姬畿其擊輯寂給犄飢及嫉癘幾唧箕麂擠急伋奇吉譏激圾即汲勣稽吃亟躋籍岌嘰濟戟饑
瑞	睿銳	蕊
蕙	諱惠晦喙燴慧繪穢彙彗賄會卉匯誨潰	麾恢詼蟲茴暉毀墮灰揮燬賄虺輝悔回會徽迴蛔誨
籽	梓紫滓仔訾子	字淄恣玆子錙自輜資孳茲吱貲孜姿髭諮漬滋緇齜
話	樺華畫劃化	樺花華猾滑劃嘩豁譁
遐	狎暇俠轄霞斜柙挾峽匣洽狹黠呷瑕	下暇蝦嚇夏廈瞎
服	孚拂夫芙袱蝠菔氟符幅扶芾輻伏俘匐彿紼縛浮涪福弗怫紱	富斧夫敷莆父復腐覆阜腑撫駙複輔傅鈇俯釜甫膚咐訃附腹賦賻副頫婦伕脯府付趺孵麩負馥赴
癖	僻闢譬屁媲闢	劈披陂仳疲否沘壞琵批啤鼙脾匹丕霹皮痞埤枇陴鈹被罷紕毗疋裨
瘢	搬般班斑扳頒	板瓣拌舨扮辦阪姅版絆闆半伴鈑
婁	呂嘍鋁樓褸履髏膂屢旅螻侶縷	簍慮閭率氯漏綠陋律鏤濾瘺驢摟露櫚
翟	荻鏑迪的嘀狄敵宅犒芽笛滌嫡	滴締底帝的齋齊蒂祭氐砥摘柢弟諦債邸抵窄低寨地第娣牴遞責棣詆
哄	轟薨烘	鴻鬨烘紅訌薨弘汞黌閎虹泓洪轟宏
芾	氟縛痱匐夫吠蝠紼扶幅孚弗輻紱費袱福浮屝伏符菔沸拂涪怫彿廢服肺芙俘	斐附覆馥膚鈇俯非複夫誹頫甫啡賻肥傅付妃撫扉斧莆赴脯賦匪訃菲富腓府腑腐霏阜腹翡副復釜敷飛婦孵趺輔咐父麩負伕駙
清	輕蜻氫頃青卿鯖傾	請親擎檠頃情晴磬傾慶罄
襠	鐺當儅噹	讜黨擋盪檔當蕩
莓	眉楣玫沒煤湄梅枚媒黴黴	每媚袂鎂妹沬瑁魅美寐昧
爸	灞霸壩耙伯罷	笆吧鈸琶疤拔芭捌巴靶扒把跋罷叭八杷
鹹	嫌銜嫻鹹舷啣弦閑賢閒絃涎	莧陷限獻蘚祆秈暹鮮纖霰先銑險線仙蜆顯癬腺羨餡僩掀憲現峴姍縣
窯	瑤姚榣崤僥遙謠搖餚爻洮堯淆	吆藥腰麼要妖窈樂舀鷂杳耀邀拗曜夭咬鑰喲
俺		按菴鞍庵岸暗安鵪諳銨氨黯案
遇	芋與馭御喻育瘉寓禺鬱尉癒諭玉澦語煜欲谷裕昱愈聿峪嫗籲預豫浴域獄毓堉慾譽禦熨俞燠	與魚諛宇雨雩竽禹予愚禺虞迂齬蝓噢盂圉逾褕圩瘀榆渝語萸漁瑜庾輿嶼歟於腴紆妤隅圄愉羽臾餘淤覦敔俞娛
控	空	崆孔倥硿恐空
磁	疵祠詞瓷茨雌辭慈	疵刺伺次雌廁賜此差
聶	鎳臬蘗涅躡囁鑷齧孽	捏
魔	膜蘑摩磨模糢謨摹	抹墨脈漠沒麼歿膜末貊默茉莫磨摸陌沫寞驀秣
驅	蛐嶇區曲趨屈瞿圈砠軀蛆	趣劬取漆曲麴齲瞿渠娶衢璩去
薛	靴噱	血雪削穴學
火	夥	活獲壑穫或惑貨濩禍豁和霍擭
改		垓丐概賅溉鈣蓋該
茄	傢袈加迦伽夾佳家痂葭豭嘉	稼鉀愜架甲怯切駕胛且竊賈假價嫁頰契戛鍥莢夏挾夾浹挈妾
鬨	汞	泓哄洪宏紅訌薨弘烘黌閎虹鴻轟
昏	葷婚	混渾魂輥餛琿
證	政掙幀証鄭症正	癥諍爭徵丁猙拯掙箏整怔睜崢錚蒸正
瑯	狼榔琅郎螂廊	浪朗
貧	頻顰嬪瀕	聘品拼牝姘
狄	鏑荻迪的犒嘀翟滌笛芽敵嫡	滴低締底帝的地蒂第氐牴娣砥遞諦弟柢棣邸抵詆
霑	詹譫佔氈瞻沾	嶄湛站暫展戰顫佔盞佔斬輾綻棧蘸
袍	咆庖刨炮匏	砲拋泡炮跑皰
迴	茴回蛔	諱詼蟲晦蕙燴灰墮揮燬彙彗虺賄悔卉誨潰麾恢惠暉毀喙慧繪穢輝會徽匯
槨	猓果裹	鍋國蟈過堝摑幗郭
舉	莒齟沮咀矩	橘拒拘菊懼鋸巨炬颶鞠居遽跼疽倨劇苣桔屨局句具鉅聚踞駒狙蛆車據沮掬瞿距足侷俱
屆	解芥介借疥誡戒界藉	睫傑節櫛竭姐揭潔捷姊頡擷階結桔孑接羯皆桀劫偕拮碣嗟解訐街詰截
頷	憾悍旱頜銲翰撼漢捍瀚汗焊	含函和韓榦汗涵蚶罕鼾喊寒酣
鈕	紐忸扭	拗妞牛
巽	遜殉汛馴徇訊蕈潠訓迅	燻巡潯徇薰循醺馴勛尋詢璿洵荀勳旬
們	門捫	捫悶燜門懣
碓	對隊兌	堆
瞬	舜順	盾吮
助	薴駐箸祝註注蛀柱佇鑄杼住	諸逐軸朱躅茱硃渚拄蛛誅術主囑珠豬築朮貯竺侏藷屬煮燭矚株銖竹
您		
觸	怵絀矗歜畜處黜	齣除鋤杵褚初出芻儲楚廚雛櫥跦處楮躇礎
址	趾紙芷徵止咫指只旨祉祇	智制脂植痔梔直致摭之製蛭躓質窒雉芝泜值胝躑枝吱峙祇幟肢支擲稚執祗職炙痣識汁置輊只至殖織卮滯隻蜘秩摯知姪氏緻治志誌
番	蕃幡翻繙帆	藩釩飯範返蕃泛樊墦反販帆氾犯煩礬梵汎繁凡
激	唧跡畿屐居績犄饑譏羈機乩積奇稽箕嘰躋蹟畸嵇其癘肌幾期雞璣基磯飢姬勣	急唧霽髻疾脊寄際繼寂即繫楫伋稷擠吉薺技記擊忌騎及悸嫉汲覬己亟藉劑岌紀吃季瘠給借棘計級祭圾戟麂妓驥籍濟鯽輯幾芰戢集暨洎極薊系冀躋既
臚	蘆爐盧廬鑪鱸瀘顱	路滷露魯擄鹵櫓鹿麓戮僇碌氯嚕鷺陸錄穋祿虜賂
塹	欠縴歉倩	乾簽前遣黔愆鉛千箝遷韆鈐籤譴鉗阡嵌仟縴騫虔潛謙淺牽搴錢
癩	籟睞賴瀨	徠萊來
勰	攜協諧鞋偕擷斜邪頡挾脅	蟹邂榭歇屜解寫洩駭屑些卸械瀉懈謝褻契燮蠍楔洩血紲
轟	哄薨烘	鴻鬨哄紅訌弘汞黌閎虹泓洪宏
糧	良量粱涼樑	亮輛兩倆魎量晾諒涼
缶	否	芣
仇	惆裘裯梂球鯈稠毬躊疇酋囚泅儔籌愁酬綢求	丘龜鰍溴秋臭醜抽蚯邱鞦
粒	荔琍儷痢例利厲欐莉曆礫勵瀝慄隸蒞釙蠣靂立礪壢唳力戾俐吏麗癘鬲溧笠歷酈	裏貍醴李離鯉釐黎罹禮漓理浬梨驪狸蜊俚娌邐澧麗蠡犁璃鋰喱籬犛裡哩
訛	哦蛾蚵俄娥峨鵝額	厄呃扼惡萼顎詻婀堊阿軛噩餓鱷愕啞鄂俄遏鍔
海		氦孩咳害骸嗨亥駭還
乘	呈賸懲誠承丞橙剩城勝成程聖盛澄	笙昇牲騁聲陞省甥秤繩逞澠勝瞠生撐升稱
硼	蓬膨彭朋澎棚鵬篷	捧澎抨碰烹砰
殆	迨大貸黛怠逮岱待玳帶代戴袋	逮待歹呆
警	景井阱憬璟頸	靜競精荊淨兢京旌敬經粳勁菁驚痙涇晶鏡鯨睛莖竟更徑逕靖境
茶	搽察查	差剎喳叉岔詫插
碑	背杯卑裨揹悲盃俾	鋇背倍臂貝輩備孛悖憊北邶狽焙蓓被
蜻	輕清氫頃青卿鯖傾	請親擎檠頃情晴磬傾慶罄
虛	鬚噓訏須胥墟戌籲需	咻卹婿序許洫煦徐恤緒酗畜絮頊栩續蓄敘旭勗
矜	棺關金觀莞倌津禁筋襟觔浸官斤鰥冠綸巾今	館琯燼觀勁鸛縉謹瑾進罐冠盥盡饉晉莞緊管噤僅禁儘灌貫慣覲浸錦近
屨	炬苣颶懼具巨踞瞿鉅倨劇遽距俱聚據句鋸足拒	莒咀舉桔疽橘蛆跼車駒俱拘狙侷掬菊局鋸沮鞠居齟矩
嗉	蓿塑簌肅宿縮速粟訴溯素夙	俗蘇囌酥甦穌
輦	碾拈攆輾撚捻涊	念唸黏廿年
次	廁刺賜伺	疵祠詞瓷茨雌辭慈此差磁
瘠	棘戢疾擊輯寂集脊及嫉藉唧急伋吉圾即楫汲吃亟級極籍岌	洎璣羈暨忌肌祭脊己騎芰雞磯乩劑積幾記績期屐機嵇跡覬紀蹟基計妓居冀畸姬畿其寄給犄薊飢癘際幾唧箕麂繼擠薺奇譏激季稷髻霽技勣稽既悸躋繫嘰濟鯽戟驥饑
蓆	錫惜席習熄媳襲褶檄息昔	攜烯嬉膝璽洗溪細析係棲蟋羲夕蹊歙曦淅悉熹禧犀系汐行翕蜥稀戲隙希吸徙晰畦兮鰓熙釐矽喜谿譆犧唏晞嘻西潟繫奚僖
拋		咆砲庖刨泡炮跑袍皰匏
泌	庇埤幣密裨箄襞篦蔽鄙糸必弊斃比蹕碧詖鉍賁陛避蜜畢冪壁嗶覓闢璧臂敝痺愎睥婢薜汨閉祕弼俾謐	糜咪迷麋彼謎鄙筆弭瞇比妣靡瀰米逼敉匕鼻沘彌
踝	槐徊懷淮	壞壞
姓	性倖杏興幸悻	醒腥興行省硎刑型猩馨陘惺星形邢
佰	襬百擺	白拜敗
曲	蛐嶇取區趨齲屈瞿圈驅娶砠軀蛆	取趨渠驅娶砠趣劬漆齲衢去蛐區麴屈圈軀璩蛆嶇瞿
裂	冽列捩劣鬣獵烈洌	咧
役	詣劓羿浥異益議藝軼意刈鎰縊肄逸憶抑艾佚奕翌衣佾誼億翳懿一掖屹易裔繹液弋帟邑腋曳溢臆翼亦囈蜴驛毅義譯弈疫	咿儀揖怡飴咦依姨迆痍胰頤以遺噫移乙矣蛇衣伊夷誼尾漪圯蟻彝已壹一醫沂旖栘倚迤貽椅訑宜疑偯
億	詣劓羿浥異益議藝軼意刈鎰縊肄逸憶抑艾佚奕翌衣佾誼役翳懿一掖屹易裔繹液弋帟邑腋曳溢臆翼亦囈蜴驛毅義譯弈疫	咿儀揖怡飴咦依姨迆痍胰頤以遺噫移乙矣蛇衣伊夷誼尾漪圯蟻彝已壹一醫沂旖栘倚迤貽椅訑宜疑偯
稚	智制痔致製蛭躓窒質雉峙幟炙痣識置輊至滯秩摯知緻治志誌	徵植脂梔直摭之址質泜芝值胝躑枝吱祉祇肢擲支趾執祗職汁咫只殖織卮紙隻芷止蜘知姪指氏旨
澴	桓還環洹鍰梡寰	渙幻歡換緩喚宦患奐豢皖煥瘓梡
琳	鄰林淋遴痳燐轔磷鱗霖臨麟璘	吝凜藺賃躪懍
歜	怵矗處畜黜絀觸	齣出鋤儲除杵礎跦楮廚褚雛處櫥躇楚初芻
命	暝	螟冥酩暝茗鳴名明瞑銘
蹟	畸姬畿其璣羈肌犄飢癘雞磯乩幾積唧箕幾奇譏激績期屐機嵇跡勣稽基躋嘰居饑	洎棘疾暨忌祭集脊己騎藉芰劑幾記楫瘠覬紀計級極妓冀戢擊寄輯寂給薊及嫉際幾唧麂繼擠急伋薺吉季圾即稷髻霽技汲吃亟既悸躋籍繫岌濟鯽戟驥
繚	聊嘹潦寥撩寮遼燎僚療	料撩暸了燎瞭廖
儘	盡饉燼晉緊噤僅勁禁縉覲浸謹瑾進錦近	燼矜勁筋襟觔縉謹瑾進巾盡饉金晉緊津噤僅禁覲浸斤近錦今
嬸	哂沈審瀋	慎身沁深脤甚呻砷參滲蜃莘娠申紳伸信腎神
寵		憧充舂崇重沖蟲衝
阡	簽嵌仟縴愆鉛千騫謙牽搴遷韆籤	乾欠前塹縴遣黔歉倩箝虔潛淺鈐譴錢鉗
諦	娣締遞帝弟的地棣蒂第	滴低鏑荻迪底的嘀狄敵氐牴砥柢犒翟滌芽邸笛抵詆嫡
嶸	容榮融鎔絨蓉茸溶熔榕戎	茸冗
飭	赤熾翅斥啻敕叱	褫尺恥蚩癡呎踟侈匙癡吃栘齒弛持馳嗤池魑遲墀笞喫
秦	擒禽芹勤琴噙	嶔寢欽沁侵親撳
焜	髡琨坤錕昆崑	睏捆綑困梱
苞	褒胞包	抱葆鉋刨雹報飽薄鑤堡褓保豹爆寶鮑暴
慰	魏畏褽偽尉謂僞遺渭爲喂餵位未胃穌蔚衛味為	違葦帷崴緯薇圍唯煨猥桅諉逶鮪幃維威巍偎萎尾濰惟痿闈委危韋微洧娓偉為
廖	燎料瞭	寮繚聊潦寥撩療遼僚嘹燎了暸瞭
陋	露瘺漏鏤	簍嘍樓髏摟婁螻
磧	汽器愒企訖迄亟泣契憩妻砌緝氣棄	歧其淇旗琪齊萋琦耆麒棋淒騎妻祺欺臍溪豈綺畦鰭祁崎杞圻乞奇岐啟期柒祇衹祈棲谿稽枝漆慼悽起戚七錡
瓶	平馮枰蘋坪萍屏評憑	娉乒
唱	倡暢悵	嫦徜氅場償常嘗嚐鯧敞娼昌猖廠裳腸萇長倡倀
猖	鯧娼昌倡倀	腸嘗暢嫦常嚐徜敞萇氅場裳唱倡悵償廠長
棵	窠科柯軻顆蚵稞瞌蝌磕刻苛	緙咳坷喀恪剋可嗑殼溘課克渴客刻髁
鋒	豐諷峯風楓封蜂烽瘋	俸諷逢縫馮鳳奉
乎	忽惚戲呼	鵠虎葫扈唬湖許瑚戶壺弧鬍沍瓠護互囫糊狐胡滬蝴琥楛斛
騵	緣媛源員原轅園圓援猿湲元爰袁沅垣	宛院苑媛願淵願冤鴛鳶怨遠
娑	梭嗦縮莎唆蓑簑	鎖所瑣索
卻	闋雀恪鵲闕榷怯確殼	缺瘸闕
蟀	數率碩爍妁鑠勺朔帥	摔衰說甩
綜	鬃糉從縱棕宗蹤	鬃糉從總縱棕宗蹤傯
汨	覓祕祕冪密糸蜜謐泌	靡謎敉彌瀰弭麋瞇米咪糜迷
族	卒嗾足	組俎祖租阻詛
伯	卜鈸博蔔鉑駁箔荸脖霸壩耙搏檗渤帛薄白柏爸膊灞勃泊舶罷	鈸芭把杷吧琶玻菠拔扒蘗跋檗跛播疤薄亳捌巴靶般擘缽叭八笆薜簸剝罷撥
淫	齦垠夤銀吟鄞簷寅霪	蔭聽殷印胤尹因癮飲湮隱陰慇氤姻蚓縯引音茵
捐	娟身圈鐫鵑涓	捲倦卷狷圈雋眷絹
繼	霽髻寄際繫稷薺技記忌騎悸覬劑紀季計祭妓驥濟鯽芰暨洎薊系冀躋既	急唧疾脊跡即寂楫屐居伋績擠吉犄饑譏擊羈機及乩嫉積激己汲藉亟岌吃瘠奇給稽借棘箕級圾嘰戟麂躋蹟籍濟輯畸嵇幾其肌期集戢飢雞極癘璣基磯畿姬勣
骼	郃革隔格咯閣膈閤葛鬲鎘蛤	哥歌各戈疙個箇鉻擱割胳葛鴿
颶	炬苣懼具巨踞瞿鉅倨劇遽屨距俱聚據句鋸足拒	莒咀舉桔疽橘蛆跼車駒俱拘狙侷掬菊局鋸沮鞠居齟矩
圬	屋汙誣烏鎢惡嗚污於巫	武鵡晤騖巫侮吾悟塢亡誤誣務無吳午五毋伍寤戊惡鼯嫵唔物勿憮霧舞兀鎢捂軏梧蕪蜈堊
漏	露瘺陋鏤	簍嘍樓髏摟婁螻
跼	掬桔侷菊局鞠橘	苣炬颶具巨疽鉅倨劇遽屨距俱狙聚據齟咀莒舉懼踞瞿蛆車駒拘句鋸沮足拒居矩
衰	摔催崔摧	蟀率淬粹悴橇萃璀甩瘁翠脆帥
硎	邢行刑陘型形	醒性興幸馨倖惺杏星悻姓省腥猩
鴉	鴨煆押呀丫壓	啞疋亞蚜芽衙訝涯牙軋雅押氬
旺	妄王忘望	罔尢網往魍王汪亡枉惘輞
泵	榴瘤留劉瀏硫琉流遛	餾霤六陸溜鉚柳
戛	浹莢頰夾挾	嘉架假夏鉀加葭稼傢甲迦駕價痂賈袈夾茄豭嫁佳胛家
粵	曜越刖悅玥藥說耀月躍軏樂鑰籥嶽閱	約曰
姚	瑤榣崤窯僥遙謠搖餚爻洮堯淆	吆藥腰麼要妖窈樂舀鷂杳耀邀拗曜夭咬鑰喲
除	鋤芻儲廚雛櫥跦躇	怵齣杵褚絀觸初出矗儲歜楚畜黜處楮礎
舵	度惰踱咄跺剁墮馱	奪朵躲鐸多
腺	莧陷霰憲限羨現獻峴蜆線餡僩縣	賢蘚閒祆秈暹涎鮮纖先嫻銑險仙蜆顯癬嫌弦啣閑絃掀銜鹹舷姍
喃	南楠難男	赧囝難
旖	尾椅以蟻已乙矣偯迤迆倚	漪藝屹肄軼刈誼囈迤移縊逸彝溢佾夷沂宜劓醫疫頤噫疑懿鎰毅揖義訑蛇邑億液佚役儀易羿裔姨咦弋蜴壹驛飴弈譯帟翌異益栘臆遺亦艾腋曳咿議詣意伊繹怡貽憶掖浥翳圯胰奕一翼抑衣痍依
姆	牡拇姥母畝	慕穆模募墓木目沐睦苜幕暮牧
鑽	纂賺	纂賺
遛	劉留泵琉瀏流榴硫瘤	霤鉚柳餾陸六溜
囝	繭筧減檢撿柬簡揀剪鹼儉瞼	件南檻箋劍健僭見男縑艦兼姦韉漸毽殲諫奸艱濺楠赧踐箭監間難閒肩尖薦湔腱鍵建堅餞鑑喃鑒菅澗緘賤薦煎
口		寇扣釦叩佝
韓	寒函含榦涵汗	瀚喊罕銲悍鼾憾蚶焊漢旱撼酣頷捍和翰汗頜
溶	鎔蓉榕戎榮容熔融絨茸嶸	茸冗
邋	剌	喇蠟拉剌臘辣落啦
聽	隱引汀尹癮縯廳蚓飲	淫蔭蜓霪霆殷印胤亭汀梃吟因鄞簷挺飲湮庭隱垠夤銀陰慇氤廳廷姻齦音婷茵寅停艇
鱔	扇善膳禪擅訕疝單繕汕贍煽	扇縿姍刪山舢煽跚羶杉衫珊潸閃芟陝
健	餞澗鑒劍閒毽諫箭僭踐艦件建間檻見監賤濺薦腱漸鑑鍵	尖儉堅艱減菅緘韉柬湔撿簡殲瞼肩筧間揀繭煎姦剪鹼監檢縑濺奸兼漸囝箋
拭	室恃螫筮奭勢嗜舐豉市士事仕識試世釋柿逝是適侍示飾軾誓弒氏式噬使視	濕詩十施屎師史匙提矢射食碩拾蝕駛塒屍噓時什溼豕獅失始蝨實石使
渤	卜鈸博蔔鉑駁箔荸脖搏檗帛薄白柏膊勃泊伯舶	玻菠薄亳般薜擘蘗簸檗剝跛缽播撥
陰	湮殷音氤慇茵因姻	淫蔭霪聽胤印尹吟癮鄞簷飲隱垠夤銀蚓縯引齦寅
砂	莎殺沙煞鯊紗裟杉	廈煞傻霎
爺	椰耶琊	葉耶噎冶業野曄射也頁謁鄴靨夜咽拽
扭	紐忸鈕	拗妞牛
落	洛酪絡烙臘咯駱犖蠟珞雒剌辣	裸鑼騾玀啦羅拉鏍儸邏螺囉邋喇籮剌蘿
兮	攜曦淅悉熹烯禧犀嬉膝行蜥稀希吸溪晰畦析熙釐棲譆谿犧蟋唏晞嘻羲西奚蹊僖	系汐蓆翕戲隙惜習璽徙洗細鰓係媳矽喜息潟夕繫席錫熄歙襲昔檄褶
撼	瀚旱憾銲悍焊捍頷翰漢汗頜	韓鼾寒罕函含蚶榦酣涵和喊汗
胸	兄兇匈洶	雄熊
尤	鈾遊油由猶郵魷疣猷	囿佑悠誘憂幼攸友侑優又祐柚幽莠酉右牖宥黝有釉鼬
還	孩環鍰骸洹桓澴玄漩梡寰璿懸旋縣	氦宦選患晅嗨萱喚豢絢渲漩緩梡炫亥旋瘓壎煥害眩煖駭鉉宣暄皖幻咳海奐諼軒渙喧歡換
防	房坊妨肪	放坊彷訪枋倣芳舫紡仿方
意	詣劓羿浥異益議藝軼刈鎰縊肄逸憶抑艾佚奕翌衣佾誼億役翳懿一掖屹易裔繹液弋帟邑腋曳溢臆翼亦囈蜴驛毅義譯弈疫	咿儀揖怡飴咦依姨迆痍胰頤以遺噫移乙矣蛇衣伊夷誼尾漪圯蟻彝已壹一醫沂旖栘倚迤貽椅訑宜疑偯
融	鎔蓉榕戎榮容熔溶絨茸嶸	茸冗
邵	召紹哨少	勺芍捎燒少稍杓韶梢
露	鷺穋氯漏陋路僇碌鏤瘺鹿陸祿錄賂戮麓	虜樓鱸髏廬嚕爐擄螻簍臚櫓摟婁滷顱嘍鑪瀘魯盧鹵蘆
耑	磚端專顓	斷鍛囀賺撰僎篆轉短傳緞段
璞	莆葡脯蒲菩濮樸僕釙匍蹼樸	普埔鋪浦誧僕溥暴撲撲譜瀑圃曝噗
枝	旗脂祈梔琦琪麒耆之錡臍齊泜騎祁芝胝吱祇肢棋畦支祗奇汁只崎淇織卮隻其祺期圻衹蜘知歧岐氏鰭	憩制植製溪躑祉祇幟趾執炙訖咫輊殖止知至治器智徵豈致躓慼泣值稚稽戚痣滯七棄秩摯愒指欺萋啟淒谿悽直企摭漆蛭磧雉砌亟峙職啓迄識置紙綺乞氣志旨痔汽起杞址質窒擲契柒只緝芷棲姪緻妻誌
褲	酷庫	苦骷窟枯哭楛
窪	蛙媧哇呱挖	娃襪瓦
瓷	疵祠詞茨雌辭慈磁	疵刺伺次雌廁賜此差
溴	袖宿嗅臭秀鏽繡岫	儔綢朽醜鯈修惆醜酬脩稠仇疇抽愁宿躊籌裯休咻羞
狷	倦雋絹圈卷眷	圈捲身捲捐鵑涓鐫娟
縿	扇姍刪山舢煽跚杉衫羶珊潸芟	鱔扇膳禪擅疝訕繕汕贍煽善閃單陝
豕	始使矢屎駛史	拭恃軾是匙溼獅氏拾蝨使視失蝨豉噓仕噬蝕誓筮施室提嗜屍什逝舐式適屍柿飾奭士詩碩螫十弒市示試塒石食實時勢侍世師濕識射事釋
塋	瑩縈嬴迎營楹贏蠅瀛盈螢熒	纓罌景郢鶯櫻映膺鸚嬰應瑛英鷹嚶瓔穎硬影
錫	惜習檄褶息媳席襲蓆昔熄	細悉禧行谿羲繫嬉晰蟋釐洗吸唏曦隙希蹊稀淅溪矽畦奚鰓係翕犧譆熙夕攜烯析西兮嘻僖蜥晞棲璽系汐膝潟戲犀熹徙喜歙
庇	埤幣裨箄襞篦蔽鄙必弊斃比蹕碧詖鉍賁陛避畢壁嗶闢璧臂敝痺愎泌睥婢薜閉祕弼俾	逼鄙匕筆鼻沘比妣彼
噤	覲縉浸盡燼晉進近禁僅勁儘	饉金矜緊津僅禁儘筋襟覲觔斤浸謹瑾錦巾今
貼	帖	餮鐵帖
鷓	浙這蔗宅	遮懾謫赭者轍哲蜇折著摘摺輒螫褶
綽	輟啜齪	戳
褽	位慰魏胃衛蔚謂未遺尉喂渭畏為味穌餵偽	尾娓維痿緯萎威韋唯惟濰圍桅為崴煨薇逶幃葦危偉洧帷鮪微巍偎闈猥諉違委
鍛	緞段斷	端耑短
諂	剷鏟闡產	懺攙禪蟾儳嬋巉饞摻讒澶孱潺蟬毚單纏羼
軍	均龜君鈞	竣菌浚窘郡駿俊雋濬蕈峻
薺	霽髻寄際繼繫稷技記忌騎悸覬劑紀季計祭妓驥濟鯽芰暨洎薊系冀躋既	急唧疾脊跡即寂楫屐居伋績擠吉犄饑譏擊羈機及乩嫉積激己汲藉亟岌吃瘠奇給稽借棘箕級圾嘰戟麂躋蹟籍濟輯畸嵇幾其肌期集戢飢雞極癘璣基磯畿姬勣
詻	愕鱷遏俄軛啞噩惡呃鍔顎扼鄂餓厄堊萼	額俄蛾哦婀訛娥阿峨鵝蚵
廢	吠芾費屝怫痱沸肺	菲啡肥誹霏斐妃腓扉匪翡非飛
庾	雨語與宇敔噢齬圉禹予嶼羽圄	瘉澦域妤娛瘀馭獄逾峪昱燠褕蝓竽雩渝覦預漁迂語於與紆煜慾芋育餘餘俞歟堉鬱豫毓虞裕盂禦隅籲嫗榆喻愚魚玉欲譽禺熨輿癒寓愈愉諭御谷鬱淤腴臾遇諛圩聿尉瑜予萸浴於
遊	鈾疣油由猶郵魷游尤猷	囿佑悠誘憂攸幼友侑優又祐柚幽莠酉右牖宥黝有釉鼬
噎	耶	也曄琊冶鄴葉謁業拽椰頁野靨射夜咽爺耶
欽	嶔親侵	擒禽寢沁芹勤琴秦噙撳
嚅	燸儒茹濡蠕如孺	女茹入汝乳褥辱孺
脫	託拖	妥駝柝馱佗跎橢陀鴕唾拓沱
章	璋蟑樟獐張彰漳	瘴脹丈賬帳掌障仗長杖漲幛
微	薇圍唯違濰桅惟幃維帷闈危巍爲韋為	葦魏畏褽偽崴慰緯尉猥諉煨謂逶鮪僞遺渭威偎萎喂尾餵痿未位委胃洧穌蔚衛味娓偉為
譫	詹佔氈霑瞻沾	嶄湛站暫展戰顫佔盞佔斬輾綻棧蘸
踵	腫塚塚種	盅仲忠眾鍾衷終忪湩中鐘重種
鬚	須墟胥訏需虛籲戌噓	敘恤畜絮洫蓄婿酗卹許緒頊徐煦勗咻栩續旭序
光	洸胱	獷逛廣
菴	黯暗按案岸	諳鞍安氨庵銨俺鵪
批	劈披丕匹壞霹紕被鈹	啤媲埤陂脾裨匹屁琵僻枇癖疲仳紕譬陴鼙鈹闢否毗痞沘疋罷皮
薜	弊亳璧必鉍簸敝嗶痺箄襞避臂斃庇畢俾擘愎碧陛賁泌薄鄙蹕篦播蔽檗詖埤闢蘗閉弼祕婢比壁睥幣裨	荸搏般筆帛簸匕蔔伯博脖沘妣勃菠跛逼舶剝泊鉑膊渤箔薄玻撥鄙駁播檗彼白鈸缽比柏鼻
棹	罩肇炤詔晁召趙照兆涿捉櫂桌	釗擢朝濁昭卓沼濯爪晁琢召鐲著酌招拙嘲找灼斫茁啄
栓	閂拴	涮
旗	祈琦琪麒耆錡臍齊祁騎枝祇棋畦奇只崎淇其祺期圻衹歧岐鰭	器憩啟淒谿豈悽企汽漆杞起慼磧泣溪亟砌欺契稽訖戚啓迄柒緝七綺棄乞棲氣愒萋妻
脂	梔之泜芝胝枝吱祇肢支祗汁只卮織隻蜘知氏	智徵制植痔直致摭製蛭址躓質窒雉值躑擲峙祉幟祇趾稚執職炙痣識咫置輊只至殖滯紙芷止秩摯知姪指緻治志旨誌
十	塒時什碩拾射食蝕實石提	濕詩室恃施螫屎筮師史匙奭勢嗜舐豉矢市士事仕拭識試世釋柿逝是駛適噓屍侍示飾豕軾溼獅失誓弒始氏式蝨噬使視
僇	路露鹿戮麓碌氯鷺陸錄穋祿賂	蘆滷盧魯鹵擄臚鑪櫓鱸顱爐嚕廬虜瀘
洵	潯巡馴徇尋詢璿循荀旬	燻汛殉徇薰醺迅訓潠遜馴訊勛巽勳蕈
辰	沈宸忱塵晨沉陳諶臣娠	襯趁琛讖櫬稱瞋疢
裨	必璧陂疲揹嗶沘斃琵俾陛賁啤鄙蹕脾篦皮埤祕陴枇鈹比紕毗幣弊敝鉍盃薜卑痺背箄杯避襞臂庇畢愎碧鼙泌蔽碑詖闢閉弼婢罷壁睥悲	劈披筆譬仳貝北鋇匕否背輩沘妣僻壞邶臂逼憊癖悖批孛闢蓓鄙倍媲匹丕霹焙痞狽彼闢備鈹屁被比紕疋鼻
絢	鉉眩漩炫旋渲	懸漩還煖暄軒宣晅諼萱喧壎選璿旋縣玄
鈑	板舨闆阪版	搬般瓣拌斑扮頒辦瘢姅絆班扳半伴
姊	姐解	睫傑節櫛芥竭揭潔捷頡疥階擷戒結桔孑藉接羯皆桀借劫偕拮碣界嗟解訐介街屆詰誡截
廈	夏煞霎下嚇暇	霞呷殺狎柙瑕蝦裟黠遐煞洽紗瞎莎轄沙砂狹杉峽挾匣傻鯊斜暇俠
虺	燬賄蟲悔會毀誨	諱詼茴晦蕙燴灰墮揮彙彗賄回迴卉誨潰麾恢惠暉喙慧繪穢輝會徽蛔匯
葆	堡褓飽寶保	鉋鑤爆報刨豹雹暴包鮑抱褒胞苞薄
塵	沈宸忱沉晨辰陳諶臣娠	襯趁琛讖櫬稱瞋疢
銨	諳鞍安氨庵鵪	菴黯暗按案俺岸
根	跟	亙艮
種	湩仲重衆腫眾中塚踵	湩終仲忠鐘重盅忪腫眾衷鍾中塚踵
往	罔網魍枉惘輞	旺尢妄忘王汪亡望
靜	鏡敬競徑淨勁痙逕竟靖境	井精荊兢警旌京經粳菁驚頸涇晶鯨睛莖阱憬璟景更
氳	暈	雲韻員運筠昀暈醞蘊紜耘允孕勻熨隕雲慍芸
限	莧陷霰憲腺線羨現獻峴蜆餡僩縣	賢蘚閒祆秈暹涎鮮纖先嫻銑險仙蜆顯癬嫌弦啣閑絃掀銜鹹舷姍
盟	朦虻萌蒙檬濛甍矇懵	夢孟蜢錳艋猛懵
揪	啾糾鳩	酒玖赳舊究糾救咎臼舅灸廄九就韭柩久疚
擬	旎你妳	尼溺暱霓逆膩倪泥匿呢怩睨妮
墜	綴贅惴	追椎錐隹
叱	赤熾翅斥啻飭敕	褫尺恥蚩癡呎踟侈匙癡吃栘齒弛持馳嗤池魑遲墀笞喫
衽	刃紉妊韌認仞飪軔任賃	仁荏稔壬人忍兒任
射	攝涉葉捨曄十謁夜麝提社業舍食靨鄴咽碩拾設蝕拽塒時什頁歙實石赦	濕捨詩舌室恃施螫屎筮師史匙奭耶甚勢嗜舐豉矢也市士蛇事仕拭椰噎賒識爺試世釋柿逝是琊適噓屍侍駛示冶什野飾豕軾溼獅失誓弒始氏式蝨噬奢使視
碎	遂祟誶歲隧穗燧邃	綏髓隨隋雖睢
寰	桓還環澴洹鍰梡	渙幻歡換緩喚宦患奐豢皖煥瘓梡
漁	魚諛雩予竽愚禺虞蝓盂逾褕圩榆渝萸瑜輿歟於腴妤隅愉臾餘覦俞娛	芋與馭御喻育宇雨予禹瘉寓譽禺迂鬱尉齬噢癒圉諭玉澦煜語欲谷庾裕嶼昱愈紆聿峪嫗籲預豫圄域浴羽獄毓遇淤堉慾瘀敔禦熨俞燠
蛙	窪媧哇呱挖	娃襪瓦
魂	餛琿混渾	混渾輥葷昏婚
籍	急唧疾脊即寂楫伋吉擊及嫉汲亟岌藉吃瘠借棘圾級輯戢集極	唧霽髻寄脊跡際繼冀繫屐居績稷擠犄薺饑譏技記忌羈騎機乩激積覬己悸劑紀季奇給稽既箕計嘰祭戟麂妓蹟躋驥濟鯽畸嵇幾其肌芰期飢癘雞暨洎璣基薊系磯畿姬勣
夏	鉀賈假廈下嚇甲暇胛	霞呷加稼架狎柙瑕家蝦茄駕嘉黠賈假遐洽價嫁佳頰傢瞎葭戛豭迦袈轄莢痂狹峽挾夾匣浹斜暇俠
鈽	怖簿步埠不佈布部	捕埔不補哺卜
瞻	沾霑佔詹譫氈	棧斬站嶄展盞輾綻湛暫佔蘸顫戰
襄	鄉鑲瓖廂湘箱香相	餉響祥像詳嚮降翔庠鄉橡巷象享饗想項向相
多	奪鐸朵	度惰奪踱舵朵躲咄跺鐸剁墮馱
疑	儀怡飴咦姨痍胰頤遺移蛇圯夷誼彝一沂栘迤貽訑宜	咿詣劓揖羿浥異益議藝軼意刈鎰依縊迆肄逸憶以噫抑乙艾佚矣奕翌衣伊佾誼億漪役蟻尾翳已懿壹一掖醫屹易裔繹旖倚液弋迤帟偯邑腋曳溢椅臆翼亦囈蜴驛毅義譯弈疫
瞟	縹漂	飄瓢驃漂嫖剽票
坊	房妨防芳肪枋方	放房妨防彷訪枋倣芳舫肪紡仿方
孩	骸還	氦咳害海嗨亥駭
器	憩妻緝棄訖汽迄泣磧氣愒砌亟企契	旗啟淒祈谿豈悽琦琪麒耆漆杞起錡臍慼齊祁騎溪欺枝祇棋畦奇稽戚啓柒崎淇七隻綺其祺期圻乞棲衹歧岐萋鰭妻
遭	糟	蚤竈造噪皁譟躁鑿澡燥藻棗早
珪	閨龜圭瑰鮭皈傀規歸	鬼桂鱖癸軌跪詭晷櫃貴
嚨	聾窿籠龍矓隆瓏朧	隴攏壟
社	攝捨涉葉舍拾射設歙麝赦	捨甚什賒蛇舌奢
銲	憾悍旱頜翰撼漢捍瀚汗頷焊	含函和韓榦汗涵蚶罕鼾喊寒酣
慼	悽淒柒妻欺戚棲溪萋七谿漆	歧琪齊琦耆棋騎妻祺豈綺棄磧祁乞啟祇期器祈訖枝迄起錡氣其淇愒旗麒臍畦鰭崎圻杞汽奇岐衹企稽亟泣契憩砌緝
遣	淺譴	倩乾鉛謙韆嵌歉錢纖潛愆籤塹搴仟千牽欠簽前遷鉗騫鈐黔箝幹虔縴阡
責	債窄嘖祭笮寨則賊澤咋擇	仄齋宅側窄齊摘怎翟
瑣	索所鎖	莎縮梭嗦娑唆簑蓑
抄	勦鈔剿超	潮炒巢吵朝嘲晁
索	瑣所鎖	莎縮梭嗦娑唆簑蓑
絛	滔濤掏韜饕	洮桃討濤萄陶燾套檮淘逃啕
萋	悽淒柒妻欺戚棲溪七谿漆慼	歧琪齊琦耆棋騎妻祺豈綺棄磧祁乞啟祇期器祈訖枝迄起錡氣其淇愒旗麒臍畦鰭崎圻杞汽奇岐衹企稽亟泣契憩砌緝
攝	社捨涉葉舍拾射設歙麝赦	捨甚什賒蛇舌奢
諾	懦糯	挪娜
窟	骷枯哭	庫苦酷楛褲
誘	囿柚侑佑宥有莠又釉祐幼右鼬	悠憂攸友優猶疣鈾遊幽莠油由酉魷牖有黝郵尤猷
禹	雨語與宇庾敔噢齬圉予嶼羽圄	瘉澦域妤娛瘀馭獄逾峪昱燠褕蝓竽雩渝覦預漁迂語於與紆煜慾芋育餘餘俞歟堉鬱豫毓虞裕盂禦隅籲嫗榆喻愚魚玉欲譽禺熨輿癒寓愈愉諭御谷鬱淤腴臾遇諛圩聿尉瑜予萸浴於
楮	褚處儲杵礎楚	矗齣出畜黜鋤儲除絀跦廚怵雛處櫥歜躇觸初芻
幼	囿柚侑佑宥有莠誘又釉祐右鼬	悠憂攸友優猶疣鈾遊幽莠油由酉魷牖有黝郵尤猷
洫	敘恤畜絮酗婿蓄卹頊緒勗續旭序	墟胥籲戌許須徐訏鬚煦需虛咻栩噓
玖	赳酒糾灸九韭久	舊究糾救咎臼舅疚廄就揪柩鳩啾
泛	犯汎梵販飯範氾	藩煩反釩蕃礬返樊番繁幡翻凡繙墦帆
澦	裕瘉禦域籲嫗馭喻獄玉欲譽禺熨峪昱燠癒寓愈諭御谷鬱預語遇與煜慾芋育聿尉俞堉鬱豫浴毓	妤娛瘀宇逾褕竽蝓雨雩渝覦迂漁於語紆與噢齬餘餘俞歟羽虞盂隅榆敔愚魚圉禺禹嶼輿愉圄淤腴臾諛庾圩瑜予萸於
旎	你擬妳	尼妮霓呢溺怩倪逆匿暱泥睨膩
餌	邇爾耳洱	兒貳而二
宅	浙鷓蔗這翟	齋窄螫寨債哲齊褶懾者責着摘謫祭赭遮蜇轍摺折輒著
偺	雜咱砸	紮簪鏨贊瓚暫讚匝
鑲	廂瓖香箱湘襄鄉相	橡餉翔鄉嚮相向象饗詳降響祥像巷庠想項享
籮	鑼騾玀羅鏍儸邏螺囉蘿	裸落洛酪絡烙咯駱犖囉珞雒
嵇	畸姬畿其璣羈肌犄飢癘雞磯乩幾唧積箕幾奇譏激績期屐機跡勣稽蹟基躋嘰居饑	洎棘疾暨忌祭集脊己騎藉芰劑幾記楫瘠覬紀計級極妓冀戢擊寄輯寂給薊及嫉際幾唧麂繼擠急伋薺吉季圾即稷髻霽技汲吃亟既悸躋籍繫岌濟鯽戟驥
犁	罹麗蠡璃貍漓蜊喱狸梨籬犛驪離釐黎	裏荔琍儷利厲痢例欐莉曆醴礫李勵鯉瀝慄禮隸理浬蒞釙蠣靂俚立粒礪壢唳力邐娌俐戾澧吏麗蠡鬲溧癘鋰笠裡哩歷酈
炬	拒懼鋸巨颶遽倨劇苣句屨具鉅聚踞據瞿距足俱	橘拘菊鋸居鞠莒跼疽齟桔局駒狙蛆舉車沮掬侷俱咀矩
倡	暢鯧悵娼昌猖唱倀	嫦徜氅場悵償常嘗暢嚐鯧敞娼昌猖唱廠裳腸萇長倀
神	甚	慎身沁深哂脤甚沈呻砷參滲蜃瀋莘申娠紳伸信審腎嬸
蓑	梭娑嗦縮莎唆簑	鎖所瑣索
樺	話華猾滑畫劃化嘩豁譁	話花華猾滑畫劃化嘩豁譁
槐	懷淮踝徊	壞
瑙	惱腦	鐃撓鬧呶橈
遜	迅徇潠汛巽訊殉馴蕈訓	徇循潯勛尋醺燻勳旬洵璿詢巡荀薰馴
脣	醇鶉唇淳純	春蠢
獺	遝漯榻蹋踏遢塌躂撻	他塔牠她它塌
絞	攪狡鉸腳僥剿矯姣餃繳較勦皎角	礁醮澆嚼焦跤蕉嬌教交叫椒覺轎郊較窖膠蛟鮫驕校姣詨
廳	聽汀	庭蜓亭梃婷廷聽停挺霆艇
幢	撞牀	窗瘡囪創闖搶愴
嫖	瓢	飄縹驃漂剽票瞟
懶	纜覽欖攬	蘭攔爛斕纜襤瀾嵐藍籣濫闌婪籃欄
彆		癟別鱉
嗥	貉毫濠蚵壕豪鶴蠔嚎號	皓昊浩蒿鎬郝顥鄗好號涸耗
裊	鳥嬝	尿
丈	瘴脹賬帳障仗長杖漲幛	璋蟑樟獐掌彰章張長漲漳
岑	涔	參
誡	解芥介借屆疥戒界藉	睫傑節櫛竭姐揭潔捷姊頡擷階結桔孑接羯皆桀劫偕拮碣嗟解訐街詰截
牆	薔戕彊強檣	嗆鎗槍將鏘強繈搶羌腔
懂	董	東凍胴動咚恫洞冬棟鼕
秣	默沒漠陌膜磨末寞脈貊墨茉歿驀沫莫	磨摹模摩摸抹糢麼蘑謨魔膜
儷	慄麗礫礪唳痢歷靂力慄立癘溧蒞壢戾曆琍吏笠粒例利厲釙荔欐俐酈隸蠣勵瀝鬲莉	禮喱澧醴麗犁哩鯉犛貍籬黎娌璃浬釐離理驪邐李鋰梨狸裡罹裡漓蠡蜊俚
剋	髁嗑可課喀緙克刻溘恪客	軻坷稞棵渴磕可咳殼窠柯科刻顆苛蚵瞌蝌
恃	室螫筮奭勢嗜舐豉市士事仕拭識試世釋柿逝是適侍示飾軾誓弒氏式噬使視	濕詩十施屎師史匙提矢射食碩拾蝕駛塒屍噓時什溼豕獅失始蝨實石使
寨	祭責債	齋宅窄齊摘翟
醴	禮澧浬理哩鯉邐李鋰裡裡蠡俚娌	儷哩歷靂力慄立溧黎琍粒璃離利厲狸俐蠣漓蠡莉鬲慄喱麗犁礫礪唳痢犛貍籬蒞癘壢戾曆吏笠釐例釙荔驪欐梨罹隸酈勵瀝蜊
繙	番蕃翻幡帆	氾犯範泛梵礬販反藩汎蕃樊墦凡飯煩範釩繁返帆
坪	平馮枰蘋瓶萍屏憑評	娉乒
曦	攜淅悉熹烯禧犀嬉膝行蜥稀希吸溪畦晰兮析熙釐棲譆谿犧蟋唏羲晞嘻西奚蹊僖	系汐蓆翕戲隙惜習璽徙洗細鰓係媳矽喜息潟夕繫席錫熄歙襲昔檄褶
返	反	藩釩翻飯繙範蕃泛番樊墦販帆氾犯煩礬梵汎繁幡凡
湯	鏜觴殤商傷	膛螳糖躺趟棠燙唐醣鏜晌儻瑭堂裳賞塘尚淌搪帑倘上
冕	沔靦勉偭湎娩緬免	眠綿麵棉面
敏	閩皿湣愍閔澠憫泯抿	民岷玟
鴦	殃泱鞅央秧	楊颺羊養昜漾洋鞅樣怏徉揚氧仰烊煬鍚瘍陽暘癢恙佯
膚	伕夫敷鈇趺孵麩	孚富拂斧夫芙莆父復袱腐蝠菔氟覆阜撫腑符駙複幅輔服馥傅俯釜扶甫咐芾訃附輻腹俘賦伏匐賻彿副頫婦紼脯縛府付涪浮福弗怫負紱赴
菩	蒲璞脯濮莆樸匍釙葡蹼僕	撲普噗曝溥瀑圃鋪暴浦誧埔譜僕
響	享餉饗想	橡香翔鄉嚮相向象詳降廂鑲祥像瓖箱湘巷庠項襄
鴛	鳶淵冤宛	院願遠湲員猿袁援原媛沅轅垣爰元騵圓怨緣苑園源
肖	校嘯傚笑酵孝效	梟銷瀟霄小削蕭哮簫曉嘐硝囂學宵逍消驍篠
杖	瘴脹丈賬帳障仗長漲幛	璋蟑樟獐掌彰章張長漲漳
珮	轡配佩沛	壞裴呸陪培胚賠
豳	繽彬瀕儐濱檳賓	殯儐臏鬢
暘	烊鍚佯揚瘍洋颺羊楊徉昜陽煬	泱養仰鴦怏殃央秧癢樣漾恙氧鞅煬
摔	衰	蟀率帥甩
閃	陝	善芟煽珊鱔扇山禪疝潸羶舢汕繕跚膳縿刪杉擅單訕衫贍姍
蘭	攔斕襤瀾嵐藍籣闌婪籃欄	覽爛纜欖攬濫懶
少	邵紹哨召	捎哨韶紹杓芍燒梢邵勺稍召
倍	鋇背臂貝輩備孛悖憊邶狽焙蓓被	碑背杯北卑裨揹悲盃俾
裘	仇毬酋泅求球梂囚	蚯丘邱龜秋鞦鰍
智	制痔致製蛭躓窒質雉峙幟稚炙痣識置輊至滯秩摯知緻治志誌	徵植脂梔直摭之址質泜芝值胝躑枝吱祉祇肢擲支趾執祗職汁咫只殖織卮紙隻芷止蜘知姪指氏旨
島	禱導倒搗	蹈盜悼導道到稻叨刀倒
麝	攝捨赦拾設社射歙涉葉	舌捨奢什甚賒蛇捨
嫘	累鐳擂縲羸雷	磊累壘擂類儡漯淚蕾耒勒
溉	概鈣丐蓋	賅該垓改
疙	胳割歌鴿戈擱哥	革格隔個膈合鬲蛤鉻骼閤箇閣咯鎘各郃葛
疵	辭祠茨雌瓷詞慈磁差	辭賜此次祠雌詞差伺茨廁瓷刺慈磁
繕	鱔扇善膳禪擅訕疝單汕贍煽	扇縿姍刪山舢煽跚羶杉衫珊潸閃芟陝
反	返	藩釩翻飯繙範蕃泛番樊墦販帆氾犯煩礬梵汎繁幡凡
盆		噴
盜	蹈悼導道到稻倒	導島搗禱叨刀倒
攆	撚輦涊輾捻碾拈	廿念年黏唸
犧	悉禧行谿羲嬉晰釐蟋吸唏曦希蹊稀淅溪畦奚譆熙攜烯西析兮嘻僖蜥晞棲膝犀熹	細繫席昔惜洗隙褶襲矽習鰓翕係夕蓆熄檄璽息汐系媳錫戲潟徙喜歙
規	龜皈歸閨鮭圭珪瑰傀	晷桂鱖詭跪貴癸鬼軌櫃
縈	瑩嬴迎營楹塋贏蠅瀛盈螢熒	纓罌景郢鶯櫻映膺鸚嬰應瑛英鷹嚶瓔穎硬影
髖	寬	梡款
怠	待迨大貸黛逮殆戴玳袋岱帶代	呆待逮歹
彭	蓬膨朋澎棚鵬篷硼	捧澎抨碰烹砰
傚	效笑嘯校肖酵孝	梟逍囂哮消篠曉削硝銷小霄驍簫嘐瀟蕭宵學
豔	釅雁宴研艷硯嚥厭咽贗沿彥諺驗堰焰燄燕唁淹饜晏	言兗演研殷鹽菸奄顏咽巖厭閻簷沿眼湮煙偃魘郾延儼筵燕焉嫣嚴炎醃淹衍妍鼴掩癌胭
溜	陸六餾霤	榴瘤泵餾劉留霤六瀏硫陸鉚柳琉流遛
杜	度妒肚蠹渡鍍	讀賭肚睹嘟髑都獨督毒篤黷瀆堵櫝犢牘
何	褐劾曷荷禾郃嗑河閤閡涸闔盒盍翮核合紇貉和蓋	訶賀鶴赫暍郝嚇荷和呵喝
吞		囤臀褪豚飩屯
鞭	砭邊編蝙	辯扁遍貶變汴匾褊卞弁釆辨辮便
渣	喳扎眨查	閘搾炸柵扎吒紮乍喳札蚱眨砟咋詐查
獲	壑穫或惑貨濩禍豁霍擭	活夥火豁和
穩	刎吻	雯紊聞文瘟蚊塭汶免問溫紋抆玟
矗	怵觸絀歜畜處黜	齣除鋤杵褚初出芻儲楚廚雛櫥跦處楮躇礎
售	獸瘦狩壽授受綬	守收手首熟
妥	橢	託駝柝脫馱佗跎拖陀鴕唾拓沱
鏡	靜敬競徑淨勁痙逕竟靖境	井精荊兢警旌京經粳菁驚頸涇晶鯨睛莖阱憬璟景更
盾	燉頓遁噸吮沌囤盹鈍	順敦蹲舜惇盹躉墩瞬
擔	啗蛋單氮啖簞誕但澹淡旦丹耽憚彈石	撢淡蛋啖丹簞誕耽憚彈啗單氮但澹旦膽石疸
腱	件檻劍健僭見艦漸毽諫濺踐監箭間閒薦建鍵餞鑑鑒澗賤薦	箋縑兼姦韉漸殲奸囝艱柬檢簡濺減筧監間肩尖湔剪鹼瞼繭堅菅緘撿揀儉煎
繁	藩煩釩蕃礬樊凡帆墦	犯反返蕃梵泛番汎幡販翻飯繙範氾帆
違	薇圍唯濰桅惟幃維帷闈危巍爲韋微為	葦魏畏褽偽崴慰緯尉猥諉煨謂逶鮪僞遺渭威偎萎喂尾餵痿未位委胃洧穌蔚衛味娓偉為
含	韓寒函榦涵汗	瀚喊罕銲悍鼾憾蚶焊漢旱撼酣頷捍和翰汗頜
虎	琥唬許	鵠葫扈惚湖呼戶瑚壺弧鬍沍乎瓠護互囫糊狐胡滬蝴忽戲楛斛
劊	筷塊膾會檜儈快	
惇	蹲墩敦	鈍燉囤躉噸頓盾沌遁盹
場	腸嘗嫦嚐徜萇敞氅裳長償廠常	嫦徜氅悵償常嘗暢嚐鯧敞娼昌猖唱廠裳腸萇長倡倀
曹	漕嘈槽	草操糙
儒	燸如濡嚅孺蠕茹	汝入女褥辱孺乳茹
阮	軟蠕	
稞	軻窠科柯刻顆蚵苛瞌棵蝌磕	嗑課客恪溘坷渴剋髁可咳喀殼緙克刻
促	卒醋趣鏃趨錯簇槭蹙蹴	粗
儐	繽彬瀕殯豳濱臏檳鬢賓	繽彬瀕豳殯濱臏檳賓鬢
臀	豚囤飩屯	吞褪
踏	遢漯蹋獺塌躂撻遝榻	它牠塔她塌他
疹	診枕縝	賑陣箴偵針鎮斟振真診臻鴆禎榛砧貞娠楨枕朕珍震甄
紇	嗑合蓋河郃翮和闔盍核荷貉禾曷劾盒閡何褐閤涸	嚇郝和訶喝鶴賀暍荷赫呵
貌	冒瑁茂懋耄貿帽	茅茆卯髦泖毛貓矛錨
或	獲壑穫谿惑貨濩禍霍擭	活夥火豁和
碉	鯛凋叼彫雕貂刁	釣調掉弔吊
默	膜末貊莫磨陌墨驀沫秣脈茉寞漠沒歿	膜抹蘑摩摸磨模糢謨魔摹麼
同	童桐瞳僮潼銅彤峒	統慟桶筒恫痛通
真	禎榛箴斟診偵砧貞針珍楨甄臻	賑鎮疹鴆陣枕振朕診娠震縝
沅	緣媛源員原轅園圓援騵猿湲元爰袁垣	宛院苑媛願淵願冤鴛鳶怨遠
執	職植質姪值直躑擲殖摭	智徵制脂痔梔致之製蛭址躓質窒雉芝泜胝枝吱峙祉幟肢支祇稚趾祗炙痣識汁咫置輊只至織卮滯紙隻芷止蜘秩摯知指氏緻治志旨誌
伉	亢炕抗	糠慷康扛
竺	軸竹朮築築燭躅逐	主杼薴註柱諸朱茱矚銖囑屬煮鑄住渚助佇蛀藷拄侏硃誅蛛箸貯駐注豬祝珠株
騫	簽阡嵌仟縴愆鉛千謙牽搴遷韆籤	乾欠前塹縴遣黔歉倩箝虔潛淺鈐譴錢鉗
栩	煦咻許	敘絮蓄徐鬚需勗續序噓胥墟畜恤洫酗婿籲卹戌須訏頊緒虛旭
髓		綏遂隨碎祟誶隋穗隧歲睢雖燧邃
幹	潛淦柑黔乾尷榦甘桿前坩疳肝鉗竿杆錢贛	淺乾橄鉛謙嵌甘歉纖遣籤疳肝贛千牽欠遷感稈竿杆桿敢淦柑幹尷榦干坩譴趕
逮	待迨代大貸歹黛殆戴玳袋岱帶怠	待迨代大貸歹黛殆戴玳呆袋岱帶怠
奶	迺氖奈乃	耐奈
湘	廂瓖香鑲箱襄鄉相	橡餉翔鄉嚮相向象饗詳降響祥像巷庠想項享
橡	向象巷像項鄉嚮相	香餉翔鄉相饗詳降廂鑲響祥瓖箱湘庠想襄享
趣	卒醋漆鏃促趨錯簇槭娶去蹙蹴	取趨渠驅娶砠劬曲齲衢蛐區麴屈圈軀璩蛆嶇瞿粗
蕉	蛟礁鮫教嬌驕澆姣膠交焦椒詨郊跤	攪醮矯嚼餃狡教剿叫覺轎較鉸勦腳僥窖絞繳校姣皎角
蠔	貉毫嗥濠蚵壕豪鶴嚎號	皓昊浩蒿鎬郝顥鄗好號涸耗
頓	燉遁盾噸沌囤盹鈍	敦蹲惇盹躉墩
卿	輕蜻清氫頃青鯖傾	請親擎檠頃情晴磬傾慶罄
踫	盤蹣般胖蟠槃磐	叛拚潘判盼攀畔
譬	媲闢癖屁僻	啤埤劈陂脾裨匹琵枇疲壞仳紕霹被陴披鼙鈹否批毗丕沘痞疋罷皮
椎	錘鎚追陲垂綞隹捶錐槌箠	吹贅墜惴炊綴
洛	落酪絡烙咯駱犖珞雒	裸鑼騾玀羅鏍儸邏螺囉蘿籮
構	遘夠雊媾詬搆購垢	苟鉤狗溝勾枸句
炕	伉亢抗	扛慷糠康
範	犯梵泛汎販飯范氾	藩煩釩反蕃礬返樊番繁幡翻凡繙墦帆
屑	燮解褻懈卸契瀉楔洩蟹駭邂榭械謝紲屜	寫血挾諧頡擷偕歇蠍邪斜些攜勰協鞋脅
勢	室恃螫筮奭嗜舐豉市士事仕拭識試世釋柿逝是適侍示飾軾誓弒氏式噬使視	濕詩十施屎師史匙提矢射食碩拾蝕駛塒屍噓時什溼豕獅失始蝨實石使
呻	參信身申莘深娠紳砷伸	脤甚慎沈滲沁蜃審瀋腎哂嬸神
褕	盂妤隅娛榆愚魚逾禺輿愉蝓竽雩渝覦腴漁臾於諛圩餘餘瑜俞予歟萸於虞	瘉澦域瘀宇馭獄峪昱燠雨預迂語紆與煜齬慾噢芋育俞堉鬱豫羽毓裕禦籲嫗敔喻玉欲圉譽禺禹熨嶼癒寓愈諭圄御谷鬱淤遇庾聿尉予浴
雲	勻耘筠昀紜芸雲	允醞隕氳韻慍暈蘊運員熨孕
循	徇尋潯旬洵璿詢巡荀馴	迅徇潠勛汛醺燻勳巽遜訊殉薰馴蕈訓
裕	芋與馭御喻育瘉寓禺鬱尉癒諭玉澦語煜欲谷昱愈聿峪嫗籲預豫浴域獄毓遇堉慾譽禦熨俞燠	與魚諛宇雨雩竽禹予愚禺虞迂齬蝓噢盂圉逾褕圩瘀榆渝語萸漁瑜庾輿嶼歟於腴紆妤隅圄愉羽臾餘淤覦敔俞娛
揩	開	凱咳愷慨愾豈愒剴楷
攣	孿	
軋	亞噶訝氬	涯雅亞牙價押鴉呀丫鴨蚜煆壓芽尬啞嘎衙疋
妓	霽髻寄際繼繫稷薺技記忌騎悸覬劑紀季計祭驥濟鯽芰暨洎薊系冀躋既	急唧疾脊跡即寂楫屐居伋績擠吉犄饑譏擊羈機及乩嫉積激己汲藉亟岌吃瘠奇給稽借棘箕級圾嘰戟麂躋蹟籍濟輯畸嵇幾其肌期集戢飢雞極癘璣基磯畿姬勣
蹙	鏃趨錯促卒槭蹴簇醋趣	粗
柩	廄究舊救臼舅咎就疚	九揪韭啾赳鳩灸久酒糾玖
譁	樺花華猾滑劃嘩豁	樺話花華畫劃化嘩
屜	悌卸洩榭屑楔涕替蟹逖邂契褻懈惕嚏謝駭械燮解銻剃瀉紲	體隄踢歇啼蠍提寫題血諧梯頡擷剔邪勰鞋偕攜緹挾蹄斜些堤協脅
摻	攙	闡儳懺纏諂饞蟾澶嬋剷禪產讒蟬羼孱毚單潺巉鏟
汾	墳焚	棻氛吩紛分忿憤芬份糞奮粉
字	孳漬自恣	仔訾淄玆子錙輜籽滓資孳茲吱梓貲孜姿髭紫諮滋緇齜
酥	甦蘇穌囌	溯嗉訴塑速縮粟宿俗蓿素夙肅簌
蠹	杜度鍍渡肚妒	髑瀆堵櫝讀睹犢篤黷賭嘟肚都督毒牘獨
且		竊鍥伽愜挈怯妾茄切契
沈	宸忱塵晨沉辰審瀋諶陳哂娠臣嬸	慎身沁深稱疢脤甚趁櫬呻砷參襯琛滲讖蜃莘申紳娠伸信腎瞋神
踐	餞澗鑒劍閒毽諫箭僭艦件健建間檻見監賤濺薦腱漸鑑鍵	尖儉堅艱減菅緘韉柬湔撿簡殲瞼肩筧間揀繭煎姦剪鹼監檢縑濺奸兼漸囝箋
必	庇埤幣裨箄襞篦蔽鄙弊斃比蹕碧詖鉍賁陛避畢壁嗶闢璧臂敝痺愎泌睥婢薜閉祕弼俾	逼鄙匕筆鼻沘比妣彼
契	器憩卸愜洩榭怯切汽企屑竊楔磧泣蟹邂砌亟褻懈鍥訖迄謝駭械妻緝燮解棄氣愒挈瀉妾紲屜	旗啟淒祈谿豈歇悽琦茄切蠍琪耆麒寫且漆起錡諧頡伽臍血慼杞齊擷祁騎邪溪勰欺枝鞋祇棋畦奇稽戚啓偕柒攜崎淇七隻綺祺其挾期圻乞棲衹斜歧岐些萋鰭妻協脅
睬	綵採踩彩	猜採纔材才菜財裁蔡
穹	窮瓊	窮瓊
裔	屹藝肄軼刈誼囈縊逸佾溢劓疫懿鎰毅義邑億液佚役易羿弋蜴驛弈帟譯翌異益臆亦艾腋曳詣議意繹憶掖浥翳奕一抑翼衣	漪尾咦姨椅壹蟻飴旖誼偯迤栘移以彝夷已遺沂宜咿醫頤伊噫疑乙怡貽揖訑迆蛇矣圯胰儀一衣痍倚依
嘩	劃豁滑花譁樺劃猾華	畫劃化豁花滑話譁樺劃猾華
隘	噯艾礙璦愛曖	靄哀藹埃捱哎矮挨唉皚
餿	搜蒐颼	叟藪擻嗽嗾
鈐	乾箝虔潛前黔錢鉗	簽欠阡嵌仟塹縴遣歉倩愆鉛騫千謙淺遷牽搴韆籤譴
螂	狼瑯榔琅郎廊	浪朗
瞿	苣炬颶具巨鉅璩劇倨距屨遽圈俱砠曲聚區渠據驅趨嶇劬懼麴踞蛆屈蛐軀句足鋸衢拒	桔取疽璩圈砠俱狙曲區掬侷渠驅齟趨嶇去娶咀莒舉劬趣麴漆蛆橘跼屈齲車駒拘蛐軀局菊沮鋸衢居鞠矩
雜	砸偺咱	匝紮
奉	鳳俸諷縫	豐馮諷逢縫峯風鋒楓封蜂烽瘋
憮	武舞鵡五捂伍嫵侮午	汙晤騖巫吾塢悟亡誤誣務無吳烏毋寤戊惡嗚鼯於唔物勿霧屋兀圬鎢軏污梧蕪蜈堊
蘚	顯蜆癬險銑鮮	僩纖峴餡涎限嫌莧舷暹銜啣鹹秈現霰嫻祆姍腺閒鮮絃閑羨鹹憲獻仙弦蜆陷掀縣線先賢
憂	悠優攸幽	囿佑誘幼友侑又祐猶疣鈾柚遊莠油由酉魷右牖宥黝有釉郵尤猷鼬
箭	餞澗鑒劍閒毽諫僭踐艦件健建間檻見監賤濺薦腱漸鑑鍵	尖儉堅艱減菅緘韉柬湔撿簡殲瞼肩筧間揀繭煎姦剪鹼監檢縑濺奸兼漸囝箋
殼	闋雀咳撬蹺俏恪誚闕鵲翹竅峭卻榷鞘怯確	憔科雀軻顆坷譙喀剋鵲刻克苛愀蹺缺恪嗑翹蝌悄磕瞧緙柯巧稞蚵棵鍬可闕僑課瘸渴喬樵窠瞌橋溘撬橇客敲髁
虞	盂妤隅娛榆愚魚逾禺輿愉褕竽蝓雩渝覦腴漁臾於諛圩餘餘瑜俞予歟萸於	瘉澦域瘀宇馭獄峪昱燠雨預迂語紆與煜齬慾噢芋育俞堉鬱豫羽毓裕禦籲嫗敔喻玉欲圉譽禺禹熨嶼癒寓愈諭圄御谷鬱淤遇庾聿尉予浴
肄	詣劓羿浥異益議藝軼意刈鎰縊逸憶抑艾佚奕翌衣佾誼億役翳懿一掖屹易裔繹液弋帟邑腋曳溢臆翼亦囈蜴驛毅義譯弈疫	咿儀揖怡飴咦依姨迆痍胰頤以遺噫移乙矣蛇衣伊夷誼尾漪圯蟻彝已壹一醫沂旖栘倚迤貽椅訑宜疑偯
臍	旗祈琦琪麒耆錡齊祁騎枝祇棋畦奇只崎淇其祺期圻衹歧岐鰭	器憩啟淒谿豈悽企汽漆杞起慼磧泣溪亟砌欺契稽訖戚啓迄柒緝七綺棄乞棲氣愒萋妻
蜿	彎灣莞碗挽宛輓晚皖綰剜豌娩婉	惋彎灣丸完碗莞頑腕萬挽宛玩輓晚皖綰汍豌剜娩婉
嫁	稼賈假架價駕	鉀加家甲茄胛嘉賈假葭頰傢豭佳戛迦袈莢痂夏挾夾浹
廉	憐漣奩簾蓮濂鐮聯鰱連	瀲煉楝斂鏈臉鍊戀殮練
枴	拐	乖怪
瀘	蘆爐盧廬臚鑪鱸顱	路滷露魯擄鹵櫓鹿麓戮僇碌氯嚕鷺陸錄穋祿虜賂
恕	數漱墅術豎庶曙樹束倏署述戍疏	鼠黍署輸數薯贖梳菽暑舒叔淑蜀書藷殊疏塾屬橾抒蔬樞熟孰
蓮	憐漣奩簾鐮濂聯鰱連廉	瀲煉楝斂鏈臉鍊戀殮練
晚	皖婉蜿宛碗挽莞娩輓綰	汍剜玩彎惋萬蜿豌灣莞頑腕丸完
瓖	鄉鑲廂湘襄箱香相	餉響祥像詳嚮降翔庠鄉橡巷象享饗想項向相
剩	賸乘勝聖盛	笙牲昇聲陞省甥繩澠勝生升
誨	賄會彙蟲彗穢繪燴蕙潰匯卉虺燬毀諱惠慧悔晦喙	蛔賄會彙蟲彗詼燴潰蕙繪穢輝匯茴揮卉虺回燬麾徽灰毀諱惠迴墮恢暉慧悔晦喙
挽	皖娩婉蜿宛碗莞晚輓綰	汍剜玩彎惋萬蜿豌灣莞頑腕丸完
淤	紆瘀迂	與諛虞鬱尉癒逾玉語漁谷輿於愈聿妤隅羽獄堉榆譽覦熨宇雩竽愚寓蝓萸昱峪預豫域愉臾遇慾禦俞娛芋馭御喻魚育雨予禹瘉齬噢圉褕諭澦渝瑜庾裕嶼腴嫗籲餘圄敔禺盂圩煜欲歟毓浴燠
柄	餅秉鉼丙稟屏炳	摒冰兵並併病
歲	遂碎祟誶隧穗燧邃	綏髓隨隋雖睢
堉	裕瘉澦禦域籲嫗馭喻獄玉欲譽禺熨峪昱燠癒寓愈諭御谷鬱預語遇與煜慾芋育聿尉俞鬱豫浴毓	妤娛瘀宇逾褕竽蝓雨雩渝覦迂漁於語紆與噢齬餘餘俞歟羽虞盂隅榆敔愚魚圉禺禹嶼輿愉圄淤腴臾諛庾圩瑜予萸於
驟	奏揍	啁陬鄒走鄹
琍	慄儷麗礫礪唳痢歷靂力慄立溧蒞癘壢戾曆吏笠粒例利厲釙荔欐俐酈隸蠣勵瀝鬲莉	禮喱澧醴麗犁哩鯉犛貍籬黎娌璃浬釐離理驪邐李鋰梨狸裡罹裡漓蠡蜊俚
股	罟鼓賈凸鵠牯穀滑轂詁鈷骨瞽古蠱谷	咕顧錮鴣告家僱骨估蛄鈷菰故呱姑孤辜固沽
整	拯	政爭徵猙幀諍掙睜証證癥丁蒸怔箏崢錚鄭症正
櫃	跪貴桂鱖	晷龜皈歸詭閨鮭癸規圭珪瑰鬼傀軌
締	棣第帝娣蒂的地弟遞諦	氐笛嘀犒敵邸柢砥翟迪狄嫡的牴低抵滌芽荻詆鏑滴底
忿	分奮糞憤份	棻分汾焚粉吩芬紛墳氛
感	敢橄稈趕杆桿	淦柑乾幹尷榦甘桿疳坩肝竿贛
尿		裊嬝鳥
鋪	撲噗曝瀑暴僕	莆暴誧撲蒲璞普樸釙葡僕菩濮曝瀑圃溥噗脯匍譜浦埔蹼
帆	藩煩釩蕃礬樊番繁幡翻凡繙墦	藩釩翻飯繙範返蕃泛番樊墦反販氾犯煩礬梵汎繁幡凡
杼	鑄住箸助註薴駐柱蛀注佇祝	主軸築朱諸茱矚銖囑朮築屬燭煮渚竹竺拄藷侏硃誅蛛貯躅逐豬珠株
痱	費廢屝芾肺沸怫吠	菲斐肥翡非腓妃飛扉誹啡霏匪
驥	洎暨寄忌祭薊騎芰際劑繼薺記季稷髻霽技紀覬既悸計躋繫濟妓鯽冀	棘璣羈疾肌集脊己藉雞磯乩積幾績期屐機楫瘠嵇跡蹟基級極居戢畸姬畿其擊輯寂給犄飢及嫉癘幾唧箕麂擠急伋奇吉譏激圾即汲勣稽吃亟躋籍岌嘰濟戟饑
紼	氟縛匐夫蝠扶芾幅孚弗輻紱袱福浮伏符菔拂涪怫彿服芙俘	富馥覆附膚俯鈇複府夫腑腐頫甫阜腹賻副傅復釜敷付撫斧孵赴婦莆趺輔咐父麩脯賦負駙伕訃
幾	唧脊跡畿屐居績擠犄饑譏羈激機乩積己奇給稽箕嘰戟麂躋蹟濟畸嵇其癘肌幾期雞璣基磯飢姬勣	霽寄擊忌騎悸己藉紀瘠計圾籍畸洎璣磯飢既躋唧脊楫居績稷譏羈覬劑吃季借稽祭麂蹟驥鯽幾集犄姬際伋吉薺饑機及乩亟奇棘箕妓濟嵇其芰戢雞基薊系冀急髻疾跡繼寂即繫屐擠技記激嫉汲積岌給級嘰戟輯癘肌期暨極畿勣
攫	鴃掘鱖抉獗決譎蹶劂腳倔玨角爵孓崛觼覺蕨訣厥絕嚼噱	倔蹶嗟
尷	乾竿疳坩甘柑桿幹肝	橄淦幹贛敢榦感稈桿趕
壇	痰談潭譚覃檀罈彈曇	坍癱灘探碳袒嘆毯貪攤炭歎坦
徑	鏡靜敬競淨勁痙逕竟靖境	井精荊兢警旌京經粳菁驚頸涇晶鯨睛莖阱憬璟景更
耿	哽梗埂	亙耕庚更羹粳賡
哼	亨	橫恆桁衡
涵	韓寒函含榦汗	瀚喊罕銲悍鼾憾蚶焊漢旱撼酣頷捍和翰汗頜
訣	觼蕨嚼劂掘鴃崛倔鱖絕玨覺獗厥腳抉孓譎爵攫蹶決噱角	蹶嗟倔
勞	癆酪絡牢烙嘮	癆佬酪絡牢烙撈嘮姥老
泥	尼溺怩暱霓膩逆倪匿呢睨妮	尼你溺暱霓逆膩妳倪擬旎匿呢怩睨妮
掠	略	
慌	荒肓	凰恍遑湟幌黃篁晃簧謊韹洸煌蝗隍皇徨璜惶磺
偃	鼴衍魘掩兗眼儼郾演	豔閻癌堰焰諺菸雁簷驗湮醃贗咽艷殷硯巖炎晏延研妍嚥奄彥煙簷胭沿燕鹽醃饜顏釅筵巖厭嚴淹燄言焉嫣宴唁
孤	咕姑估鴣沽蛄鈷家辜菰呱	顧錮鼓牯鵠穀滑告古僱骨罟股賈估鈷故蠱谷凸轂詁固瞽
媾	購構雊垢遘夠詬搆	勾狗句枸鉤溝苟
鏃	趨錯促卒槭蹴蹙簇醋趣	粗
憚	誕氮蛋淡石旦擔彈但澹啖啗	簞丹擔耽撢單膽疸
瞞	饅鰻漫蹣蠻	鏝滿曼縵屘漫蔓幔慢
杭	吭行桁航	行沆
鄒	鄹啁陬	揍走驟奏
嚼	觼蕨劂掘訣鴃崛倔鱖絕玨覺獗厥腳抉孓譎爵攫蹶決噱角	攪礁醮澆矯餃焦跤蕉嬌狡教倔剿椒交叫覺轎郊較勦鉸腳僥窖絞膠繳嗟蛟鮫驕校姣蹶詨皎角
寂	急唧疾脊即楫伋吉擊及嫉汲亟岌藉吃瘠借棘圾級籍輯戢集極	唧霽髻寄脊跡際繼冀繫屐居績稷擠犄薺饑譏技記忌羈騎機乩激積覬己悸劑紀季奇給稽既箕計嘰祭戟麂妓蹟躋驥濟鯽畸嵇幾其肌芰期飢癘雞暨洎璣基薊系磯畿姬勣
敞	氅廠場	嫦徜場悵償常嘗暢嚐鯧娼昌猖唱裳腸萇長倡倀
主	屬拄煮矚囑貯渚	諸逐軸朱蛀躅茱鑄硃助蛛箸誅術注珠豬薴祝築朮柱竺杼侏藷燭駐註佇株銖竹住
積	唧跡畿屐居績犄饑譏羈激機乩奇稽箕嘰躋蹟畸嵇其癘肌幾期雞璣基磯飢姬勣	急唧霽髻疾脊寄際繼寂即繫楫伋稷擠吉薺技記擊忌騎及悸嫉汲覬己亟藉劑岌紀吃季瘠給借棘計級祭圾戟麂妓驥籍濟鯽輯幾芰戢集暨洎極薊系冀躋既
頰	戛挾夾浹莢	稼鉀加架家甲茄駕胛嘉賈假價嫁葭豭傢佳迦袈痂夏夾
鼾	蚶和酣	憾悍旱頜含函韓漢榦汗頷涵銲翰撼罕捍瀚喊寒焊
眠	綿棉	沔靦娩勉麵冕偭湎面緬免
宸	陳娠諶晨忱臣塵辰沉沈	讖櫬稱襯疢琛趁瞋
蹲	墩惇敦	燉頓遁盾噸沌囤盹鈍躉
磅	旁傍滂鎊乓謗棒蚌	梆胖膀旁邦傍綁螃榜龐幫徬
嚏	涕悌屜剃替銻逖惕	剔題梯堤蹄踢啼體隄緹提
世	室恃螫筮奭勢嗜舐豉市士事仕拭識試釋柿逝是適侍示飾軾誓弒氏式噬使視	濕詩十施屎師史匙提矢射食碩拾蝕駛塒屍噓時什溼豕獅失始蝨實石使
俐	荔琍儷痢例利厲欐莉曆礫勵瀝慄隸蒞釙蠣靂立礪壢粒唳力戾吏麗癘鬲溧笠歷酈	裏貍醴李離鯉釐黎罹禮漓理浬梨驪狸蜊俚娌邐澧麗蠡犁璃鋰喱籬犛裡哩
衙	蚜涯牙押芽	啞鴨亞疋訝軋煆雅鴉押呀丫壓氬
盅	終忠鐘忪衷鍾中	湩種仲重衆腫眾中塚踵
貉	毫蓋濠盍蠔嚎荷禾曷盒嗥閡褐蚵閤鶴嗑合郃河和翮紇闔壕核劾何豪涸號	昊浩嚇和訶喝鄗荷暍赫皓蒿鎬郝顥賀鶴好號涸耗呵
宜	儀怡飴咦姨痍胰頤遺移蛇圯夷誼彝一沂栘迤貽訑疑	咿詣劓揖羿浥異益議藝軼意刈鎰依縊迆肄逸憶以噫抑乙艾佚矣奕翌衣伊佾誼億漪役蟻尾翳已懿壹一掖醫屹易裔繹旖倚液弋迤帟偯邑腋曳溢椅臆翼亦囈蜴驛毅義譯弈疫
人	兒仁任壬	刃任軔忍認荏賃稔飪韌紉仞妊衽
登	燈	等凳嶝磴蹬瞪鄧
縝	診枕疹	陣禎鴆枕診貞真楨針斟朕賑臻震珍砧娠榛偵甄鎮振箴
困	睏	錕崑梱綑捆焜坤琨昆髡
拂	孚夫芙袱蝠菔氟符幅服扶芾輻伏俘匐彿紼縛浮涪福弗怫紱	富斧夫敷莆父復腐覆阜腑撫駙複輔傅鈇俯釜甫膚咐訃附腹賦賻副頫婦伕脯府付趺孵麩負馥赴
菌	竣浚郡駿俊雋濬蕈峻	龜均窘君鈞軍
徹	澈坼撤掣轍	車扯
惹	若	熱
鮭	閨龜珪圭瑰皈傀規歸	鬼桂鱖癸軌跪詭晷櫃貴
緯	猥諉葦偉痿鮪委娓洧萎尾	違魏畏帷褽偽崴慰尉薇圍唯煨桅謂逶僞幃遺維渭威巍偎爲萎喂餵濰惟闈未位危委韋胃微穌蔚衛味為
遺	儀魏怡畏飴褽咦偽慰姨尉謂痍胰頤僞渭爲移蛇喂夷誼圯餵彝一未位沂栘胃穌迤貽蔚衛味訑宜疑為	葦劓羿浥益藝軼鎰緯肄逶憶幃維矣佚翌萎伊惟一闈屹洧溢臆囈偯咿揖議意崴刈依唯煨噫以威乙役億蟻痿委繹韋弋迤腋毅譯詣縊薇圍諉猥桅逸抑漪懿壹醫倚液微帟翼義疫違異帷迆鮪巍艾偎奕衣佾誼尾翳濰已掖易危裔旖邑曳椅亦娓蜴驛偉弈為
瞇	咪	謎彌弭密糸米蜜糜靡汨敉祕覓瀰祕冪麋謐泌迷
菰	咕孤鴣辜鈷沽估姑呱蛄家	凸鵠僱罟賈鼓穀顧估僱故轂股告谷滑牯蠱瞽錮古詁鈷固骨
砷	呻伸深娠信身紳參申莘	哂審甚滲瀋腎蜃沁嬸脤神慎沈
榴	瘤泵留劉瀏硫琉流遛	餾霤六陸溜鉚柳
黛	迨大貸怠逮岱待玳帶殆代戴袋	逮待歹呆
灸	赳酒玖糾九韭久	舊究糾救咎臼舅疚廄就揪柩鳩啾
狼	螂廊郎琅瑯榔	浪朗
乖		拐枴怪
琨	髡焜坤錕昆崑	睏捆綑困梱
蜥	攜曦淅悉熹烯禧犀嬉膝行稀希吸溪畦晰兮析熙釐棲譆谿犧蟋唏晞嘻羲西奚蹊僖	系汐蓆翕戲隙惜習璽徙洗細鰓係媳矽喜息潟夕繫席錫熄歙襲昔檄褶
獄	芋與馭御喻育瘉寓禺鬱尉癒諭玉澦語煜欲谷裕昱愈聿峪嫗籲預豫浴域毓遇堉慾譽禦熨俞燠	與魚諛宇雨雩竽禹予愚禺虞迂齬蝓噢盂圉逾褕圩瘀榆渝語萸漁瑜庾輿嶼歟於腴紆妤隅圄愉羽臾餘淤覦敔俞娛
坩	乾竿疳甘柑尷桿幹肝	橄淦幹贛敢榦感稈桿趕
刃	任軔認賃飪韌紉仞妊衽	壬忍荏稔人任兒仁
利	荔琍儷痢例厲欐莉曆礫勵瀝慄隸蒞釙蠣靂立礪壢粒唳力戾俐吏麗癘鬲溧笠歷酈	裏貍醴李離鯉釐黎罹禮漓理浬梨驪狸蜊俚娌邐澧麗蠡犁璃鋰喱籬犛裡哩
劉	榴瘤泵留瀏硫琉流遛	餾霤六陸溜鉚柳
兌	隊碓對	堆
悠	優攸幽憂	囿佑誘幼友侑又祐猶疣鈾柚遊莠油由酉魷右牖宥黝有釉郵尤猷鼬
橈	鐃撓蟯嬈饒呶	繞瑙惱鬧腦擾
梆	邦幫傍	膀旁傍綁鎊磅榜謗棒蚌
估	咕顧錮姑固鴣沽孤蛄告鈷呱家辜菰故僱	咕顧鼓錮鴣牯鵠穀滑告家古僱骨罟股賈蛄鈷菰故呱蠱谷姑凸孤轂詁辜固沽瞽
胤	印飲蔭隱	夤聽銀飲尹茵寅姻湮慇殷引癮鄞因齦淫音簷垠陰吟縯氤隱蚓霪
爨	竄篡	
食	十寺似提伺兕射耜祀泗嗣碩拾巳駟賜蝕飼肆塒四時什俟實石姒	濕詩室思司恃施螫視屎筮鷥師史匙奭勢嗜舐豉矢市士事仕拭嘶識廝私試世釋柿逝是駛適噓屍侍示飾豕軾溼獅失誓死斯絲弒氏式始蝨噬使撕
澶	饞讒禪蟬潺孱蟾毚嬋單巉纏	懺剷摻諂攙儳鏟闡產羼
諳	鞍安氨庵銨鵪	菴黯暗按案俺岸
覺	觼醮蕨嚼劂掘訣鴃崛教倔鱖絕叫玨轎較獗厥腳窖抉孓譎校爵攫蹶決噱角	攪礁澆矯嚼餃焦跤蕉嬌狡教倔剿椒交郊較勦鉸腳僥絞膠繳嗟蛟鮫驕姣蹶詨皎角
郊	蛟礁鮫教嬌驕蕉澆姣膠交焦椒詨跤	攪醮矯嚼餃狡教剿叫覺轎較鉸勦腳僥窖絞繳校姣皎角
殤	觴湯傷商	賞晌上裳尚
舢	扇姍縿刪山煽跚杉衫羶珊潸芟	鱔扇膳禪擅疝訕繕汕贍煽善閃單陝
擦	搽	
綬	授售狩壽受獸瘦	熟守首收手
嗚	屋鎢巫惡於汙污烏圬誣	無巫毋勿騖寤軏梧嫵誤惡舞物堊吾兀誣務鎢悟塢霧吳五侮鼯蕪捂鵡憮晤戊蜈午亡武伍唔
汎	販氾犯範飯梵泛範	繙礬番反藩蕃墦樊凡煩翻釩返幡繁帆
芹	擒禽勤琴秦噙	嶔寢欽沁侵親撳
朕	震陣娠鴆枕鎮賑振	禎枕診貞縝真針楨斟疹臻珍砧偵榛甄箴
儸	騾羅螺籮蘿玀鑼囉邏鏍	烙珞駱洛酪咯絡雒囉犖裸落
籠	聾窿龍矓隆瓏朧嚨	隴攏壟
藏	葬髒臟奘	贓蒼傖艙滄臧臢髒倉
輞	惘往網魍罔枉	望汪亡王旺妄尢忘
赦	社攝捨涉葉舍拾射設歙麝	捨甚什賒蛇舌奢
鼓	罟股賈凸鵠牯穀滑轂詁鈷骨瞽古蠱谷	咕顧錮鴣告家僱骨估蛄鈷菰故呱姑孤辜固沽
詩	濕屍噓失獅溼施師蝨	室十恃螫屎筮史提匙奭實勢嗜舐豉矢射市食士事仕拭碩拾識蝕試世釋柿逝是駛適塒侍示時什飾豕軾誓弒始氏式噬石使視
滑	樺鼓牯鵠猾穀古骨罟股賈鈷豁蠱谷凸轂詁嘩華劃瞽譁	咕樺顧錮鴣告家僱骨話花估蛄鈷化菰故呱姑孤嘩辜固華沽畫劃
糯	懦諾	挪娜
符	孚拂夫芙袱蝠菔氟幅服扶芾輻伏俘匐彿紼縛浮涪福弗怫紱	富斧夫敷莆父復腐覆阜腑撫駙複輔傅鈇俯釜甫膚咐訃附腹賦賻副頫婦伕脯府付趺孵麩負馥赴
袁	沅轅垣圓爰緣湲園援元騵原源媛員猿	怨院鳶苑宛鴛願淵遠冤媛
圉	雨語與宇庾敔噢齬禹予嶼羽圄	瘉澦域妤娛瘀馭獄逾峪昱燠褕蝓竽雩渝覦預漁迂語於與紆煜慾芋育餘餘俞歟堉鬱豫毓虞裕盂禦隅籲嫗榆喻愚魚玉欲譽禺熨輿癒寓愈愉諭御谷鬱淤腴臾遇諛圩聿尉瑜予萸浴於
鬥	讀逗痘竇抖陡蚪豆脰枓	讀逗痘竇都斗陡抖鬥兜蚪豆脰枓
嚇	夏和廈鶴賀暍赫郝下荷暇喝	褐霞呷劾訶曷狎柙瑕荷蝦禾郃何黠和遐嗑洽河閤蓋呵瞎閡涸轄闔盒狹盍峽翮挾合核匣紇斜貉暇俠喝
河	褐劾曷荷禾郃和嗑閤閡涸闔盒盍翮核合紇貉何蓋	訶賀鶴赫暍郝嚇荷和呵喝
旋	縣渲漩眩玄炫絢璿鉉懸還	選晅萱絢懸還縣渲漩炫壎玄眩煖璿鉉宣暄諼喧軒
輕	蜻清氫頃青卿鯖傾	請親擎檠頃情晴磬傾慶罄
濮	莆葡脯蒲菩璞樸僕釙匍蹼樸	普埔鋪浦誧僕溥暴撲撲譜瀑圃曝噗
沍	瓠互戶滬楛護扈	壺鬍鵠蝴胡琥湖葫囫弧虎許斛瑚惚唬乎戲呼糊忽狐
坑	吭阬鏗	
坎	崁侃檻砍	戡刊看堪瞰勘
樽	尊遵	圳俊撙
鱷	啞鄂軛惡俄萼厄堊顎詻呃噩遏餓鍔扼愕	哦蛾蚵俄娥峨鵝婀阿訛額
盍	嗑合蓋河郃翮和紇闔核荷貉禾曷劾盒閡何褐閤涸	嚇郝和訶喝鶴賀暍荷赫呵
吭	航行鏗桁坑阬杭	行沆
奈	氖耐奶迺乃	氖耐奶迺乃
庚	更粳羹耕賡	更耿埂梗亙哽
說	越玥藥月稅軏嶽閱悅樂粵耀曜刖蛻躍睡鑰籥	數蟀誰約率碩爍妁水鑠勺朔帥曰
氣	器憩妻緝棄訖汽迄泣磧愒砌亟企契	旗啟淒祈谿豈悽琦琪麒耆漆杞起錡臍慼齊祁騎溪欺枝祇棋畦奇稽戚啓柒崎淇七隻綺其祺期圻乞棲衹歧岐萋鰭妻
糝	傘散	三散參
慝	特	
滿	屘	鏝饅鰻曼縵漫蹣蠻蔓幔瞞慢
傯	總	蹤糉縱綜鬃宗從棕
辮	辯遍變汴卞弁釆辨便	扁鞭蝙編匾邊褊貶砭
岷	玟民	閩澠憫敏抿愍泯皿閔湣
揉	柔鞣蹂	肉
莒	咀舉沮齟矩	炬苣颶具桔巨疽鉅劇倨遽屨距俱狙侷掬聚據懼踞瞿橘蛆跼車駒拘局句菊鋸沮足鞠拒居
裒		剖
輛	亮量晾諒涼	良兩糧魎粱量倆涼樑
嗜	室恃螫筮奭勢舐豉市士事仕拭識試世釋柿逝是適侍示飾軾誓弒氏式噬使視	濕詩十施屎師史匙提矢射食碩拾蝕駛塒屍噓時什溼豕獅失始蝨實石使
被	鋇倍貝劈匹焙背孛備悖壞紕霹輩憊披鈹臂批邶狽丕蓓	啤媲埤杯陂脾裨匹屁琵僻碑背枇癖疲悲仳紕譬北卑陴盃鼙鈹闢否毗揹沘痞疋罷皮俾
覜	頫眺跳	挑條佻調迢蜩窕
只	徵脂梔之址泜芝胝枝吱祉祇肢趾支祗汁咫織卮紙隻芷止蜘知指氏旨	智徵制脂植痔梔直致摭之製蛭址躓質窒雉芝泜值胝躑枝吱峙祉幟肢支祇稚執祗趾職炙痣識汁咫置輊至殖織卮滯紙隻芷止蜘秩摯知姪擲氏緻治志指旨誌
蘿	鑼騾玀羅鏍儸邏螺囉籮	裸落洛酪絡烙咯駱犖囉珞雒
棗	蚤澡藻早	竈造噪皁譟躁糟鑿遭燥
膨	蓬彭朋澎棚鵬篷硼	捧澎抨碰烹砰
核	褐劾曷荷禾郃和嗑河閤閡涸闔盒盍翮合紇貉何蓋	訶賀鶴赫暍郝嚇荷和呵喝
渥	臥沃斡齷握	窩我萵倭渦
決	觼蕨嚼劂掘訣鴃崛倔鱖絕玨覺獗厥腳抉孓譎爵攫蹶噱角	蹶嗟倔
色	瑟穡嗇塞圾澀	
簍	摟	露嘍漏樓髏陋鏤瘺摟婁螻
製	雉秩幟蛭稚窒志痣智緻滯致置痔至摯峙輊躓治知識制質炙誌	姪止植織梔咫泜氏芷脂胝值汁址吱肢執摭祇祉躑枝蜘直支擲知徵隻質紙趾只之指祗職芝旨卮殖
亂		巒鸞卵鑾灤
女	汝乳辱	燸如忸濡入嚅褥辱蠕孺儒茹
佩	珮沛轡配	培裴陪賠胚壞呸
衡	橫恆桁	哼橫亨
嚎	蠔蚵嗥鶴號毫貉濠豪壕	顥鎬涸號郝浩昊蒿好耗鄗皓
皓	昊浩鎬顥鄗好號涸耗	毫濠壕蠔嚎貉嗥蒿郝蚵豪鶴好號
奚	攜曦淅悉熹烯禧犀嬉膝行蜥稀希吸溪晰畦兮析熙釐棲譆谿犧蟋唏晞嘻羲西蹊僖	系汐蓆翕戲隙惜習璽徙洗細鰓係媳矽喜息潟夕繫席錫熄歙襲昔檄褶
暗	按菴岸黯案	鞍庵安鵪俺諳銨氨
遙	瑤姚榣崤窯僥謠搖餚爻洮堯淆	吆藥腰麼要妖窈樂舀鷂杳耀邀拗曜夭咬鑰喲
亳	蘗簸薜播擘檗薄	荸搏般帛簸蔔伯博脖勃菠跛舶剝泊鉑膊渤箔薄玻撥駁播檗白鈸缽柏
棍		輥滾鯀袞
駭	氦卸嗨洩榭屑楔蟹亥邂契褻懈害謝械燮解瀉紲屜	孩骸嗨歇蠍寫血諧頡擷邪勰鞋偕攜咳挾海斜些協脅還
惘	往網魍罔枉輞	望汪亡王旺妄尢忘
冪	汨覓祕祕密糸蜜謐泌	靡謎敉彌瀰弭麋瞇米咪糜迷
逝	室恃螫筮奭勢嗜舐豉市士事仕拭識試世釋柿是適侍示飾軾誓弒氏式噬使視	濕詩十施屎師史匙提矢射食碩拾蝕駛塒屍噓時什溼豕獅失始蝨實石使
喋	碟跌耋牒迭蝶絰諜疊	爹
安	鞍庵鵪諳銨氨	按菴暗岸俺黯案
些	歇蠍	卸洩榭寫屑血諧頡楔擷邪蟹邂勰鞋契褻懈偕謝駭攜械燮解挾斜瀉協紲脅屜
穎	郢景影	盈瑛嚶瓔楹迎櫻應纓嬴熒螢贏營嬰映瑩鸚鶯縈膺鷹罌蠅瀛英塋硬
芟	扇姍縿刪山舢煽跚杉衫羶珊潸	鱔扇膳禪擅疝訕繕汕贍煽善閃單陝
哨	邵紹少召	少捎韶杓燒芍梢勺稍
菱	綾零蛉櫺昤泠鴒靈羚玲鈴苓伶齡聆陵凌翎	拎令另嶺領
閣	革格隔膈合鬲蛤閤咯鎘骼郃葛	個戈胳割鉻鴿箇歌疙各葛擱哥
媼	襖	鼇凹鏖奧嗷遨敖澳熬懊翱拗傲聱
唉	埃哀挨哎	靄皚藹曖捱噯艾矮礙璦愛隘
匯	繪賄慧卉諱會彙晦誨潰喙彗惠穢燴蕙	蛔賄會蟲詼輝茴揮虺回麾燬徽灰毀迴墮恢暉悔誨
小	曉篠	嘯梟酵銷瀟霄削蕭哮笑孝效簫嘐硝囂學肖宵逍校消傚驍
敖	鼇熬鏖翱嗷遨聱	凹澳懊奧媼襖拗傲
蛄	菰咕孤鴣辜鈷沽估姑呱家	凸鵠僱罟賈鼓穀顧估僱故轂股告谷滑牯蠱瞽錮古詁鈷固骨
泜	肢祇織梔枝蜘支氏知隻只祗之脂芝胝卮汁吱	雉秩幟止蛭志芷值址執祇祉峙治制紙質誌姪稚窒植咫痣智緻滯致置痔摭至摯製輊躑躓直擲知識徵只炙趾指職旨殖
漫	鏝饅鰻曼縵蹣蠻蔓幔瞞慢	鏝饅鰻慢縵曼屘蹣蠻蔓幔瞞滿
殘	慚蠶	慘孱璨參餐燦
韻	醞慍暈蘊運員熨孕	勻允耘氳隕筠昀紜暈芸雲
砥	牴底柢邸抵詆氐	滴鏑荻締迪帝的嘀狄蒂氐弟諦犒翟笛芽低地敵第娣遞棣滌嫡
流	榴瘤泵留劉瀏硫琉遛	餾霤六陸溜鉚柳
肛	缸鋼岡綱崗槓剛扛釭	崗槓港
吠	芾費屝怫痱廢沸肺	菲啡肥誹霏斐妃腓扉匪翡非飛
軛	愕詻鱷遏俄啞噩惡呃鍔顎扼鄂餓厄堊萼	額俄蛾哦婀訛娥阿峨鵝蚵
祝	助薴駐箸註注蛀柱佇鑄杼住	諸逐軸朱躅茱硃渚拄蛛誅術主囑珠豬築朮貯竺侏藷屬煮燭矚株銖竹
鸚	瑛嚶英瓔嬰鶯應膺櫻纓鷹罌	穎盈楹迎應嬴熒螢贏營映瑩縈瀛蠅郢景塋硬影
孿	攣	
暄	萱喧壎煖軒晅宣諼	鉉懸漩還炫絢渲眩選旋縣璿玄
皇	凰隍遑惶徨簧璜黃湟篁韹煌磺蝗	幌恍慌荒謊肓洸晃
秤	稱	呈懲誠承騁丞撐橙乘逞城瞠成程稱盛澄
井	景阱憬警璟頸	靜競精荊淨兢京旌敬經粳勁菁驚痙涇晶鏡鯨睛莖竟更徑逕靖境
楣	莓媒眉黴梅枚玫煤沒湄	妹瑁每昧魅袂鎂美媚沬寐
遂	碎祟誶歲穗隧燧邃	綏髓隨隋雖睢
複	富腹馥覆賻附副傅復付赴婦咐父阜賦負駙訃	氟縛匐膚鈇俯府腑夫腐頫蝠紼扶甫幅芾孚弗輻紱福袱浮伏符菔釜敷拂涪撫怫斧孵莆趺輔彿服父麩脯芙伕俘
優	悠攸幽憂	囿佑誘幼友侑又祐猶疣鈾柚遊莠油由酉魷右牖宥黝有釉郵尤猷鼬
恪	嗑課確雀闕客溘怯剋卻髁可闋鵲殼喀克緙榷刻	軻闕坷稞棵渴磕瘸缺可咳殼窠柯科刻顆苛蚵瞌蝌
褶	懾謫媳蓆轍息蜇哲折摺摘輒席惜錫習熄昔檄襲	攜烯嬉者宅膝著璽洗溪細析係赭棲蟋這羲夕蹊鷓歙遮曦蔗淅悉熹禧犀系汐浙行翕蜥稀戲隙希螫吸徙晰畦兮鰓熙釐矽喜谿譆犧唏晞嘻西潟繫奚僖
渝	盂妤隅娛榆愚魚逾禺輿愉褕竽蝓雩覦腴漁臾於諛圩餘餘瑜俞予歟萸於虞	瘉澦域瘀宇馭獄峪昱燠雨預迂語紆與煜齬慾噢芋育俞堉鬱豫羽毓裕禦籲嫗敔喻玉欲圉譽禺禹熨嶼癒寓愈諭圄御谷鬱淤遇庾聿尉予浴
中	湩終種仲忠鐘重衆盅忪眾衷鍾	湩終種仲忠鐘重盅忪腫眾衷鍾塚踵
仟	簽阡嵌縴愆鉛千騫謙牽搴遷韆籤	乾欠前塹縴遣黔歉倩箝虔潛淺鈐譴錢鉗
職	執植質姪值直躑擲殖摭	智徵制脂痔梔致之製蛭址躓質窒雉芝泜胝枝吱峙祉幟肢支祇稚趾祗炙痣識汁咫置輊只至織卮滯紙隻芷止蜘秩摯知指氏緻治志旨誌
酗	序恤旭緒續卹蓄畜絮敘婿頊勗洫	鬚咻噓訏栩須戌胥墟籲煦虛需徐許
吐	土菟兔	酴土凸屠禿菟餘塗徒兔突途圖荼
跺	度惰踱舵咄剁墮馱	奪朵躲鐸多
笨		賁畚本奔苯
賜	寺似伺兕食耜祀廁泗嗣次巳駟飼肆四俟刺姒	祠詞雌思鷥此疵瓷嘶辭廝差茨絲撕斯慈死私磁司
倚	蟻迆已椅以乙矣旖尾迤偯	劓羿浥益藝軼鎰姨痍肄頤憶遺佚翌伊夷一屹栘貽溢臆囈訑疑咿揖議意刈依噫移蛇役圯億沂繹弋迤腋毅譯儀詣怡咦縊逸抑漪彝懿壹醫液帟翼義疫飴異胰艾奕衣佾誼翳掖易裔邑曳亦蜴驛宜弈
訊	迅徇潠汛巽遜殉馴蕈訓	徇循潯勛尋醺燻勳旬洵璿詢巡荀薰馴
紙	趾芷徵址止咫指只旨祉祇	智制脂植痔梔直致摭之製蛭躓質窒雉芝泜值胝躑枝吱峙祇幟肢支擲稚執祗職炙痣識汁置輊只至殖織卮滯隻蜘秩摯知姪氏緻治志誌
信	參紳身申呻莘芯深娠釁砷伸	慎沁心薪訢芯哂馨脤沈甚昕鋅新滲蜃瀋莘尋審辛腎嬸欣神
有	牖友囿柚侑佑宥黝莠誘又釉祐酉幼右鼬	囿佑悠誘憂攸幼友侑優又祐猶疣鈾柚遊莠幽油由酉魷右牖宥黝釉郵尤猷鼬
雷	擂嫘縲羸鐳累	擂壘淚耒漯儡勒蕾磊累類
錮	告顧估僱故固僱	菰凸鴣鵠罟賈鼓穀估呱轂孤股谷滑沽蠱牯蛄瞽咕辜古詁鈷姑骨家
糉	縱綜從	傯總蹤縱綜鬃宗棕
俏	蹺峭誚翹竅鞘撬殼	樵憔喬雀巧譙蹺鍬鵲僑橋翹悄撬橇瞧敲愀
雁	釅宴研艷硯嚥厭咽贗沿彥諺驗堰焰燄燕唁淹豔饜晏	言兗演研殷鹽菸奄顏咽巖厭閻簷沿眼湮煙偃魘郾延儼筵燕焉嫣嚴炎醃淹衍妍鼴掩癌胭
藍	蘭攔斕襤瀾嵐籣闌婪籃欄	覽爛纜欖攬濫懶
螫	拭恃遮軾式適是飾柿奭氏士使視弒市示試豉仕噬誓筮室勢侍世嗜識逝事釋舐	豕謫匙溼者宅獅哲著使蝨拾失蝨噓懾蝕赭施提轍這屍什屎鷓褶遮蔗屍浙摘詩碩十始塒石食實時史師濕蜇折摺矢輒射駛
幫	梆邦傍	膀旁傍綁鎊磅榜謗棒蚌
輜	淄錙緇貲諮茲姿孳孜資滋諮齜玆髭吱	仔訾字恣紫滓籽漬子孳梓自
牘	讀髑獨毒黷瀆櫝犢	度妒賭肚睹蠹嘟都督杜堵篤鍍渡
霆	廷婷蜓停亭庭	聽廳挺汀梃艇
紅	鴻黌泓龔弘虹肱功躬供蚣公閎共釭宏宮訌攻恭工洪弓	供鞏鬨烘哄薨汞礦共廾拱轟貢
鮪	葦尾娓猥諉偉洧痿緯萎委	魏衛胃蔚維萎威未韋唯遺惟渭濰圍桅為崴味穌煨薇逶餵幃偽慰位危謂帷微巍偎褽尉喂闈畏違委
倨	炬苣颶懼具巨踞瞿鉅劇遽屨距俱聚據句鋸足拒	莒咀舉桔疽橘蛆跼車駒俱拘狙侷掬菊局鋸沮鞠居齟矩
賁	弊璧必敝鉍薜嗶痺箄襞避臂斃庇畢俾愎陛碧泌鄙蹕篦蔽詖埤闢閉弼婢祕奔比壁睥幣裨	畚筆鄙匕笨苯沘妣彼本逼比鼻
姦	箋監間尖肩縑湔兼堅韉漸菅殲奸緘艱濺煎	件檻劍健僭見艦毽漸諫囝檢柬簡濺減筧踐監箭間閒薦腱鍵剪建鹼瞼繭餞鑑鑒澗賤撿揀儉薦
仰	養鞅氧癢	楊颺羊泱養央昜漾殃洋鞅樣鴦怏徉揚秧烊煬鍚瘍陽暘恙佯
匱	愧餽喟簣潰	夔葵窺睽盔虧魁揆傀奎逵
眇	緲渺杪邈秒杳藐	描瞄妙苗繆廟
瓏	聾龍矓窿籠嚨隆朧	攏壟隴
晨	沈宸忱塵沉辰陳諶臣娠	襯趁琛讖櫬稱瞋疢
膂	褸鋁婁旅侶屢呂履縷	氯櫚閭綠濾驢律慮率
甄	禎診貞真針楨斟臻珍砧偵榛箴	震陣娠鴆診枕縝鎮朕賑振疹
偌	鶸篛若弱	
救	舊究咎臼舅廄就柩疚	赳酒玖糾灸九韭揪久鳩啾
綠	慮率氯律濾	呂閭鋁褸履驢膂屢旅婁侶縷櫚
勝	賸笙昇牲聲陞甥乘剩聖生盛升	賸笙昇牲聲陞省甥乘剩繩澠聖生盛升
躡	涅鑷蘗囁齧鎳孽聶臬	捏
抆	文聞問紊免汶	文聞瘟雯吻紋玟蚊溫穩塭刎
愀	鵲巧雀悄	樵鞘俏憔蹺敲撬誚橇譙鍬瞧殼喬僑竅橋翹峭
末	膜貊莫磨陌默墨驀沫秣脈茉寞漠沒歿	膜抹蘑摩摸磨模糢謨魔摹麼
慮	率氯綠律濾	呂閭鋁褸履驢膂屢旅婁侶縷櫚
鞏	汞礦共廾拱	躬供宮龔釭紅蚣公攻恭共工肱功弓貢
霰	現僩峴腺餡羨憲獻限蜆莧陷縣線	纖涎顯嫌銑舷銜暹啣鹹秈癬嫻險祆姍閒閑絃鮮鹹仙弦蜆掀先賢蘚
痍	咦姨飴疑怡貽誼訑迤蛇栘移彝夷遺沂圯胰儀宜一頤	漪蟻藝屹肄軼刈誼囈迤縊以逸佾已溢劓醫疫噫乙懿鎰毅揖義迆邑億液役佚易羿倚尾弋裔蜴椅壹驛弈旖譯帟翌異益偯臆亦艾腋曳咿議詣意伊繹憶掖浥翳矣奕一翼抑衣依
茉	膜末貊莫磨陌默墨驀沫秣脈寞漠沒歿	膜抹蘑摩摸磨模糢謨魔摹麼
艦	餞澗鑒劍閒毽諫箭僭踐件健建間檻見監賤濺薦腱漸鑑鍵	尖儉堅艱減菅緘韉柬湔撿簡殲瞼肩筧間揀繭煎姦剪鹼監檢縑濺奸兼漸囝箋
診	疹禎榛枕斟箴真偵砧貞針珍甄楨縝臻	賑陣箴偵針鎮斟振真臻鴆禎榛砧貞娠楨疹枕朕珍甄震縝
朽	宿	咻脩袖秀溴岫繡休臭嗅宿羞鏽修
邱	蚯丘龜秋鞦鰍	仇毬酋泅求裘球梂囚
紋	雯聞文蚊玟	穩紊聞文瘟塭汶免問溫刎吻抆
耨		
等		凳嶝磴蹬瞪鄧燈登
都	兜督嘟	讀度痘妒蠹毒堵牘鍍脰逗睹瀆陡鬥渡犢賭髑黷抖蚪豆篤肚竇獨杜櫝枓
悻	倖性杏興幸姓	邢醒興馨形行刑惺星省陘型腥猩硎
聿	裕瘉澦禦域籲嫗馭喻獄玉欲譽禺熨峪昱燠癒寓愈諭御谷鬱預語遇與煜慾芋育尉俞堉鬱豫浴毓	妤娛瘀宇逾褕竽蝓雨雩渝覦迂漁於語紆與噢齬餘餘俞歟羽虞盂隅榆敔愚魚圉禺禹嶼輿愉圄淤腴臾諛庾圩瑜予萸於
焉	奄菸煙胭燕醃湮醃厭咽淹殷嫣	豔閻癌堰焰儼諺雁簷驗衍魘掩贗郾咽艷硯巖炎延晏研偃妍兗眼嚥彥簷沿燕鹽鼴饜顏釅筵巖厭嚴淹燄言宴演唁
畸	唧跡畿屐居績犄饑譏羈激機乩積奇稽箕嘰躋蹟嵇其癘肌幾期雞璣基磯飢姬勣	急唧霽髻疾脊寄際繼寂即繫楫伋稷擠吉薺技記擊忌騎及悸嫉汲覬己亟藉劑岌紀吃季瘠給借棘計級祭圾戟麂妓驥籍濟鯽輯幾芰戢集暨洎極薊系冀躋既
逢	馮縫	豐俸諷縫峯風鋒楓封蜂烽瘋鳳奉
鉻	各個箇	郃哥歌咯格戈骼疙個鎘蛤擱割胳革隔閣膈閤鬲葛鴿
姒	賜祀泗兕肆食飼巳伺嗣似耜寺駟俟四	撕司廝絲斯鷥私思嘶死
唧	急疾脊跡即寂楫屐居伋績吉犄饑譏擊羈機及乩嫉積激汲亟藉岌吃瘠奇借稽棘箕級圾嘰躋蹟籍輯畸嵇幾其肌期集戢飢雞極癘璣基磯畿姬勣	霽寄擊忌騎悸己藉紀瘠計圾籍畸洎璣磯飢既躋脊楫居績稷譏羈覬劑吃季稽祭麂蹟驥鯽幾集犄姬際伋吉薺饑機及乩亟奇棘箕妓濟嵇其芰戢雞基薊系冀急髻疾跡繼寂即繫屐擠技記激嫉汲積岌給級嘰戟輯癘肌期暨極畿勣
詭	晷鬼軌癸	龜皈桂鱖歸跪閨貴鮭規圭珪瑰傀櫃
楓	豐諷峯風鋒封蜂烽瘋	俸諷逢縫馮鳳奉
颱	薹苔擡檯跆臺臺	泰苔汰態胎太
績	唧跡畿屐居犄饑譏羈激機乩積奇稽箕嘰躋蹟畸嵇其癘肌幾期雞璣基磯飢姬勣	急唧霽髻疾脊寄際繼寂即繫楫伋稷擠吉薺技記擊忌騎及悸嫉汲覬己亟藉劑岌紀吃季瘠給借棘計級祭圾戟麂妓驥籍濟鯽輯幾芰戢集暨洎極薊系冀躋既
友	牖有黝莠酉	囿佑悠誘憂攸幼侑優又祐猶疣鈾柚遊莠幽油由魷右宥有釉郵尤猷鼬
瑤	洮淆崤謠榣僥餚姚遙餚窯堯搖爻	邀要喲耀夭咬吆鷂杳舀腰樂窈麼鑰藥妖拗曜
唏	攜曦淅悉熹烯禧犀嬉膝行蜥稀希吸溪晰畦兮析熙釐棲譆谿犧蟋晞嘻羲西奚蹊僖	系汐蓆翕戲隙惜習璽徙洗細鰓係媳矽喜息潟夕繫席錫熄歙襲昔檄褶
齟	莒咀舉沮矩	炬苣颶具桔巨疽鉅劇倨遽屨距俱狙侷掬聚據懼踞瞿橘蛆跼車駒拘局句菊鋸沮足鞠拒居
魁	揆奎葵夔逵睽	虧餽愧簣潰盔匱喟窺傀
夙	蓿塑簌肅宿縮速粟嗉訴溯素	俗蘇囌酥甦穌
佝	釦叩扣寇	口
躬	供宮龔釭紅蚣公攻恭共工肱功弓	供鞏汞礦共廾拱貢
拚	叛判盼畔	盤蹣般胖潘蟠槃磐攀踫
榣	洮淆崤謠瑤僥餚姚遙餚窯堯搖爻	邀要喲耀夭咬吆鷂杳舀腰樂窈麼鑰藥妖拗曜
榛	禎箴斟真診偵砧貞針珍楨甄臻	賑鎮疹鴆陣枕振朕診娠震縝
鯽	霽髻寄際繼繫稷薺技記忌騎悸覬劑紀季計祭妓驥濟芰暨洎薊系冀躋既	急唧疾脊跡即寂楫屐居伋績擠吉犄饑譏擊羈機及乩嫉積激己汲藉亟岌吃瘠奇給稽借棘箕級圾嘰戟麂躋蹟籍濟輯畸嵇幾其肌期集戢飢雞極癘璣基磯畿姬勣
適	室恃螫筮奭勢嗜舐豉市士事仕拭識試世釋柿逝是侍示飾軾誓弒氏式噬使視	濕詩十施屎師史匙提矢射食碩拾蝕駛塒屍噓時什溼豕獅失始蝨實石使
驀	默沒秣漠陌膜磨末寞脈貊墨茉歿沫莫	磨摹模摩摸抹糢麼蘑謨魔膜
矚	主渚囑貯屬拄煮	軸杼薴註築柱諸朱茱銖朮築燭鑄住助竹竺佇蛀藷侏硃誅蛛箸駐躅逐注豬祝株珠
叢	從淙	樅聰從囪匆蔥
樹	數漱墅術豎恕庶曙束倏署述戍疏	鼠黍署輸數薯贖梳菽暑舒叔淑蜀書藷殊疏塾屬橾抒蔬樞熟孰
鬆	淞崧松嵩忪	誦訟悚慫頌宋聳送
近	晉噤進覲燼儘僅禁勁盡縉浸	金謹錦浸饉覲瑾矜津禁斤襟緊觔巾僅儘今筋
靖	鏡靜敬競徑淨勁痙逕竟境	井精荊兢警旌京經粳菁驚頸涇晶鯨睛莖阱憬璟景更
奏	驟揍	啁陬鄒走鄹
漣	簾聯蓮簾鰱濂奩連憐鐮廉	鍊戀殮瀲斂練煉鏈楝臉
仔	籽宰紫梓載滓訾子	字淄再玆恣子錙哉自輜資孳茲吱載貲孜姿髭災諮栽漬滋齜緇在
捶	錘鎚陲垂綞椎槌箠	炊吹
鑒	件檻劍健僭見艦漸毽諫濺踐監箭間閒薦腱建鍵餞鑑澗賤薦	箋縑兼姦韉漸殲奸囝艱柬檢簡濺減筧監間肩尖湔剪鹼瞼繭堅菅緘撿揀儉煎
腆	靦舔忝	甜畋填添恬天田闐
紗	莎殺沙煞鯊砂裟杉	廈煞傻霎
陝	閃	善芟煽珊鱔扇山禪疝潸羶舢汕繕跚膳縿刪杉擅單訕衫贍姍
瀋	哂審嬸沈	砷信滲甚申莘腎伸呻娠深身蜃沁脤參紳慎神
餓	啞鄂軛惡俄萼厄堊顎詻呃噩遏扼鱷愕鍔	哦蛾蚵俄娥峨鵝婀阿訛額
骯	醃	昂盎
灘	癱坍探貪攤	痰談潭譚探碳袒覃毯嘆壇檀罈炭歎彈坦曇
戊	晤惡寤騖物勿悟塢霧兀誤務軏鎢堊	武汙鵡巫侮吾亡誣無吳午五烏毋伍惡嗚鼯嫵於唔憮屋舞圬鎢捂污梧蕪蜈
息	惜習檄褶錫媳席襲蓆昔熄	細悉禧行谿羲繫嬉晰蟋釐洗吸唏曦隙希蹊稀淅溪矽畦奚鰓係翕犧譆熙夕攜烯析西兮嘻僖蜥晞棲璽系汐膝潟戲犀熹徙喜歙
熹	攜曦淅悉烯禧犀嬉膝行蜥稀希吸溪畦晰兮析熙釐棲譆谿犧蟋唏晞嘻羲西奚蹊僖	系汐蓆翕戲隙惜習璽徙洗細鰓係媳矽喜息潟夕繫席錫熄歙襲昔檄褶
睫	捷劫拮櫛桔截詰節羯訐傑竭桀擷孑結潔頡傑碣	姊階芥皆解街嗟戒揭疥界偕藉誡結姐借介接屆
拒	懼鋸巨颶遽倨劇苣句屨具鉅聚踞據瞿距足炬俱	橘拘菊鋸居鞠莒跼疽齟桔局駒狙蛆舉車沮掬侷俱咀矩
朵	多躲	度惰奪踱舵躲咄跺鐸多剁墮馱
鵑	娟身捐圈鐫涓	捲倦卷狷圈雋眷絹
頃	請輕蜻清氫青卿鯖傾	請擎傾蜻輕檠清氫情青鯖晴卿磬親慶罄
汽	器憩妻緝棄訖磧迄泣氣愒砌亟企契	旗啟淒祈谿豈悽琦琪麒耆漆杞起錡臍慼齊祁騎溪欺枝祇棋畦奇稽戚啓柒崎淇七隻綺其祺期圻乞棲衹歧岐萋鰭妻
峒	瞳銅同潼桐僮童彤	通筒桶痛統恫慟
查	搽察扎渣喳茶	渣眨搾柵扎吒紮叉岔插砟詐蚱閘炸乍差咋剎喳札詫
拄	屬煮矚主囑貯渚	諸逐軸朱蛀躅茱鑄硃助蛛箸誅術注珠豬薴祝築朮柱竺杼侏藷燭駐註佇株銖竹住
厝	措錯挫銼撮	磋嵯蹉撮搓
逗	讀痘竇鬥豆脰	都陡抖鬥蚪兜枓
揮	麾恢輝徽灰暉詼墮	蛔賄會彙蟲彗潰燴繪蕙穢匯茴卉虺回燬毀諱惠迴慧悔晦誨喙
號	蠔鎬鶴耗嚎皓顥涸蚵好昊毫濠豪鄗嗥浩貉壕	蒿蠔鎬鶴郝耗嚎皓顥涸蚵好昊毫濠豪鄗嗥浩貉壕
帖	餮鐵貼	餮鐵貼
非	菲啡霏妃扉飛	菲吠肥誹芾斐腓匪費屝怫翡痱廢沸肺
毬	仇酋泅求裘球梂囚	蚯丘邱龜秋鞦鰍
支	脂梔之泜芝胝枝吱祇肢祗汁只卮織隻蜘知氏	智徵制植痔直致摭製蛭址躓質窒雉值躑擲峙祉幟祇趾稚執職炙痣識咫置輊只至殖滯紙芷止秩摯知姪指緻治志旨誌
聚	拒懼鋸巨颶遽倨劇苣句屨具鉅踞據瞿距足炬俱	橘拘菊鋸居鞠莒跼疽齟桔局駒狙蛆舉車沮掬侷俱咀矩
潑	坡波陂	叵珀迫鄱剖破樸婆泊魄粕頗醱
縐	胄晝宙咒籀皺冑紂	粥軸帚舟妯周肘啁週洲州
吏	荔琍儷痢例利厲欐莉曆礫勵瀝慄隸蒞釙蠣靂立礪壢粒唳力戾俐麗癘鬲溧笠歷酈	裏貍醴李離鯉釐黎罹禮漓理浬梨驪狸蜊俚娌邐澧麗蠡犁璃鋰喱籬犛裡哩
敢	橄感稈趕杆桿	淦柑乾幹尷榦甘桿疳坩肝竿贛
摧	催衰崔	淬粹悴萃璀瘁橇翠脆
喙	諱惠晦蕙燴慧繪穢彙彗賄會卉匯誨潰	麾恢詼蟲茴暉毀墮灰揮燬賄虺輝悔回會徽迴蛔誨
麻	嘛蟆痲麼	嬤瑪媽螞罵馬嘛嗎蟆碼
慕	穆募墓木目沐睦苜幕暮牧	牡模拇姥姆母畝
鏍	騾羅螺籮蘿玀鑼儸囉邏	烙珞駱洛酪咯絡雒囉犖裸落
窘	炯迥	龜軍竣菌均浚郡俊駿君雋蕈濬鈞峻
藝	詣劓羿浥異益議軼意刈鎰縊肄逸憶抑艾佚奕翌衣佾誼億役翳懿一掖屹易裔繹液弋帟邑腋曳溢臆翼亦囈蜴驛毅義譯弈疫	咿儀揖怡飴咦依姨迆痍胰頤以遺噫移乙矣蛇衣伊夷誼尾漪圯蟻彝已壹一醫沂旖栘倚迤貽椅訑宜疑偯
蹴	鏃趨錯促卒槭蹙簇醋趣	粗
蠱	轂凸股谷鵠滑牯瞽罟賈鼓穀古詁鈷骨	菰孤鴣告沽蛄僱咕辜錮顧鈷估僱姑呱固故骨家
曾	繒憎層增	贈
氈	沾瞻霑佔詹譫	棧斬站嶄展盞輾綻湛暫佔蘸顫戰
舊	究救咎臼舅廄就柩疚	赳酒玖糾灸九韭揪久鳩啾
悼	蹈盜導道到稻倒	導島搗禱叨刀倒
滲	脤甚慎沁蜃腎	參甚沈信身紳呻深審瀋娠莘哂申嬸砷伸神
擴	廓括蛞闊	
赧		南楠喃囝難男
界	解芥介借屆疥誡戒藉	睫傑節櫛竭姐揭潔捷姊頡擷階結桔孑接羯皆桀劫偕拮碣嗟解訐街詰截
齧	涅鑷蘗囁鎳孽聶臬躡	捏
病	並併摒	餅秉鉼丙稟柄屏冰兵炳
忽	惚呼戲乎	鵠虎葫扈唬湖許瑚戶壺弧鬍沍瓠護互囫糊狐胡滬蝴琥楛斛
蓄	序恤旭緒酗續卹畜絮敘婿頊勗洫	鬚咻噓訏栩須戌胥墟籲煦虛需徐許
霖	痳麟鱗林鄰燐淋磷轔遴臨琳璘	吝懍躪藺凜賃
疋	啞仳否匹雅亞痞	劈披陂譬衙疲鴨沘僻壞丫押癖琵芽批啤闢鼙牙訝脾涯媲呀匹鴉壓丕霹亞皮埤氬蚜闢軋陴枇鈹煆被屁罷紕毗裨
磺	韹湟隍蝗皇徨凰篁簧黃璜煌遑惶	幌肓謊洸荒慌晃恍
頂	酊鼎	盯丁叮訂釘定仃酊錠
塊	筷劊膾會檜儈快	
薪	心訢莘昕鋅辛新芯馨欣	信釁尋芯
篌	猴侯喉	厚吼後堠鱟逅候後
談	痰潭譚覃壇檀罈彈曇	坍癱灘探碳袒嘆毯貪攤炭歎坦
韉	箋監間尖肩縑湔兼姦堅漸菅殲奸緘艱濺煎	件檻劍健僭見艦毽漸諫囝檢柬簡濺減筧踐監箭間閒薦腱鍵剪建鹼瞼繭餞鑑鑒澗賤撿揀儉薦
僞	爲衛謂位尉喂胃未味遺慰蔚魏畏	委偉尾薇葦違維圍威偎萎緯唯危微巍桅
以	蟻迆已椅乙矣旖倚尾迤偯	劓羿浥益藝軼鎰姨痍肄頤憶遺佚翌伊夷一屹栘貽溢臆囈訑疑咿揖議意刈依噫移蛇役圯億沂繹弋迤腋毅譯儀詣怡咦縊逸抑漪彝懿壹醫液帟翼義疫飴異胰艾奕衣佾誼翳掖易裔邑曳亦蜴驛宜弈
爻	洮淆崤謠榣瑤僥餚姚遙餚窯堯搖	邀要喲耀夭咬吆鷂杳舀腰樂窈麼鑰藥妖拗曜
閏	潤	
牝	聘	拼頻品瀕姘嬪貧顰
啾	揪鳩糾	九究舊救臼舅咎酒就玖疚糾廄韭赳灸久柩
襲	惜習檄褶錫息媳席蓆昔熄	細悉禧行谿羲繫嬉晰蟋釐洗吸唏曦隙希蹊稀淅溪矽畦奚鰓係翕犧譆熙夕攜烯析西兮嘻僖蜥晞棲璽系汐膝潟戲犀熹徙喜歙
樑	良糧量梁粱涼	亮輛晾兩魎量倆諒涼
晷	鬼癸軌詭	鱖跪鮭皈規傀貴桂閨龜圭珪瑰櫃歸
穫	禍貨獲豁或壑霍惑擭濩	夥夥活豁和火
憊	鋇背倍臂貝輩備孛悖邶狽焙蓓被	碑背杯北卑裨揹悲盃俾
畜	絀卹婿序洫觸矗黜恤緒酗歜絮頊處怵續蓄敘旭勗	咻訏齣杵出墟櫥跦楮需許胥楚廚煦虛徐除鋤雛處躇礎籲鬚噓栩初褚芻須儲戌
醱	破粕迫泊珀魄樸	剖婆陂波叵鄱潑坡頗
庸	壅傭邕臃雍擁鄘慵	壅永勇恿泳詠傭臃蛹湧擁俑踊踴用甬
邶	貝鋇倍背焙輩狽備臂憊悖被孛蓓	杯盃北揹卑背俾碑悲裨
辛	心薪訢莘昕鋅新芯馨欣	信釁尋芯
禦	裕瘉澦域籲嫗馭喻獄玉欲譽禺熨峪昱燠癒寓愈諭御谷鬱預語遇與煜慾芋育聿尉俞堉鬱豫浴毓	妤娛瘀宇逾褕竽蝓雨雩渝覦迂漁於語紆與噢齬餘餘俞歟羽虞盂隅榆敔愚魚圉禺禹嶼輿愉圄淤腴臾諛庾圩瑜予萸於
咕	姑估鴣孤沽蛄鈷家辜菰呱	顧錮鼓牯鵠穀滑告古僱骨罟股賈估鈷故蠱谷凸轂詁固瞽
富	父復覆阜駙複傅咐訃腹附賦賻副婦付負馥赴	孚拂斧夫芙敷莆父袱腐蝠菔氟腑撫符幅輔服鈇俯釜扶甫膚芾輻伏俘匐彿頫伕紼脯縛府浮涪趺福弗怫孵麩紱
肥	腓	誹肺菲匪費非廢沸吠芾斐妃屝痱啡霏扉怫翡飛
並	摒併病並	餅秉鉼丙稟柄屏冰兵炳
辣	剌蠟臘落	啦拉喇邋剌
泳	壅永勇恿詠臃蛹湧擁俑踊踴甬	壅庸傭邕臃雍擁鄘慵用
蟹	燮屑解褻懈卸契瀉楔洩駭邂榭械謝紲屜	寫血挾諧頡擷偕歇蠍邪斜些攜勰協鞋脅
嬝	鳥裊	尿
乩	畸姬畿其璣羈肌犄飢癘雞磯幾唧積箕幾奇譏激績期屐機嵇跡勣稽蹟基躋嘰居饑	洎棘疾暨忌祭集脊己騎藉芰劑幾記楫瘠覬紀計級極妓冀戢擊寄輯寂給薊及嫉際幾唧麂繼擠急伋薺吉季圾即稷髻霽技汲吃亟既悸躋籍繫岌濟鯽戟驥
虹	鴻訌紅弘黌閎泓洪宏	鬨烘哄薨汞轟
瘧	虐	
瞎	蝦	霞呷狎柙瑕黠遐廈洽下嚇轄狹夏峽挾匣斜暇俠
醣	瑭糖搪堂塘膛棠唐鏜螳	燙湯躺趟帑倘淌儻鏜
硝	簫宵霄嘐逍消梟削蕭驍哮囂銷瀟	曉校嘯小傚學笑酵孝肖效篠
伏	孚拂夫芙袱蝠菔氟符幅服扶芾輻俘匐彿紼縛浮涪福弗怫紱	富斧夫敷莆父復腐覆阜腑撫駙複輔傅鈇俯釜甫膚咐訃附腹賦賻副頫婦伕脯府付趺孵麩負馥赴
甍	蒙矇檬盟虻朦萌懵濛	艋蜢夢孟猛懵錳
貯	屬拄煮矚主囑渚	諸逐軸朱蛀躅茱鑄硃助蛛箸誅術注珠豬薴祝築朮柱竺杼侏藷燭駐註佇株銖竹住
噩	啞鄂軛惡俄萼厄堊顎詻呃扼遏餓鱷愕鍔	哦蛾蚵俄娥峨鵝婀阿訛額
鈣	概丐蓋溉	賅該垓改
綏	睢雖	誶碎穗髓邃歲隨隋隧燧遂祟
嘎		價軋尬噶
炎	沿嚴言鹽簷妍顏筵延巖閻癌研	釅雁宴兗演研艷殷硯嚥菸奄咽厭贗沿眼湮彥諺煙偃魘驗堰郾焰儼燄燕焉嫣唁醃淹衍豔鼴饜掩胭晏
恰	洽	卡
嗦	莎縮梭娑唆簑蓑	索瑣所鎖
進	晉噤覲燼儘僅禁勁盡縉近浸	金謹錦浸饉覲瑾矜津禁斤襟緊觔巾僅儘今筋
嬈	蟯饒橈	繞擾
豢	渙奐幻煥換瘓梡喚患宦	桓還環皖澴洹歡鍰緩梡寰
睨	暱泥膩溺匿逆	妮尼泥霓呢你擬倪怩妳旎
錘	鎚陲垂綞椎捶槌箠	炊吹
殷	菸奄因厭咽湮煙陰慇氤姻嫣燕焉醃淹音茵胭	言釅淫蔭雁宴兗霪聽演研艷硯胤印嚥吟鹽尹顏厭巖咽癮鄞簷閻贗沿飲眼彥諺隱偃魘驗夤堰郾銀垠焰延筵儼燄燕蚓縯嚴引齦炎唁淹衍豔妍鼴饜寅掩癌晏
鎳	涅鑷蘗囁齧孽聶臬躡	捏
奕	詣劓羿浥異益議藝軼意刈鎰縊肄逸憶抑艾佚翌衣佾誼億役翳懿一掖屹易裔繹液弋帟邑腋曳溢臆翼亦囈蜴驛毅義譯弈疫	咿儀揖怡飴咦依姨迆痍胰頤以遺噫移乙矣蛇衣伊夷誼尾漪圯蟻彝已壹一醫沂旖栘倚迤貽椅訑宜疑偯
噙	擒禽琴勤秦芹	嶔侵沁撳親寢欽
尾	葦緯猥諉迆鮪以乙矣萎蟻已痿委旖倚洧迤椅娓偉偯	劓羿畏浥益藝軼偽鎰姨尉痍肄逶頤憶幃遺維佚翌萎夷伊喂惟一闈屹栘貽溢臆囈訑疑咿揖議意崴刈依唯煨僞噫威移蛇役圯億餵委沂繹韋弋迤腋毅譯儀詣怡褽咦慰縊薇圍桅逸渭抑漪彝懿壹醫未胃液微帟味翼義疫違魏飴異帷謂胰爲巍艾偎奕衣佾誼翳濰掖位易裔危穌邑蔚曳衛亦蜴驛宜弈為
定	錠釘訂	盯頂丁叮釘鼎酊仃
邐	禮澧醴浬理哩鯉李鋰裡裡蠡俚娌	儷哩歷靂力慄立溧黎琍粒璃離利厲狸俐蠣漓蠡莉鬲慄喱麗犁礫礪唳痢犛貍籬蒞癘壢戾曆吏笠釐例釙荔驪欐梨罹隸酈勵瀝蜊
陳	沈宸忱塵晨沉辰諶臣娠	襯趁琛讖櫬稱瞋疢
渦	窩倭萵	齷斡我渥握沃臥
組	俎詛祖阻	卒嗾租族足
宦	幻煥喚患奐梡渙豢瘓換	皖環澴洹鍰桓緩梡寰歡還
齣	出初	矗畜黜儲鋤除絀杵礎跦楮廚怵褚雛處櫥歜躇楚觸芻
騾	鑼玀羅鏍儸邏螺囉蘿籮	裸落洛酪絡烙咯駱犖囉珞雒
淡	啗擔蛋氮啖但誕澹旦憚彈石	擔單簞疸丹耽膽撢
任	刃軔壬認賃飪韌紉兒仞人仁妊衽	刃軔忍壬認荏賃稔飪韌紉兒仞人仁妊衽
腥	興猩馨惺星	醒性興行倖杏省幸硎悻刑型姓陘形邢
縵	蔓慢漫幔曼鏝	蠻屘蹣漫鰻饅滿瞞
比	庇埤幣裨箄襞彼篦蔽鄙筆必弊斃妣蹕碧詖鉍賁陛避畢壁嗶闢璧臂敝痺愎泌睥匕婢薜沘閉祕弼俾	庇埤幣裨箄襞彼篦蔽鄙筆必弊斃妣蹕逼碧詖鉍賁陛避畢壁嗶闢璧臂敝痺愎泌睥匕婢薜鼻沘閉祕弼俾
墦	藩蕃樊凡煩礬釩繁帆	氾繙犯範泛梵番販反汎蕃飯翻範返幡帆
咐	富父復覆阜駙複傅訃腹附賦賻副婦付負馥赴	孚拂斧夫芙敷莆父袱腐蝠菔氟腑撫符幅輔服鈇俯釜扶甫膚芾輻伏俘匐彿頫伕紼脯縛府浮涪趺福弗怫孵麩紱
鈾	遊郵猶猷疣遊尤油魷由	幼幽黝攸鼬誘悠宥右柚牖祐有侑莠友又酉囿佑優憂釉
誑	狂	壙劻匡礦況筐框曠眶
艋	蜢猛懵錳	甍蒙矇檬夢盟虻孟朦萌懵濛
雹	薄	抱刨保苞暴胞葆鉋包報鑤褓豹寶鮑飽堡爆褒
麗	荔琍儷利厲痢貍例欐莉曆礫勵離釐黎罹瀝慄隸漓蒞梨釙蠣驪狸靂蜊立粒礪壢唳力戾俐吏蠡鬲溧璃犁癘笠喱籬犛歷酈	裏荔琍儷利厲痢貍例欐莉曆醴礫李勵離鯉黎釐罹瀝慄禮漓隸理浬蒞梨犛釙蠣驪狸靂俚蜊立粒礪壢唳力娌邐俐戾澧吏蠡鬲溧璃犁癘鋰笠喱籬哩裡歷酈
茨	辭疵祠雌瓷詞慈磁	賜疵此伺次雌廁刺差
鵪	諳鞍安氨庵銨	菴黯暗按案俺岸
讀	逗痘豆髑竇獨毒黷瀆牘鬥櫝犢脰	度妒蠹督堵鍍睹嘟陡鬥渡賭都抖蚪兜篤肚杜枓
鯈	酬稠儔仇疇綢愁躊籌裯惆	溴抽臭醜醜
喚	幻宦煥患奐梡渙豢瘓換	皖環澴洹鍰桓緩梡寰歡還
鍍	度妒肚蠹杜渡	讀賭肚睹嘟髑都獨督毒篤黷瀆堵櫝犢牘
史	矢豕駛始屎使	濕詩室十恃施螫筮師匙提奭實勢嗜舐豉射市食士事仕拭碩拾識蝕試世釋柿逝是適噓屍塒侍示時什飾溼軾獅失誓弒氏式蝨噬石使視
要	邀喲夭耀吆鷂腰樂麼鑰藥妖拗曜	喲淆夭耀崤咬杳謠瑤僥窈鑰堯搖邀洮吆鷂舀榣腰樂餚姚麼遙餚窯藥妖拗曜爻
粱	良糧量涼樑	亮輛兩倆魎量晾諒涼
湔	箋監間尖肩縑兼姦堅韉漸菅殲奸緘艱濺煎	件檻劍健僭見艦毽漸諫囝檢柬簡濺減筧踐監箭間閒薦腱鍵剪建鹼瞼繭餞鑑鑒澗賤撿揀儉薦
贏	嬴盈瑩楹熒塋瀛縈螢迎營蠅	穎瑛嚶瓔櫻應纓嬰映鸚鶯膺鷹罌郢英景硬影
聒	颳括蝸呱刮瓜	掛掛卦褂寡
贗	豔晏研堰焰嚥諺彥雁沿燕驗饜釅厭咽淹艷燄宴唁硯	閻癌儼菸簷衍魘掩湮醃郾咽殷巖炎延研偃妍兗眼奄煙簷胭沿燕鹽鼴醃顏筵巖厭嚴淹言焉演嫣
汰	太泰態	跆颱薹苔臺擡檯胎
萍	平馮枰憑蘋瓶屏評坪	娉乒
娌	禮澧醴浬理哩鯉邐李鋰裡裡蠡俚	儷哩歷靂力慄立溧黎琍粒璃離利厲狸俐蠣漓蠡莉鬲慄喱麗犁礫礪唳痢犛貍籬蒞癘壢戾曆吏笠釐例釙荔驪欐梨罹隸酈勵瀝蜊
旱	瀚憾銲撼悍焊捍頷翰漢汗頜	韓鼾寒罕函含蚶榦酣涵和喊汗
酷	庫褲	苦骷窟枯哭楛
丙	餅秉鉼稟屏柄炳	摒冰兵並併病
茵	湮殷音陰慇氤因姻	淫蔭霪聽胤印尹吟癮鄞簷飲隱垠夤銀蚓縯引齦寅
嶺	領	令零菱泠靈另鴒齡聆綾拎蛉櫺羚玲鈴苓陵昤伶凌翎
指	趾紙芷徵址止咫只旨祉祇	智制脂植痔梔直致摭之製蛭躓質窒雉芝泜值胝躑枝吱峙祇幟肢支擲稚執祗職炙痣識汁置輊只至殖織卮滯隻蜘秩摯知姪氏緻治志誌
曰	約	粵越嶽耀閱悅躍月樂鑰刖軏藥嶽曜籥說玥
呈	懲誠承丞橙乘城成程盛澄	騁秤逞瞠撐稱
膀	旁螃綁榜龐徬	梆邦胖旁傍滂鎊乓磅謗棒幫蚌
扈	瓠互戶滬楛沍護	壺鬍鵠蝴胡琥湖葫囫弧虎許斛瑚惚唬乎戲呼糊忽狐
陶	檮逃桃燾啕淘洮萄濤	韜絛討套饕掏濤滔
戶	沍滬扈瓠互護楛	鵠虎葫惚唬湖許呼瑚壺弧鬍乎囫糊狐胡蝴忽琥戲斛
蒼	傖倉艙滄	藏
脹	瘴丈賬帳障仗長杖漲幛	璋蟑樟獐掌彰章張長漲漳
妖	要吆夭邀喲腰麼	藥餚洮淆瑤崤要搖窈樂爻舀鷂姚榣杳僥遙謠耀堯拗曜窯夭咬鑰
柬	瞼揀筧簡繭儉囝剪減撿鹼檢	餞澗尖劍鑒閒堅毽艱菅諫箭緘僭踐韉艦件健湔建殲肩間檻見煎姦監賤縑濺薦腱奸兼漸鑑鍵箋
嬋	饞讒禪澶蟬潺孱蟾毚單巉纏	懺剷摻諂攙儳鏟闡產羼
鐲	著擢酌濁卓拙濯斫灼琢啄茁	棹涿捉桌
怪		乖枴拐
嫗	裕瘉澦禦域籲馭喻獄玉欲譽禺熨峪昱燠癒寓愈諭御谷鬱預語遇與煜慾芋育聿尉俞堉鬱豫浴毓	妤娛瘀宇逾褕竽蝓雨雩渝覦迂漁於語紆與噢齬餘餘俞歟羽虞盂隅榆敔愚魚圉禺禹嶼輿愉圄淤腴臾諛庾圩瑜予萸於
寇	叩扣佝釦	口
單	善煽纏鱔扇饞蟾澶嬋丹禪疝汕讒繕蟬簞膳耽孱擅毚擔訕潺巉贍	芟摻闡儳攙撢淡煽珊諂蛋扇啖剷山膽潸羶產舢閃陝誕跚羼縿鏟憚彈刪啗杉擔氮但澹衫旦懺姍石疸
膛	醣搪棠鏜螳瑭堂糖塘唐	淌湯趟帑倘鏜儻燙躺
奴	駑	努弩怒
板	舨版阪鈑闆	頒搬斑半扳姅班般瘢伴辦扮瓣絆拌
縹	漂瞟	飄瓢驃漂嫖剽票
浪		螂狼郎廊朗琅瑯榔
闊	括蛞擴廓	
裁	才纔財材	踩睬猜採菜綵彩蔡
吸	悉禧行谿羲嬉晰釐蟋唏曦希蹊稀淅溪畦奚犧譆熙攜烯西析兮嘻僖蜥晞棲膝犀熹	細繫席昔惜洗隙褶襲矽習鰓翕係夕蓆熄檄璽息汐系媳錫戲潟徙喜歙
靛	電鈿奠澱殿墊店甸玷佃惦	滇巔顛點碘典癲
具	拒懼鋸巨颶遽倨劇苣句屨鉅聚踞據瞿距足炬俱	橘拘菊鋸居鞠莒跼疽齟桔局駒狙蛆舉車沮掬侷俱咀矩
臃	鄘擁踴傭泳雍永慵湧庸勇蛹甬邕俑詠湧壅恿	鄘擁踴泳傭雍永慵湧庸勇傭甬蛹邕用俑詠湧壅恿
倘	儻帑淌躺	醣搪膛湯鏜趟棠螳燙瑭堂糖塘唐
死		思寺似鷥伺兕耜食祀泗嗣嘶巳駟廝賜飼肆四俟絲撕斯私姒司
豚	囤屯臀飩	褪吞
彩	綵採睬踩	猜採纔材才菜財裁蔡
恫	通胴洞棟凍動	瞳銅同峒桐僮董桶彤痛慟東冬潼鼕筒童懂統咚
芯	信心薪訢昕鋅辛新莘馨欣釁	尋信心薪訢昕鋅新辛莘馨欣釁
穿	川	船傳釧舛串喘
擾		蟯饒橈嬈繞
翁	嗡	甕蓊
歐	甌區毆嘔鷗	耦噢藕嘔偶
參	信身餐申呻莘深娠紳砷伸三	慎沁涔哂璨沈甚蠶傘脤散燦殘慘滲蜃瀋孱岑慚審糝腎嬸神
茅	矛髦錨毛	冒茆瑁卯泖茂懋貌耄貿貓帽
迦	嘉痂袈茄夾加豭葭傢佳家	架假夏鉀頰稼甲挾駕價浹賈莢戛夾嫁胛
書	殊抒橾疏蔬輸樞舒梳	樹叔塾菽術淑贖黍恕屬述漱豎束熟數庶鼠倏藷戍暑孰薯蜀墅疏署曙
副	富父復覆阜駙複傅咐訃腹附賦賻婦付負馥赴	孚拂斧夫芙敷莆父袱腐蝠菔氟腑撫符幅輔服鈇俯釜扶甫膚芾輻伏俘匐彿頫伕紼脯縛府浮涪趺福弗怫孵麩紱
咖	哈喀	喀卡咳
蜜	泌密糸汨祕冪謐覓	靡瀰米謎敉糜弭瞇咪迷麋彌
隅	魚諛雩予竽愚禺虞蝓盂逾褕圩榆渝萸漁瑜輿歟於腴妤愉臾餘覦俞娛	芋與馭御喻育宇雨予禹瘉寓譽禺迂鬱尉齬噢癒圉諭玉澦煜語欲谷庾裕嶼昱愈紆聿峪嫗籲預豫圄域浴羽獄毓遇淤堉慾瘀敔禦熨俞燠
笆	吧疤捌芭巴扒叭八	吧鈸灞琶拔霸靶壩耙把伯跋罷爸杷
合	褐革劾曷閣荷禾郃和嗑河閤閡涸闔蛤盒盍翮核紇貉何格葛蓋	訶割荷各賀鶴郝嚇疙戈呵哥赫胳暍鴿歌和擱喝
崗	缸鋼岡港綱槓剛扛釭肛	缸鋼岡港綱槓剛扛釭肛
蛛	諸誅朱珠茱株豬銖侏硃藷	軸蛀躅鑄渚助拄箸術注主囑薴祝築朮貯柱竺杼屬煮燭駐註矚佇逐竹住
噬	拭恃式軾適是飾柿奭氏士使視螫弒市示試豉仕誓筮室勢侍世嗜識逝事釋舐	豕屍匙溼獅蝨使拾詩碩失十蝨噓始塒石蝕實食施時提史師濕屍矢什屎射駛
訶	喝呵	蓋嚇盍荷貉禾曷盒閡褐閤鶴賀嗑合郃河翮和紇喝闔核暍赫劾郝何涸
譙	樵瞧憔僑喬橋翹	巧鞘俏雀蹺敲撬悄誚橇愀鍬鵲殼竅翹峭
惑	獲壑穫或貨濩禍豁霍擭	活夥火豁和
怖	埠佈鈽布不部步簿	卜捕補不埔哺
之	脂梔泜芝胝枝吱祇肢支祗汁只卮織隻蜘知氏滋資姿諮	智徵制植痔直致摭製蛭址躓質窒雉值躑擲峙祉幟祇趾稚執職炙痣識咫置輊只至殖滯紙芷酯止秩摯知姪指緻治志旨誌
亞	啞訝軋雅疋氬	啞鴨疋蚜芽衙訝涯牙軋煆雅鴉押呀丫壓氬
漯	累壘蕾獺遢磊遝儡榻踏蹋耒塌撻躂	累擂類他塔牠嫘它縲鐳她淚羸雷塌勒
舜	瞬順	吮盾
苜	穆募牧木慕沐幕睦目墓暮	母模牡畝拇姆姥
代	待迨大貸黛逮殆戴玳袋岱帶怠	呆待逮歹
冬	東鼕咚	董凍胴動恫洞棟懂
昭	釗晁着朝召嘲著招	櫂找詔罩趙肇兆沼炤爪召棹照著晁
浙	這宅鷓蔗	赭者遮蜇着轍哲褶摘摺謫著螫折輒懾
逼		庇埤幣裨箄襞彼篦蔽鄙筆必弊斃比妣蹕碧詖鉍賁陛避畢壁嗶闢璧臂敝痺愎泌睥匕婢薜鼻沘閉祕弼俾
黷	髑瀆櫝讀犢牘毒獨	杜蠹堵睹篤賭度鍍嘟渡肚都督妒
麂	幾脊己擠幾濟戟給	洎棘璣羈暨疾忌肌祭集脊騎藉芰雞磯乩劑積幾記績期機屐瘠楫跡嵇覬紀蹟基計級極居妓冀畸戢姬畿其擊寄輯寂犄薊及飢嫉癘際幾唧箕繼急伋薺奇吉譏激季圾稷即髻霽汲技稽勣吃亟既悸躋籍繫岌嘰濟鯽驥饑
巔	滇顛癲	奠甸店點碘典靛玷佃惦電鈿澱殿墊
拖	託脫	妥駝柝馱佗跎橢陀鴕唾拓沱
儼	鼴衍魘掩偃兗眼郾演	豔閻癌堰焰諺菸雁簷驗湮醃贗咽艷殷硯巖炎晏延研妍嚥奄彥煙簷胭沿燕鹽醃饜顏釅筵巖厭嚴淹燄言焉嫣宴唁
刪	芟扇衫羶跚縿山煽珊潸姍舢杉	汕善擅繕單扇陝訕膳疝禪煽贍鱔閃
魯	虜鹵櫓擄滷	鱸廬路僇嚕爐露錄鷺穋氯陸臚顱賂鑪瀘戮麓盧碌蘆鹿祿
囀	轉	磚賺撰專僎耑篆轉傳顓
拇	牡姥姆母畝	慕穆模募墓木目沐睦苜幕暮牧
拴	閂栓	涮
俞	瘉澦妤域娛馭獄逾昱峪燠褕蝓竽雩渝覦預漁語於與煜慾芋育餘餘歟堉鬱豫毓虞裕盂禦隅籲嫗榆喻愚魚玉欲譽禺熨輿癒寓愈愉諭御谷鬱腴遇臾諛圩聿尉瑜予萸於浴	瘉澦妤域娛瘀宇馭獄逾峪昱燠褕蝓竽雨雩渝覦預漁迂於語紆與煜齬慾噢芋育餘餘歟堉鬱豫羽虞毓裕盂禦隅籲嫗榆敔喻愚魚玉欲圉譽禺禹熨嶼輿癒寓愈愉諭圄御谷鬱淤腴臾遇諛庾圩聿尉瑜予萸於浴
倩	欠塹縴歉	乾簽前遣黔愆鉛千箝遷韆鈐籤譴鉗阡嵌仟縴騫虔潛謙淺牽搴錢
卸	燮屑解褻懈契瀉楔洩蟹駭邂榭械謝紲屜	寫血挾諧頡擷偕歇蠍邪斜些攜勰協鞋脅
牯	轂凸股谷鵠滑蠱瞽罟賈鼓穀古詁鈷骨	菰孤鴣告沽蛄僱咕辜錮顧鈷估僱姑呱固故骨家
闐	甜畋填恬田	靦腆舔添忝天
貪	坍癱灘探攤	痰談潭譚探碳袒覃毯嘆壇檀罈炭歎彈坦曇
寬	髖	款梡
欄	蘭攔斕襤瀾嵐藍籣闌婪籃	覽爛纜欖攬濫懶
矮	靄藹	哀皚埃捱噯唉艾哎礙璦隘挨愛曖
械	燮屑解褻懈卸契瀉楔洩蟹駭邂榭謝紲屜	寫血挾諧頡擷偕歇蠍邪斜些攜勰協鞋脅
璘	痳霖麟鱗林鄰燐淋磷轔遴臨琳	吝懍躪藺凜賃
舷	嫌銜嫻鹹啣弦閑賢閒絃涎	莧陷限獻蘚祆秈暹鮮纖霰先銑險線仙蜆顯癬腺羨餡僩掀憲現峴姍縣
味	魏畏褽偽慰尉謂僞遺渭爲喂餵位未胃穌蔚衛為	違葦帷崴緯薇圍唯煨猥桅諉逶鮪幃維威巍偎萎尾濰惟痿闈委危韋微洧娓偉為
瘟	溫塭	穩雯紊聞文刎蚊汶免問紋吻抆玟
戌	須墟胥訏鬚需虛籲噓	敘恤畜絮洫蓄婿酗卹許緒頊徐煦勗咻栩續旭序
抿	閩澠憫敏愍泯皿閔湣	岷玟民
饅	鰻漫蹣蠻瞞	鏝滿曼縵屘漫蔓幔慢
垂	錘鎚陲綞椎捶槌箠	炊吹
釗	召著朝昭招嘲晁	棹罩肇沼炤爪詔晁召著趙照兆找櫂
萵	窩倭渦	臥我沃斡齷渥握
增	繒憎曾	贈
揣		踹
粉		棻分汾焚奮憤糞忿吩芬墳紛份氛
屘	滿	蠻蔓慢蹣漫幔曼鰻饅縵鏝瞞
窒	智制痔致製蛭躓質雉峙幟稚炙痣識置輊至滯秩摯知緻治志誌	徵植脂梔直摭之址質泜芝值胝躑枝吱祉祇肢擲支趾執祗職汁咫只殖織卮紙隻芷止蜘知姪指氏旨
螢	嬴盈瑩楹熒塋瀛縈迎贏營蠅	穎瑛嚶瓔櫻應纓嬰映鸚鶯膺鷹罌郢英景硬影
佾	屹藝肄軼刈誼囈縊逸溢劓疫懿鎰毅義邑億液佚役易羿弋裔蜴驛弈帟譯翌異益臆腋亦艾曳詣議意繹憶掖浥翳奕一抑翼衣	漪尾咦姨椅壹蟻飴旖誼偯迤栘移以彝夷已遺沂宜咿醫頤伊噫疑乙怡貽揖訑迆蛇矣圯胰儀一衣痍倚依
蠣	慄儷麗礫礪唳痢歷靂力慄立癘溧蒞壢戾曆琍吏笠粒例利厲釙荔欐俐酈隸勵瀝鬲莉	禮喱澧醴麗犁哩鯉犛貍籬黎娌璃浬釐離理驪邐李鋰梨狸裡罹裡漓蠡蜊俚
妮	尼泥霓呢倪怩	暱泥睨膩溺你擬妳旎匿逆
鴨	煆押鴉呀丫壓	啞疋亞蚜芽衙訝涯牙軋雅押氬
船	傳	釧川舛穿串喘
像	向橡象巷項鄉嚮相	香餉翔鄉相饗詳降廂鑲響祥瓖箱湘庠想襄享
喬	樵憔譙橋僑翹瞧	雀巧蹺鍬俏峭誚鵲翹竅悄鞘撬橇殼敲愀
漬	字恣孳自	仔訾紫滓籽淄錙緇貲梓諮茲子姿孳資孜輜滋諮齜玆髭吱
逞	騁	呈懲誠承丞撐橙乘秤城瞠成程稱盛澄
杲	搞攪縞槁稿	誥告篙睪羔糕高皋膏
和	褐劾曷荷禾郃賀鶴郝嗑嚇河閤鼾閡涸赫闔暍蚶盒盍翮核合紇酣貉何蓋喝	韓褐瀚劾訶或曷含惑火涵荷禾郃喊擭獲罕賀銲鶴郝嗑汗濩悍禍貨豁河嚇閤呵涸閡憾穫赫闔函暍夥焊盒漢盍活寒壑翮旱合核紇榦撼貉頷捍何翰霍蓋頜喝
猛	錳懵蜢艋	夢朦虻萌孟蒙檬濛甍盟矇懵
迫	破樸泊魄粕醱珀	叵波鄱陂剖潑婆坡頗
奮	分糞忿憤份	棻分汾焚粉吩芬紛墳氛
卯	泖茆	貿帽瑁貓耄冒矛懋髦錨貌毛茅茂
杯	碑背卑裨揹悲盃俾	鋇背倍臂貝輩備孛悖憊北邶狽焙蓓被
褫	齒尺恥呎侈	翅熾啻蚩癡匙敕栘弛馳嗤飭魑遲笞喫赤踟叱癡吃持斥池墀
幀	政掙證証鄭正症	睜掙拯徵錚正箏癥猙爭整崢蒸怔徵丁諍
鞠	橘跼菊掬侷桔局	拒拘懼鋸巨颶居莒遽疽齟倨劇苣屨句具鉅聚踞駒狙蛆舉車據沮瞿距足炬俱咀矩
翩	扁偏篇	遍片胼騙便駢
鮮	纖掀先銑險仙蘚祆蜆顯秈暹姍癬	莧陷限賢獻閒祆蘚秈暹涎纖霰先嫻銑險線仙蜆顯癬嫌弦啣閑腺羨絃餡僩掀銜鹹舷憲現峴姍縣
竊	鍥愜挈怯妾切契	伽茄切且
頤	咦姨飴疑怡貽誼訑迤蛇栘移彝夷遺沂圯胰儀宜一痍	漪蟻藝屹肄軼刈誼囈迤縊以逸佾已溢劓醫疫噫乙懿鎰毅揖義迆邑億液役佚易羿倚尾弋裔蜴椅壹驛弈旖譯帟翌異益偯臆亦艾腋曳咿議詣意伊繹憶掖浥翳矣奕一翼抑衣依
挺	梃艇	庭蜓亭汀婷廳廷聽停霆
孑	捷劫拮櫛桔截詰節羯訐傑竭桀睫擷結潔頡傑碣	姊階芥皆解街嗟戒揭疥界偕藉誡結姐借介接屆
夷	儀怡飴咦姨痍胰頤遺移蛇圯誼彝一沂栘迤貽訑宜疑	咿詣劓揖羿浥異益議藝軼意刈鎰依縊迆肄逸憶以噫抑乙艾佚矣奕翌衣伊佾誼億漪役蟻尾翳已懿壹一掖醫屹易裔繹旖倚液弋迤帟偯邑腋曳溢椅臆翼亦囈蜴驛毅義譯弈疫
窕	挑	頫眺挑條佻調迢蜩覜跳
祉	芷徵止紙趾祇只指旨咫址	雉秩幟蛭志氏脂值肢執祇峙枝治支制質祗之芝誌姪稚窒植織梔泜痣智緻胝滯汁吱致置痔摭至摯製輊躑躓蜘直擲識知隻炙只職卮殖
傷	殤湯商觴	晌裳賞上尚
迅	徇潠汛巽遜訊殉馴蕈訓	徇循潯勛尋醺燻勳旬洵璿詢巡荀薰馴
酴	徒凸荼餘塗屠突圖途	禿土兔吐菟
玷	靛鈿澱墊店奠電惦佃殿甸	點典滇碘癲顛巔
輊	雉秩幟蛭稚窒志痣智緻滯致置痔至摯峙製躓治知識制質炙誌	姪止植織梔咫泜氏芷脂胝值汁址吱肢執摭祇祉躑枝蜘直支擲知徵隻質紙趾只之指祗職芝旨卮殖
溥	誧普埔譜圃浦	葡鋪濮樸釙蹼樸莆僕暴撲撲瀑脯菩蒲璞曝噗僕匍
憐	漣奩簾蓮濂鐮聯鰱連廉	瀲煉楝斂鏈臉鍊戀殮練
推		蛻退腿頹
洞	凍胴動恫棟	東董咚冬懂鼕
磯	畸姬畿其璣羈肌犄飢癘雞乩幾積唧箕幾奇譏激績期屐機嵇跡勣稽蹟基躋嘰居饑	洎棘疾暨忌祭集脊己騎藉芰劑幾記楫瘠覬紀計級極妓冀戢擊寄輯寂給薊及嫉際幾唧麂繼擠急伋薺吉季圾即稷髻霽技汲吃亟既悸躋籍繫岌濟鯽戟驥
瘀	淤迂紆	瘉澦妤域娛宇馭獄逾昱峪燠褕蝓竽雨雩渝覦預漁語於與煜齬噢慾芋育餘餘俞歟堉鬱豫羽虞毓裕盂禦隅籲嫗榆敔喻愚魚玉欲圉譽禺熨禹嶼輿癒寓愈愉諭圄御谷鬱腴遇臾諛庾圩聿尉瑜予萸於浴
例	荔琍儷痢利厲欐莉曆礫勵瀝慄隸蒞釙蠣靂立礪壢粒唳力戾俐吏麗癘鬲溧笠歷酈	裏貍醴李離鯉釐黎罹禮漓理浬梨驪狸蜊俚娌邐澧麗蠡犁璃鋰喱籬犛裡哩
醮	教較校叫覺轎窖	教姣皎驕僥嬌焦詨角椒交蕉礁較澆勦餃跤狡郊腳繳鮫膠鉸攪絞蛟剿矯嚼
斡	臥沃齷渥握	窩我萵倭渦
輾	嶄輦碾拈盞攆斬撚捻展涊	詹譫唸湛站霑瞻廿暫年沾念戰顫佔氈黏佔綻棧蘸
咯	珞郃格絡骼鎘蛤烙駱洛酪革隔閣膈雒閤犖葛落鬲	羅螺哥儸囉箇籮蘿玀鑼葛鏍鴿騾歌各戈疙裸個邏鉻擱割胳
蟲	燬賄崇毀會悔重虺誨蟲	蛔賄會彙彗衝潰詼燴蕙繪穢憧輝舂茴匯揮卉回麾充徽灰諱沖惠迴墮恢暉慧誨晦喙寵
堵	肚篤賭睹	讀度妒蠹督毒牘鍍嘟瀆犢渡髑都黷肚獨杜櫝
依	咿揖壹一噫醫衣伊漪	劓羿浥益藝軼鎰姨痍肄頤憶遺矣佚翌夷一屹栘貽溢臆囈訑疑偯議意刈以移乙蛇役圯億蟻沂繹弋迤腋毅譯儀詣怡咦縊逸抑彝懿倚液帟翼義疫飴異迆胰艾奕衣佾誼尾翳已掖易裔旖邑曳椅亦蜴驛宜弈
痕		恨很狠
晰	悉禧行谿羲嬉釐蟋吸唏曦希蹊稀淅溪畦奚犧譆熙攜烯西析兮嘻僖蜥晞棲膝犀熹	細繫席昔惜洗隙褶襲矽習鰓翕係夕蓆熄檄璽息汐系媳錫戲潟徙喜歙
胄	晝宙咒縐籀皺冑紂	粥軸帚舟妯周肘啁週洲州
昕	欣薪鋅辛心新馨芯訢莘	信尋釁芯
乙	蟻迆已椅以矣旖倚尾迤偯	劓羿浥益藝軼鎰姨痍肄頤憶遺佚翌伊夷一屹栘貽溢臆囈訑疑咿揖議意刈依噫移蛇役圯億沂繹弋迤腋毅譯儀詣怡咦縊逸抑漪彝懿壹醫液帟翼義疫飴異胰艾奕衣佾誼翳掖易裔邑曳亦蜴驛宜弈
朝	釗潮晁招着巢嘲昭著召	櫂詔趙吵炤找罩剿肇沼爪勦兆抄鈔照召晁超炒棹著
框	劻匡眶曠筐礦況壙	誑劻匡眶曠筐礦況狂壙
舛	喘	釧船串穿傳川
庵	鞍安鵪諳銨氨	按菴暗岸俺黯案
的	笛嘀娣犒敵第地遞翟迪棣締帝狄嫡滌得弟芽荻蒂鏑諦	氐笛嘀娣犒敵邸德柢第地砥遞翟迪棣締帝狄嫡牴低抵滌得弟芽荻蒂詆鏑滴底諦
逆	溺暱膩泥匿睨	尼你霓妳倪泥擬旎呢怩妮
晌	賞上	湯觴傷裳殤上商尚
橢	妥	託駝柝脫馱佗跎拖陀鴕唾拓沱
方	枋坊芳	放房坊妨防彷訪倣舫肪紡仿
崎	旗祈琦琪麒耆錡臍齊祁騎枝祇棋畦奇只淇其祺期圻衹歧岐鰭	器憩啟淒谿豈悽企汽漆杞起慼磧泣溪亟砌欺契稽訖戚啓迄柒緝七綺棄乞棲氣愒萋妻
分	棻憤奮糞忿吩芬紛份氛	棻憤汾焚奮糞粉忿吩芬墳紛份氛
郵	鈾遊油由猶疣魷尤猷	囿佑悠誘憂幼攸友侑優又祐柚幽莠酉右牖宥黝有釉鼬
霍	獲壑穫或惑貨濩禍豁擭	活夥火豁和
跳	眺覜頫	挑調條佻蜩迢窕
鍊	戀殮瀲斂練煉鏈楝	簾蓮聯簾鰱濂連奩漣憐鐮廉臉
繪	匯賄卉慧潰諱會彙晦誨喙彗惠穢燴蕙	蛔賄會蟲詼輝茴揮虺回麾燬徽灰毀迴墮恢暉悔誨
謎	靡瀰糜迷麋彌	靡米泌敉密糸祕弭汨瞇咪蜜冪謐覓
資	髭諮貲淄玆滋孳錙緇輜茲齜孜吱姿	籽梓紫字滓仔訾漬恣孳子自
鐺	當儅噹襠	讜黨擋盪檔當蕩
懿	屹藝肄軼刈誼囈縊逸佾溢劓疫鎰毅義邑億液佚役易羿弋裔蜴驛弈帟譯翌異益臆亦艾腋曳詣議意繹憶掖浥翳奕一抑翼衣	漪尾咦姨椅壹蟻飴旖誼偯迤栘移以彝夷已遺沂宜咿醫頤伊噫疑乙怡貽揖訑迆蛇矣圯胰儀一衣痍倚依
叔	贖淑菽熟塾孰	鼠漱黍庶束署戍曙輸數薯術梳述暑舒蜀恕書藷殊疏屬橾墅抒豎樹蔬倏樞
油	鈾遊尤由猶郵魷疣猷	囿佑悠誘憂幼攸友侑優又祐柚幽莠酉右牖宥黝有釉鼬
躇	雛儲鋤除櫥跦芻廚	矗齣出畜黜儲絀杵礎楮怵褚處歜楚觸初
星	腥興猩馨惺	醒性興行倖杏省幸硎悻刑型姓陘形邢
瀛	瑩縈嬴迎營楹塋贏蠅盈螢熒	纓罌景郢鶯櫻映膺鸚嬰應瑛英鷹嚶瓔穎硬影
抽		惆籌溴躊裯仇疇愁醜鯈稠酬綢臭儔
泉	荃蜷銓卷權全詮犬痊佺拳踡	券畎圈甽犬勸
罷	啤埤陂脾裨琵杷吧琶枇霸疲壩耙紕陴爸鈹鼙灞毗沘伯皮	媲鈸劈芭把匹屁僻杷吧琶拔癖霸扒壩耙跋壞仳紕霹被譬疤捌巴靶披爸叭八鈹笆闢否灞批丕痞伯疋
夢	孟	朦萌虻蒙檬蜢甍盟濛錳矇艋猛懵
淚	擂累類	擂雷壘耒漯儡嫘縲羸蕾勒鐳磊累
勒	垃肋樂叻	擂雷壘淚耒漯儡嫘縲了蕾羸鐳磊累類
董	懂	東凍胴動咚恫洞冬棟鼕
呎	齒褫尺恥侈	翅熾啻蚩癡匙敕栘弛馳嗤飭魑遲笞喫赤踟叱癡吃持斥池墀
叉	插差喳	搽察剎岔詫差茶查
棋	旗祈琦琪麒耆錡臍齊祁騎枝祇畦奇只崎淇其祺期圻衹歧岐鰭	器憩啟淒谿豈悽企汽漆杞起慼磧泣溪亟砌欺契稽訖戚啓迄柒緝七綺棄乞棲氣愒萋妻
薨	烘哄轟	泓哄洪宏汞鬨紅訌弘閎黌虹鴻
莘	欣砷信心鋅新芯馨申呻伸深娠薪身辛訢紳參昕	哂信審滲甚芯瀋腎蜃尋沁釁嬸脤神慎沈
氾	販汎犯範飯梵泛範	繙礬番反藩蕃墦樊凡煩翻釩返幡繁帆
癆	勞嘮牢	佬烙勞酪老絡姥撈
逍	梟囂哮消削硝銷霄驍簫嘐蕭瀟宵	效笑小嘯校肖傚酵孝學篠曉
噴		盆
躂	瘩搭漯褡獺遢答遝榻踏蹋塌撻	瘩大他塔牠它靼答打達韃她怛塌
咚	冬鼕東	胴洞董棟凍動懂恫
嗤	笞吃喫癡蚩魑	飭褫赤遲斥叱弛踟匙持呎馳池翅敕栘侈啻尺熾墀齒恥
荀	潯巡馴徇尋詢璿循洵旬	燻汛殉徇薰醺迅訓潠遜馴訊勛巽勳蕈
弈	屹藝肄軼刈誼囈縊逸佾溢劓疫懿鎰毅義邑億液佚役易羿弋裔蜴驛帟譯翌異益臆腋亦艾曳詣議意繹憶掖浥翳奕一抑翼衣	漪尾咦姨椅壹蟻飴旖誼偯迤栘移以彝夷已遺沂宜咿醫頤伊噫疑乙怡貽揖訑迆蛇矣圯胰儀一衣痍倚依
燃	然髯	苒冉髯染
待	迨代大貸黛逮殆戴玳呆袋岱帶怠	迨代大貸歹黛逮殆戴玳呆袋岱帶怠
畏	魏褽偽慰尉謂僞遺渭爲喂餵位未胃穌蔚衛味為	違葦帷崴緯薇圍唯煨猥桅諉逶鮪幃維威巍偎萎尾濰惟痿闈委危韋微洧娓偉為
慣	盥貫鸛罐冠灌觀	綸關管倌琯冠莞官鰥矜觀棺館
脰	豆讀鬥竇痘逗	陡枓鬥蚪都抖兜
娃		窪蛙媧哇呱挖瓦襪
焚	汾墳	棻分憤奮糞粉忿吩芬紛份氛
傍	梆邦旁鎊磅謗棒幫蚌	梆邦膀旁綁鎊磅榜謗棒幫蚌
逾	魚諛雩予竽愚禺虞蝓盂褕圩榆渝萸漁瑜輿歟於腴妤隅愉臾餘覦俞娛	芋與馭御喻育宇雨予禹瘉寓譽禺迂鬱尉齬噢癒圉諭玉澦煜語欲谷庾裕嶼昱愈紆聿峪嫗籲預豫圄域浴羽獄毓遇淤堉慾瘀敔禦熨俞燠
條	迢佻蜩調	挑眺覜跳頫窕
罪	蕞最醉	堆嘴
萎	猥諉葦煨逶痿鮪威委娓偎崴洧尾偉緯	違葦魏畏褽帷偽慰崴緯尉薇圍唯煨猥桅謂諉逶鮪僞幃遺維渭威巍偎爲喂尾餵濰惟痿闈未位危委韋胃洧微穌蔚衛味娓偉為
紛	棻分吩芬氛	分汾焚奮糞粉忿墳憤份
莖	晶鯨睛京更精荊經粳菁兢驚旌涇	靜競井淨警敬勁痙頸鏡阱憬璟竟景徑逕靖境
徊	懷淮踝槐	壞
巢	潮朝嘲晁	超炒剿吵抄勦鈔
撒	灑	卅灑薩颯
潭	痰談譚覃壇檀罈彈曇	坍癱灘探碳袒嘆毯貪攤炭歎坦
高	皋睪羔糕膏篙	攪槁誥搞縞告杲稿
炒	吵	超潮剿巢朝抄勦鈔嘲晁
獅	濕屍噓詩失溼施師蝨	室十恃螫屎筮史提匙奭實勢嗜舐豉矢射市食士事仕拭碩拾識蝕試世釋柿逝是駛適塒侍示時什飾豕軾誓弒始氏式噬石使視
確	闋雀恪鵲闕榷卻怯殼	缺瘸闕
眷	倦卷狷圈雋絹	娟捲身捐圈鐫鵑涓
履	呂鋁褸膂屢旅婁侶縷	慮閭率氯綠驢濾律櫚
淄	錙緇貲諮茲姿孳孜資輜滋諮齜玆髭吱	仔訾字恣紫滓籽漬子孳梓自
攙	摻	闡儳懺纏諂饞蟾澶嬋剷禪產讒蟬羼孱毚單潺巉鏟
脊	急唧疾即寂楫伋擠吉擊及嫉汲己亟藉岌吃瘠給借棘圾級戟麂籍濟輯幾戢集極	霽寄擊忌騎悸己藉紀瘠計圾籍畸洎璣磯飢既躋唧楫居績稷譏羈覬劑吃季稽祭麂蹟驥鯽幾集犄姬際伋吉薺饑機及乩亟奇棘箕妓濟嵇其芰戢雞基薊系冀急髻疾跡繼寂即繫屐擠技記激嫉汲積岌給級嘰戟輯癘肌期暨極畿勣
祆	秈纖姍暹掀鮮先仙	僩峴餡涎顯限嫌莧銑舷銜啣鹹癬現霰險嫻腺閒鮮閑絃羨鹹憲獻弦蜆陷縣線賢蘚
榭	蟹邂屜解洩屑駭卸械瀉懈謝褻契燮楔洩紲	攜協歇寫邪斜些挾諧蠍偕鞋擷頡血脅勰
貨	獲壑穫或惑濩禍豁霍擭	活夥火豁和
甫	脯撫斧府腑輔莆父俯釜腐頫	孚富拂夫芙敷父復袱蝠菔氟覆阜駙符複幅服馥傅鈇扶咐膚芾訃附輻腹俘賦伏匐賻彿副婦伕紼縛付涪浮趺福弗怫孵負麩紱赴
糾	赳酒玖灸九揪韭久鳩啾	酒救揪鳩玖啾舊究咎臼灸廄韭久疚赳舅九就柩
欠	倩纖歉塹縴	淺乾鉛謙韆嵌錢潛愆遣籤搴仟千牽簽前遷鉗騫鈐黔箝幹譴虔縴阡
塢	鎢誤惡戊勿悟霧騖物寤軏堊兀晤務	無巫毋圬屋梧嫵惡舞汙烏吾誣鎢吳五侮鼯於蕪捂鵡憮嗚蜈午亡武伍污唔
膠	蛟礁鮫教嬌驕蕉澆姣交椒焦詨郊跤	攪醮矯嚼餃狡教剿叫覺轎較鉸勦腳僥窖絞繳校姣皎角
羼	懺儳	攙禪蟾嬋巉鏟饞剷摻諂讒澶孱潺蟬毚單纏闡產
韋	危維帷微巍唯惟闈圍濰為桅違薇幃	尾娓魏衛胃蔚痿緯萎威未遺渭為崴味穌煨逶餵偽葦位慰偉洧謂鮪偎褽尉喂畏猥諉委
赭	者	遮懾蔗謫轍宅浙哲這蜇折著摘摺輒螫鷓褶
嶄	展盞斬輾	棧站沾瞻綻霑湛暫佔蘸顫詹譫氈戰
觔	襟浸斤金矜津禁筋今巾	盡饉燼晉緊噤勁僅禁儘覲縉浸謹瑾進錦近
奐	渙豢幻煥換瘓梡喚患宦	桓還環皖澴洹歡鍰緩梡寰
臬	涅鑷蘗囁齧鎳孽聶躡	捏
鼴	衍魘掩偃兗眼儼郾演	豔閻癌堰焰諺菸雁簷驗湮醃贗咽艷殷硯巖炎晏延研妍嚥奄彥煙簷胭沿燕鹽醃饜顏釅筵巖厭嚴淹燄言焉嫣宴唁
鑑	餞澗鑒劍閒毽諫箭僭踐艦件健建間檻見監賤濺薦腱漸鍵	尖儉堅艱減菅緘韉柬湔撿簡殲瞼肩筧間揀繭煎姦剪鹼監檢縑濺奸兼漸囝箋
荔	琍儷痢例利厲欐莉曆礫勵瀝慄隸蒞釙蠣靂立礪壢粒唳力戾俐吏麗癘鬲溧笠歷酈	裏貍醴李離鯉釐黎罹禮漓理浬梨驪狸蜊俚娌邐澧麗蠡犁璃鋰喱籬犛裡哩
瘤	榴泵留劉瀏硫琉流遛	餾霤六陸溜鉚柳
貸	待迨代大黛逮殆戴玳袋岱帶怠	呆待逮歹
敵	迪狄嘀笛犒荻的嫡鏑滌芽翟	氐娣邸柢第地砥遞棣締帝的牴低抵弟蒂詆滴底諦
梃	挺艇	廷霆婷聽廳蜓汀停亭庭
仳	否匹痞疋	劈披陂譬疲沘壞僻癖琵批啤闢鼙脾匹媲丕霹皮埤闢枇陴鈹屁被罷紕毗裨
懈	燮屑解褻卸契瀉楔洩蟹駭邂榭械謝紲屜	寫血挾諧頡擷偕歇蠍邪斜些攜勰協鞋脅
徽	麾恢輝揮灰暉詼墮	蛔賄會彙蟲彗潰燴繪蕙穢匯茴卉虺回燬毀諱惠迴慧悔晦誨喙
憑	平馮枰蘋瓶萍屏評坪	娉乒
酉	牖有黝莠友	遊由郵疣莠又尤優憂幼幽猶猷攸遊鼬誘宥油悠右柚祐鈾有侑囿佑魷釉
液	詣劓羿浥異益議藝軼意刈鎰縊肄逸憶抑艾佚奕翌衣佾誼億役翳懿一掖屹易裔繹弋帟邑腋曳溢臆翼亦囈蜴驛毅義譯弈疫	咿儀揖怡飴咦依姨迆痍胰頤以遺噫移乙矣蛇衣伊夷誼尾漪圯蟻彝已壹一醫沂旖栘倚迤貽椅訑宜疑偯
橇	萃鍬翠悴蹺撬敲瘁粹脆淬	催樵巧鞘憔雀蹺悄愀殼鵲喬竅峭璀俏撬誚衰摧譙瞧僑崔橋翹
協	諧挾頡擷偕斜邪攜勰鞋脅	卸洩歇榭蠍寫屑血楔蟹邂契褻懈謝駭械燮解些瀉紲屜
鴣	菰咕孤辜鈷沽估姑呱蛄家	凸鵠僱罟賈鼓穀顧估僱故轂股告谷滑牯蠱瞽錮古詁鈷固骨
咧		冽列裂捩劣鬣獵烈洌
襞	弊璧必敝鉍薜嗶痺箄避臂斃庇畢俾愎陛碧賁泌鄙蹕篦蔽詖埤闢閉弼婢祕比壁睥幣裨	彼鄙筆逼匕比沘鼻妣
徬	旁膀螃龐	胖滂乓磅
僻	媲闢譬癖屁	啤埤劈陂脾裨匹琵枇疲壞仳紕霹被陴披鼙鈹否批毗丕沘痞疋罷皮
薯	數屬鼠暑黍蜀署藷	漱庶束署戍曙輸數術贖梳菽述舒叔淑恕書殊疏塾橾墅抒豎樹蔬倏樞熟孰
荸	卜鈸博蔔鉑駁箔脖搏檗渤帛薄白柏膊勃泊伯舶	玻菠薄亳般薜擘蘗簸檗剝跛缽播撥
敗	拜	佰擺襬白百
轔	痳霖麟鱗林鄰燐淋磷遴臨琳璘	吝懍躪藺凜賃
摒	病併並並	丙柄秉兵鉼屏稟冰餅炳
胼	駢便	遍片騙扁篇偏翩
蝌	窠科柯軻顆蚵稞棵瞌磕刻苛	緙咳坷喀恪剋可嗑殼溘課克渴客刻髁
貶	褊扁匾	辯編遍蝙變汴邊鞭卞弁釆辨辮砭便
瑁	媚貿帽耄冒魅昧懋袂妹貌沬茂寐	楣每泖沒莓枚貓媒矛美黴眉玫髦鎂錨毛煤茆卯梅湄茅黴
斐	菲翡匪誹	費痱菲屝肥沸非腓妃飛吠怫扉廢霏肺芾啡
暫	棧站瓚綻湛佔蘸顫讚贊戰鏨	斬嶄沾瞻展偺盞輾霑咱佔詹譫氈簪
熾	赤翅斥啻飭敕叱	褫尺恥蚩癡呎踟侈匙癡吃栘齒弛持馳嗤池魑遲墀笞喫
餒	哪	內
旭	序恤緒酗續卹蓄畜絮敘婿頊勗洫	鬚咻噓訏栩須戌胥墟籲煦虛需徐許
上	晌賞尚	湯觴傷晌裳殤賞商尚
擡	跆颱薹苔臺檯	泰汰苔太態胎
捨	麝攝赦拾設社射歙涉葉捨捨	麝攝舌赦奢甚涉葉蛇賒拾設什社射歙捨麝攝舌捨赦奢甚涉葉賒蛇拾設什社射歙
朗		螂狼郎廊琅瑯浪榔
荊	晶鯨睛莖京更精經粳菁兢驚旌涇	靜競井淨警敬勁痙頸鏡阱憬璟竟景徑逕靖境
剛	缸鋼岡綱崗槓扛釭肛	崗槓港
腰	要妖吆夭邀喲麼	藥餚洮淆瑤崤要搖窈樂爻舀鷂姚榣杳僥遙謠耀堯拗曜窯夭咬鑰
蒲	菩璞脯濮莆樸匍釙葡蹼僕	撲普噗曝溥瀑圃鋪暴浦誧埔譜僕
奭	拭恃式軾適是飾柿氏士使視螫弒市示試豉仕噬誓筮室勢侍世嗜識逝事釋舐	豕屍匙溼獅蝨使拾詩碩失十蝨噓始塒石蝕實食施時提史師濕屍矢什屎射駛
雄	熊	兄兇洶胸匈
印	蔭隱飲胤	淫霪聽殷尹吟因癮鄞簷飲湮隱垠夤銀陰慇氤姻蚓縯引齦音茵寅
撮	厝搓錯蹉磋措銼挫	厝搓錯蹉磋措銼嵯挫
烽	瘋楓鋒峯蜂豐諷風豐封	縫諷逢奉鳳俸馮
舀	窈杳咬夭	吆藥餚洮淆腰麼瑤崤要妖外搖樂爻鷂歪姚榣僥遙謠耀邀堯拗曜窯夭鑰喲
挑	窕	調眺條佻覜蜩跳頫迢窕
牽	纖簽搴鉛愆千謙嵌遷韆籤騫縴仟阡	倩潛鈐欠黔淺箝乾幹遣前歉鉗塹譴虔縴錢
糠	慷康	慷亢抗伉炕扛
偕	攜階協皆邪斜街嗟挾揭諧鞋擷結頡接脅勰	捷蟹芥拮桔節懈桀疥燮蠍楔誡藉頡紲劫邂歇屜櫛洩屑訐羯竭謝褻借傑介屆駭截詰傑孑洩血碣姊榭解寫些卸械瀉戒契睫界擷結潔姐
沐	慕穆募墓木目睦苜幕暮牧	牡模拇姥姆母畝
該	賅垓	丐概溉改鈣蓋
匣	霞峽黠挾轄呷遐洽狎柙斜瑕狹暇俠	夏廈下嚇暇蝦瞎
漸	餞澗尖劍鑒閒堅毽艱菅諫箭緘僭踐韉艦件健湔建殲肩間檻見煎姦監賤縑濺薦腱奸兼鑑鍵箋	餞澗鑒劍儉尖閒堅毽艱減菅諫箭緘僭踐韉柬艦件健湔建撿簡殲瞼肩筧揀間檻繭見煎姦剪鹼檢監賤縑濺薦腱奸囝兼鑑鍵箋
屏	平馮枰餅蘋秉丙鉼坪萍稟柄評瓶炳憑	娉摒乒冰兵並併病
紱	氟縛匐夫蝠紼扶芾幅孚弗輻袱福浮伏符菔拂涪怫彿服芙俘	富馥覆附膚俯鈇複府夫腑腐頫甫阜腹賻副傅復釜敷付撫斧孵赴婦莆趺輔咐父麩脯賦負駙伕訃
拜	敗	佰擺襬白百
躓	雉秩幟蛭稚窒志痣智緻滯致置痔至摯峙製輊治識知制質炙誌	姪止植織梔咫泜氏芷脂胝值汁址吱肢執摭祇祉躑枝蜘直支擲知徵隻質紙趾只之指祗職芝旨卮殖
祐	幼鼬誘宥右柚有侑莠又囿佑釉	遊幽黝猶猷遊攸油悠由牖鈾有郵友疣莠酉尤優魷憂
局	橘跼菊掬侷桔鞠	拒拘懼鋸巨颶居莒遽疽齟倨劇苣屨句具鉅聚踞駒狙蛆舉車據沮瞿距足炬俱咀矩
蛐	趨嶇屈圈砠曲區軀驅瞿蛆	去娶劬取趣麴瞿璩漆齲曲渠衢
傖	艙滄蒼倉	藏
圈	娟倦趨捐身驅鵑砠涓絹曲蛐區卷屈狷軀雋蛆嶇捲瞿鐫眷	娟取倦身捐渠鵑娶痊涓絹趣劬勸漆曲蜷銓齲畎衢踡去券荃麴權全詮狷甽雋璩捲瞿犬鐫泉佺拳眷
嗶	弊璧必敝鉍薜痺箄襞避臂斃庇畢俾愎陛碧賁泌鄙蹕篦蔽詖埤闢閉弼婢祕比壁睥幣裨	彼鄙筆逼匕比沘鼻妣
連	憐漣奩簾蓮濂鐮聯鰱廉	瀲煉楝斂鏈臉鍊戀殮練
紫	籽梓滓仔訾子	字淄恣玆子錙自輜資孳茲吱貲孜姿髭諮漬滋緇齜
楝	鍊戀殮瀲斂練煉鏈	簾蓮聯簾鰱濂連奩漣憐鐮廉臉
捍	瀚旱憾銲撼悍焊頷翰漢汗頜	韓鼾寒罕函含蚶榦酣涵和喊汗
啤	埤枇毗陂陴疲脾裨沘罷皮琵紕鼙鈹	媲劈匹屁僻癖壞仳紕被霹譬披鈹闢否批丕痞疋
櫂	召棹趙照兆肇罩炤詔晁	釗召著朝昭招嘲沼找爪晁
呷	狎暇俠轄霞斜柙挾峽匣洽狹黠遐瑕	下暇蝦嚇夏廈瞎
砍	坎侃檻崁	戡刊看堪瞰勘
晅	萱喧壎煖暄軒宣諼	鉉懸漩還炫絢渲眩選旋縣璿玄
室	恃螫筮奭勢嗜舐豉市士事仕拭識試世釋柿逝是適侍示飾軾誓弒氏式噬使視	濕詩十施屎師史匙提矢射食碩拾蝕駛塒屍噓時什溼豕獅失始蝨實石使
律	慮率氯綠濾	呂閭鋁褸履驢膂屢旅婁侶縷櫚
釆	遍辯辮辨卞弁變汴便	褊鞭扁砭邊蝙編貶匾
閨	龜皈歸鮭規圭珪瑰傀	晷桂鱖詭跪貴癸鬼軌櫃
耗	顥鎬涸號浩昊好鄗皓	蠔蚵嗥鶴號郝蒿好毫貉濠豪嚎壕
堊	詻愕鱷晤騖鍔塢悟誤務扼厄遏軛俄啞噩寤惡戊呃物勿霧顎兀鎢軏餓鄂萼	武汙鵡哦巫侮吾亡誣蛾婀無峨蚵吳午俄五烏訛毋伍惡嗚鼯嫵唔於額憮屋舞圬鎢捂娥阿污梧鵝蕪蜈
草		操嘈漕曹槽糙
沸	吠芾費屝怫痱廢肺	菲啡肥誹霏斐妃腓扉匪翡非飛
讒	饞禪澶蟬潺孱蟾毚嬋單巉纏	懺剷摻諂攙儳鏟闡產羼
炸	閘搾柵扎吒紮乍札蚱砟咋詐	閘搾柵扎渣吒紮乍喳札蚱眨砟咋詐查
奇	唧旗祈跡屐琦居績琪耆犄麒錡饑譏臍齊祁羈騎機乩鰭積激枝祇棋畦稽箕嘰躋蹟只崎淇畸嵇祺幾肌期其飢癘雞圻衹璣基歧岐磯畿姬勣	霽憩寄擊悸忌騎溪己藉紀瘠訖計圾籍洎躋既器唧脊豈楫稷慼泣覬劑吃季借稽戚祭麂驥鯽七幾集棄愒欺萋啟淒谿悽際伋企吉薺漆磧及砌亟啓棘迄妓濟綺芰戢乞氣薊系冀急髻疾繼繫寂即擠汽起杞技記嫉汲岌契給級柒戟輯緝暨極棲妻
模	膜蘑摩磨糢謨魔摹	抹慕墨脈募木姥漠墓沒麼歿膜末貊牡默穆茉目苜母牧莫磨摸陌沫寞沐姆幕暮畝驀拇睦秣
層	曾	
褸	鋁膂婁旅侶屢呂履縷	氯櫚閭綠濾驢律慮率
蚊	雯聞文紋玟	穩紊聞文瘟塭汶免問溫刎吻抆
詛	組俎祖阻	卒嗾租族足
抵	氐牴邸詆砥底柢	氐笛嘀娣犒敵第地遞翟迪棣締帝狄嫡的低滌弟芽荻蒂鏑滴諦
詠	壅永勇恿泳臃蛹湧擁俑踊踴甬	壅庸傭邕臃雍擁鄘慵用
恭	躬供宮龔釭紅蚣公攻共工肱功弓	供鞏汞礦共廾拱貢
盔	虧窺	餽愧簣揆潰奎魁葵夔逵匱喟睽傀
讚	鏨贊瓚暫	咱簪偺
魏	畏褽偽慰尉謂僞遺渭爲喂餵位未胃穌蔚衛味為	違葦帷崴緯薇圍唯煨猥桅諉逶鮪幃維威巍偎萎尾濰惟痿闈委危韋微洧娓偉為
悌	涕屜剃替銻逖嚏惕	剔題梯堤蹄踢啼體隄緹提
帷	危維微巍韋唯惟闈圍濰為桅違薇幃	尾娓魏衛胃蔚痿緯萎威未遺渭為崴味穌煨逶餵偽葦位慰偉洧謂鮪偎褽尉喂畏猥諉委
珞	烙駱洛酪咯絡雒犖落	騾羅螺籮蘿玀鑼儸囉裸邏鏍
戎	容榮融鎔絨蓉茸溶熔榕嶸	茸冗
官	綸關倌冠莞鰥矜觀棺	盥貫管鸛慣罐琯冠灌莞觀館
耳	邇爾餌洱	兒貳而二
楷	凱愷慨豈剴	咳開慨愾揩愒
怵	矗處畜黜歜絀觸	齣出鋤儲除杵礎跦楮廚褚雛處櫥躇楚初芻
敉	靡弭米	謎彌密糸蜜咪糜靡汨祕覓瀰祕冪麋瞇謐泌迷
璃	罹麗蠡犁貍漓蜊喱狸梨籬犛驪離釐黎	裏荔琍儷利厲痢例欐莉曆醴礫李勵鯉瀝慄禮隸理浬蒞釙蠣靂俚立粒礪壢唳力邐娌俐戾澧吏麗蠡鬲溧癘鋰笠裡哩歷酈
遼	聊嘹潦寥撩寮繚燎僚療	料撩暸了燎瞭廖
美	每鎂	妹楣袂玫煤沒眉魅媚昧瑁梅莓沬寐媒黴枚湄
釁	信芯	尋心薪訢莘昕鋅辛新芯馨欣
酈	慄儷麗礫礪唳痢歷靂力慄立癘溧蒞壢戾曆琍吏笠粒例利厲釙荔欐俐隸蠣勵瀝鬲莉	禮喱澧醴麗犁哩鯉犛貍籬黎娌璃浬釐離理驪邐李鋰梨狸裡罹裡漓蠡蜊俚
燠	裕瘉澦禦域籲嫗馭喻獄玉欲譽禺熨峪昱癒寓愈諭御谷鬱預語遇與煜慾芋育聿尉俞堉鬱豫浴毓	妤娛瘀宇逾褕竽蝓雨雩渝覦迂漁於語紆與噢齬餘餘俞歟羽虞盂隅榆敔愚魚圉禺禹嶼輿愉圄淤腴臾諛庾圩瑜予萸於
迷	靡瀰謎糜麋彌	靡米泌敉密糸祕弭汨瞇咪蜜冪謐覓
姨	儀怡飴咦痍胰頤遺移蛇圯夷誼彝一沂栘迤貽訑宜疑	咿詣劓揖羿浥異益議藝軼意刈鎰依縊迆肄逸憶以噫抑乙艾佚矣奕翌衣伊佾誼億漪役蟻尾翳已懿壹一掖醫屹易裔繹旖倚液弋迤帟偯邑腋曳溢椅臆翼亦囈蜴驛毅義譯弈疫
螻	樓嘍婁髏	簍瘺鏤摟露漏陋
曠	眶礦況框壙	誑劻匡筐狂框
纓	瑛嚶英瓔嬰鸚鶯膺櫻應鷹罌	穎盈楹迎應嬴熒螢贏營映瑩縈瀛蠅郢景塋硬影
梧	無巫毋蜈鼯吳亡蕪吾誣唔	巫勿騖寤軏圬屋嫵誤惡舞物汙堊烏兀誣務鎢悟塢霧五於侮捂鵡晤嗚戊午武伍污憮
懲	呈誠承丞橙乘城成程盛澄	騁秤逞瞠撐稱
皈	閨龜珪圭瑰鮭傀規歸	鬼桂鱖癸軌跪詭晷櫃貴
駙	富腹馥覆賻附副傅復付複赴婦咐父阜賦負訃	氟縛匐膚鈇俯府腑夫腐頫蝠紼扶甫幅芾孚弗輻紱福袱浮伏符菔釜敷拂涪撫怫斧孵莆趺輔彿服父麩脯芙伕俘
癒	裕瘉澦禦域籲嫗馭喻獄玉欲譽禺熨峪昱燠寓愈諭御谷鬱預語遇與煜慾芋育聿尉俞堉鬱豫浴毓	妤娛瘀宇逾褕竽蝓雨雩渝覦迂漁於語紆與噢齬餘餘俞歟羽虞盂隅榆敔愚魚圉禺禹嶼輿愉圄淤腴臾諛庾圩瑜予萸於
哲	蜇轍褶摘摺謫折輒懾	浙赭者宅鷓蔗遮着這螫著
椒	蛟礁鮫教嬌驕蕉澆姣膠交焦詨郊跤	攪醮矯嚼餃狡教剿叫覺轎較鉸勦腳僥窖絞繳校姣皎角
胝	肢祇織梔枝泜蜘支氏知隻只祗之脂芝卮汁吱	雉秩幟止蛭志芷值址執祇祉峙治制紙質誌姪稚窒植咫痣智緻滯致置痔摭至摯製輊躑躓直擲知識徵只炙趾指職旨殖
親	嶔欽侵磬慶罄	請擎沁勤秦琴頃擒禽蜻情傾噙卿撳輕寢清晴鯖檠氫芹青
瓦		窪娃蛙媧哇呱挖襪
岡	缸鋼綱崗槓剛扛釭肛	崗槓港
儡	壘耒漯蕾磊累	擂雷淚嫘縲羸勒鐳累類
郾	鼴衍魘掩偃兗眼儼演	豔閻癌堰焰諺菸雁簷驗湮醃贗咽艷殷硯巖炎晏延研妍嚥奄彥煙簷胭沿燕鹽醃饜顏釅筵巖厭嚴淹燄言焉嫣宴唁
崁	侃坎檻砍	戡看瞰勘刊堪
摑	國幗	鍋蟈槨過猓堝郭果裹
梢	捎稍燒	少哨韶紹杓芍邵勺召
涊	輦碾拈攆輾撚捻	念唸黏廿年
毗	陂疲脾皮沘埤枇陴鈹罷紕琵啤鼙裨	劈披譬仳匹否媲丕霹痞僻壞闢鈹癖屁被紕批闢疋
鯊	殺砂杉莎裟紗煞沙	傻霎廈煞
通	恫	童桐瞳統慟桶同筒僮彤銅潼痛峒
月	曜越粵刖悅玥藥說耀躍軏樂鑰籥嶽閱	約曰
氅	場廠敞	常場暢長裳倀腸昌倡猖鯧萇償唱娼嚐嫦悵嘗徜
鬣	洌冽烈獵裂列劣捩	咧
啼	緹題隄蹄堤提	梯悌銻剔涕踢惕替嚏剃逖體屜
詼	墮灰麾揮恢輝暉徽	諱茴蟲晦蕙燴燬彙彗虺賄悔回迴卉誨潰惠毀喙慧繪穢會蛔匯
蛉	綾零櫺昤羚菱鴒泠靈玲鈴苓伶齡聆陵凌翎	拎令另嶺領
營	嬴盈瑩楹熒塋螢縈迎贏瀛蠅	穎瑛嚶瓔櫻應纓嬰映鸚鶯膺鷹罌郢英景硬影
懷	淮徊踝槐	壞
癱	坍灘探貪攤	痰談潭譚探碳袒覃毯嘆壇檀罈炭歎彈坦曇
欖	纜覽攬懶	蘭攔爛斕纜襤瀾嵐藍籣濫闌婪籃欄
陀	馱跎沱鴕佗駝	唾脫橢拖柝妥託拓託
熄	習檄褶錫息媳席襲蓆昔惜	細悉禧行谿羲繫嬉晰蟋釐洗吸唏曦隙希蹊稀淅溪矽畦奚鰓係翕犧譆熙夕攜烯析西兮嘻僖蜥晞棲璽系汐膝潟戲犀熹徙喜歙
預	芋與馭御喻育瘉寓禺鬱尉癒諭玉澦語煜欲谷裕昱愈聿峪嫗籲豫浴域獄毓遇堉慾譽禦熨俞燠	與魚諛宇雨雩竽禹予愚禺虞迂齬蝓噢盂圉逾褕圩瘀榆渝語萸漁瑜庾輿嶼歟於腴紆妤隅圄愉羽臾餘淤覦敔俞娛
肚	度妒賭蠹睹篤杜堵渡鍍	讀度妒蠹督毒堵鍍牘睹嘟瀆犢渡賭髑都黷篤獨杜櫝
燎	聊嘹潦料寥撩寮了繚遼僚療瞭廖	聊嘹潦料寥撩暸寮了繚遼僚療瞭廖
硬	應映	穎盈瑛嚶瓔楹迎櫻應纓嬴熒螢贏營嬰瑩鸚鶯縈膺鷹罌蠅瀛郢英景塋影
刺	廁賜伺次	疵祠詞瓷茨雌辭慈此差磁
斧	脯撫腑府輔莆父俯釜腐頫甫	孚富拂夫芙敷父復袱蝠菔氟覆阜駙符複幅服馥傅鈇扶咐膚芾訃附輻腹俘賦伏匐賻彿副婦伕紼縛付涪浮趺福弗怫孵負麩紱赴
韆	簽阡嵌仟縴愆鉛千騫謙牽搴遷籤	乾欠前塹縴遣黔歉倩箝虔潛淺鈐譴錢鉗
扯		車澈坼撤徹掣轍
克	緙喀可恪剋嗑課溘客刻髁	窠科棵稞軻咳坷柯顆蚵可瞌蝌渴磕殼刻苛
湖	囫糊狐鵠胡鬍蝴葫壺弧斛瑚	戶滬虎沍扈乎瓠忽惚互琥唬戲護楛許呼
卉	諱惠晦喙蕙燴慧繪穢彙彗賄會匯誨潰	麾恢詼蟲茴暉毀墮灰揮燬賄虺輝悔回會徽迴蛔誨
件	餞澗鑒劍閒毽諫箭僭踐艦健建間檻見監賤濺薦腱漸鑑鍵	尖儉堅艱減菅緘韉柬湔撿簡殲瞼肩筧間揀繭煎姦剪鹼監檢縑濺奸兼漸囝箋
泯	閩澠憫敏抿愍皿閔湣	岷玟民
枸	勾狗句苟鉤溝	雊構購夠媾搆鉤溝勾垢遘詬狗句苟
虧	窺盔	餽愧簣揆潰奎魁葵夔逵匱喟睽傀
掉	釣吊調弔	叼凋鯛彫雕碉貂刁
爰	緣媛源員原轅園圓援騵猿湲元袁沅垣	宛院苑媛願淵願冤鴛鳶怨遠
哎	埃哀挨唉	靄皚藹曖捱噯艾矮礙璦愛隘
嫣	奄菸煙胭燕醃湮醃厭咽淹焉殷	豔閻癌堰焰儼諺雁簷驗衍魘掩贗郾咽艷硯巖炎延晏研偃妍兗眼嚥彥簷沿燕鹽鼴饜顏釅筵巖厭嚴淹燄言宴演唁
勛	燻薰醺勳	汛殉潯巡徇循潠迅訓遜馴訊尋詢璿洵荀巽蕈旬
忝	靦腆舔	甜畋填添恬天田闐
候	逅厚後堠鱟	猴吼篌侯喉
瘍	烊鍚佯揚洋颺羊楊徉昜暘陽煬	泱養仰鴦怏殃央秧癢樣漾恙氧鞅煬
橾	殊抒疏蔬書輸樞舒梳	樹叔塾菽術淑贖黍恕屬述漱豎束熟數庶鼠倏藷戍暑孰薯蜀墅疏署曙
餘	魚諛雩予余竽屠愚禺虞蝓盂逾褕塗圩渝萸荼酴漁瑜輿凸歟於腴徒妤途圖突隅愉覦臾榆俞娛	芋與馭御喻育宇雨予禹瘉寓譽禺迂鬱尉齬噢禿癒圉諭郁玉澦煜語欲谷土庾裕嶼菟吐昱愈紆聿兔峪嫗籲預豫圄域浴羽獄毓遇淤堉慾瘀敔禦熨俞燠
怫	氟縛痱匐夫吠蝠紼扶芾幅孚弗輻紱費袱福浮屝伏符菔沸拂涪彿廢服肺芙俘	斐附覆馥膚鈇俯非複夫誹頫甫啡賻肥傅付妃撫扉斧莆赴脯賦匪訃菲富腓府腑腐霏阜腹翡副復釜敷飛婦孵趺輔咐父麩負伕駙
福	孚拂夫芙袱蝠菔氟符幅服扶芾輻伏俘匐彿紼縛浮涪怫弗紱	富斧夫敷莆父復腐覆阜腑撫駙複輔傅鈇俯釜甫膚咐訃附腹賦賻副頫婦伕脯府付趺孵麩負馥赴
蠕	阮燸如軟濡嚅孺儒茹	汝入女褥辱孺乳茹
輒	蜇哲折摺摘懾謫轍褶	浙遮這著蔗螫赭鷓者宅
客	緙喀可恪剋嗑課溘克刻髁	窠科棵稞軻咳坷柯顆蚵可瞌蝌渴磕殼刻苛
惆	酬稠儔仇疇綢愁躊籌裯鯈	溴抽臭醜醜
妒	度肚蠹杜渡鍍	讀賭肚睹嘟髑都獨督毒篤黷瀆堵櫝犢牘
丐	概鈣溉蓋	賅該垓改
餐	參	慘孱璨蠶燦慚殘
茁	卓灼濯着啄濁著斫拙琢擢酌鐲	桌涿捉棹
溫	塭瘟	穩雯紊聞文刎蚊汶免問紋吻抆玟
迪	鏑荻的犒嘀翟狄滌笛芽敵嫡	滴低締底帝的地蒂第氐牴娣砥遞諦弟柢棣邸抵詆
桀	捷劫拮櫛桔截詰節羯訐傑竭睫擷孑結潔頡傑碣	姊階芥皆解街嗟戒揭疥界偕藉誡結姐借介接屆
茂	冒瑁懋貌耄貿帽	茅茆卯髦泖毛貓矛錨
囪	樅聰窗從匆創蔥瘡	撞牀從創叢闖搶愴幢淙
夥	伙火	活獲壑穫或惑貨濩禍豁和霍擭
穌	蘇位慰魏胃衛囌蔚謂未褽遺尉喂渭畏為酥甦味餵偽	尾娓肅訴維痿緯萎素威韋唯惟濰圍桅為崴煨薇逶溯幃葦塑危粟偉洧帷鮪微巍偎蓿俗簌宿闈猥縮速諉違嗉夙委
衛	魏畏褽偽慰尉謂僞遺渭爲喂餵位未胃穌蔚味為	違葦帷崴緯薇圍唯煨猥桅諉逶鮪幃維威巍偎萎尾濰惟痿闈委危韋微洧娓偉為
札	紮閘炸扎	柵喳搾扎砟詐咋乍查搾眨炸渣吒蚱
偭	湎沔勉靦冕娩緬免	棉面綿麵眠
蜴	屹藝肄軼刈誼囈縊逸佾溢劓疫懿鎰毅義邑億液佚役易羿弋裔驛弈帟譯翌異益臆亦艾腋曳詣議意繹憶掖浥翳奕一抑翼衣	漪尾咦姨椅壹蟻飴旖誼偯迤栘移以彝夷已遺沂宜咿醫頤伊噫疑乙怡貽揖訑迆蛇矣圯胰儀一衣痍倚依
輳	湊	
蜓	庭亭婷廷停霆	汀梃廳聽挺艇
粟	溯嗉訴塑速縮蓿宿素夙肅簌	囌酥蘇俗甦穌
仙	鮮纖掀先祆秈暹姍	莧陷限賢獻閒蘚涎鮮霰嫻銑險線蜆顯癬嫌弦啣閑腺羨絃餡僩銜鹹舷憲現峴縣
鉼	丙柄秉屏稟餅炳	病兵併並摒並冰
恩	嗯	
幛	脹丈障賬長仗漲帳杖瘴	長獐掌漳漲蟑樟彰章璋張
載	宰仔在再	宰栽災仔再哉在
柝	唾拓	陀跎沱妥託馱脫橢鴕佗拖駝託
掏	韜絛饕濤滔	檮逃討桃燾啕淘洮陶萄套濤
匕	鄙筆沘比妣彼	庇埤幣裨箄襞篦蔽鄙必弊斃比蹕逼碧詖鉍賁陛避畢壁嗶闢璧臂敝痺愎泌睥婢薜鼻閉祕弼俾
鐃	撓呶橈	瑙惱鬧腦
矩	莒齟沮咀舉	橘拒拘菊懼鋸巨炬颶鞠居遽跼疽倨劇苣桔屨局句具鉅聚踞駒狙蛆車據沮掬瞿距足侷俱
凍	胴動恫洞棟	東董咚冬懂鼕
寤	戊晤惡騖物勿悟塢霧兀誤務軏鎢堊	武汙鵡巫侮吾亡誣無吳午五烏毋伍惡嗚鼯嫵於唔憮屋舞圬鎢捂污梧蕪蜈
跎	馱陀沱鴕佗駝	唾脫橢拖柝妥託拓託
刈	屹藝肄軼誼囈縊逸佾溢劓疫懿鎰毅義邑億液佚役易羿弋裔蜴驛弈帟譯翌異益臆腋亦艾曳詣議意繹憶掖浥翳奕一抑翼衣	漪尾咦姨椅壹蟻飴旖誼偯迤栘移以彝夷已遺沂宜咿醫頤伊噫疑乙怡貽揖訑迆蛇矣圯胰儀一衣痍倚依
愧	餽簣匱喟潰	虧揆盔魁葵奎夔逵睽窺傀
線	莧陷霰憲腺限羨現獻峴蜆餡僩縣	賢蘚閒祆秈暹涎鮮纖先嫻銑險仙蜆顯癬嫌弦啣閑絃掀銜鹹舷姍
斃	庇埤幣裨箄襞篦蔽鄙必弊比蹕碧詖鉍賁陛避畢壁嗶闢璧臂敝痺愎泌睥婢薜閉祕弼俾	逼鄙匕筆鼻沘比妣彼
箠	陲垂捶槌錘椎綞鎚	炊吹
縫	俸諷逢馮鳳奉	豐馮諷逢俸峯風鋒楓封蜂烽瘋鳳奉
訟	頌誦送宋	淞崧悚慫嵩忪鬆聳
闕	缺闋鵲殼確雀榷恪怯卻	缺瘸闋鵲殼確雀榷恪怯卻
鐳	累擂嫘縲羸雷	磊累壘擂類儡漯淚蕾耒勒
琉	榴瘤泵留劉瀏硫流遛	餾霤六陸溜鉚柳
罌	纓應嬰瑛英鷹嚶鶯瓔櫻膺鸚	瑩景郢迎營映贏盈熒應縈嬴穎塋楹蠅瀛硬影螢
樵	譙瞧憔僑喬橋翹	巧鞘俏雀蹺敲撬悄誚橇愀鍬鵲殼竅翹峭
聲	笙牲昇陞甥勝生升	賸省繩乘剩澠勝聖盛
泖	茆卯	貿帽瑁貓耄冒矛懋髦錨貌毛茅茂
抒	輸舒橾梳書蔬樞殊疏	鼠漱黍庶束署戍曙數薯術贖菽述暑叔淑恕蜀藷疏塾屬墅豎樹倏熟孰
採	踩睬采菜綵彩蔡	踩睬猜採纔材采才菜綵財裁彩蔡
答	靼躂搭達瘩褡韃怛	大靼躂搭打達瘩褡韃怛
徙	鰓喜璽洗	細悉禧行谿羲繫席嬉晰蟋惜昔吸釐唏曦隙希褶蹊稀淅溪襲矽習畦奚係翕犧譆熙夕攜烯析西蓆熄兮檄嘻僖蜥晞棲息錫系媳膝汐戲犀熹潟歙
喝	訶賀鶴赫暍郝嚇荷和呵	褐劾訶曷荷禾郃何賀鶴郝嗑嚇河閤呵閡涸赫闔暍盒盍翮核合紇貉和蓋
瀨	睞癩籟賴	徠來萊
厄	愕詻鱷遏俄軛啞噩惡呃鍔顎扼鄂餓堊萼	額俄蛾哦婀訛娥阿峨鵝蚵
暹	秈纖祆姍掀鮮先仙	僩峴餡涎顯限嫌莧銑舷銜啣鹹癬現霰險嫻腺閒鮮閑絃羨鹹憲獻弦蜆陷縣線賢蘚
累	擂雷壘淚耒漯儡嫘縲羸蕾鐳磊類	擂雷壘淚耒漯儡嫘縲羸蕾勒鐳磊類
圍	薇違唯濰桅惟幃維帷闈危巍爲韋微為	葦魏畏褽偽崴慰緯尉猥諉煨謂逶鮪僞遺渭威偎萎喂尾餵痿未位委胃洧穌蔚衛味娓偉為
奪	鐸多	度惰踱舵朵躲咄跺多剁墮馱
徘	排牌俳	派拍湃啪
妁	數碩勺鑠蟀朔爍帥率	說
蟠	盤蹣般胖槃磐踫	叛拚潘判盼攀畔
翠	淬粹悴萃瘁橇脆	衰摧催璀崔
彝	咦姨飴疑怡貽誼訑迤蛇栘移夷遺沂圯胰儀宜一痍頤	漪蟻藝屹肄軼刈誼囈迤縊以逸佾已溢劓醫疫噫乙懿鎰毅揖義迆邑億液役佚易羿倚尾弋裔蜴椅壹驛弈旖譯帟翌異益偯臆亦艾腋曳咿議詣意伊繹憶掖浥翳矣奕一翼抑衣依
嘮	癆勞牢	佬酪絡烙撈姥老勞
阱	景井憬警璟頸	靜競精荊淨兢京旌敬經粳勁菁驚痙涇晶鏡鯨睛莖竟更徑逕靖境
幔	鏝曼縵漫蔓慢	饅鰻屘蹣漫蠻瞞滿
濟	霽髻寄脊際繼繫稷擠薺技記忌騎悸覬己劑紀季給計祭戟麂妓驥鯽幾芰暨洎薊系冀躋既	霽寄擊忌騎悸己藉紀瘠計圾籍畸洎璣磯飢既躋唧脊楫居績稷譏羈覬劑吃季借稽祭麂蹟驥鯽幾集犄姬際伋吉薺饑機及乩亟奇棘箕妓嵇其芰戢雞基薊冀急髻疾跡繼寂即繫屐擠技記激嫉汲積岌給級嘰戟輯癘肌期暨極畿勣
召	櫂少哨詔釗趙炤邵罩紹肇朝嘲昭着兆照晁棹著招	櫂少捎詔釗趙杓炤找罩韶肇沼朝爪勺嘲稍昭兆芍燒梢照晁棹著招
閥	罰法筏伐乏砝	法琺伐髮發
野	也冶	椰葉耶噎業曄射頁謁鄴靨夜咽爺拽琊
挈	契妾竊切愜怯鍥	伽切茄且
稜	蔆楞	愣冷楞
停	庭蜓亭婷廷霆	汀梃廳聽挺艇
胖	踫磐般蹣蟠盤槃	膀旁畔拚潘螃滂乓徬磅龐叛攀判盼
凜	懍	鄰吝藺林淋痳遴燐轔賃琳磷躪鱗霖臨麟璘
箔	荸搏帛蔔駁伯博檗脖勃白鈸膊鉑泊舶柏渤薄	玻撥亳般簸薜播檗菠蘗跛缽剝擘薄
謂	魏畏褽偽慰尉僞遺渭爲喂餵位未胃穌蔚衛味為	違葦帷崴緯薇圍唯煨猥桅諉逶鮪幃維威巍偎萎尾濰惟痿闈委危韋微洧娓偉為
秀	袖溴岫繡臭嗅宿鏽	咻脩休朽宿羞修
冑	胄晝宙咒縐籀皺紂	粥軸帚舟妯周肘啁週洲州
催	衰崔摧	淬粹悴萃璀瘁橇翠脆
山	芟扇衫羶跚縿煽珊潸姍刪舢杉	汕善擅繕單扇陝訕膳疝禪煽贍鱔閃
拈	輦碾攆輾撚捻涊	念唸黏廿年
誼	儀劓羿詣飴怡浥異益議藝軼咦刈意鎰姨縊痍胰肄逸頤憶遺抑移艾佚毅蛇翌奕衣佾夷億役翳圯彝懿一掖屹易沂裔弈繹栘液弋迤帟邑貽腋曳溢臆翼亦囈訑蜴驛宜義譯疑疫	劓羿浥益藝軼鎰姨痍肄頤憶遺矣佚翌伊夷一屹栘貽溢臆囈訑疑偯咿揖議意刈依以噫移乙蛇役圯億蟻沂繹弋迤腋毅譯儀詣怡咦縊逸抑漪彝懿壹醫倚液帟翼義疫飴異迆胰艾奕衣佾尾翳已掖易裔旖邑曳椅亦蜴驛宜弈
厥	鴃掘鱖抉決獗譎蹶劂腳倔玨角攫爵孓崛觼覺蕨訣絕嚼噱	倔蹶嗟
妯	軸	胄帚周縐冑紂粥舟宙晝咒肘啁籀皺週州洲
附	富父復覆阜駙複傅咐訃腹賦賻副婦付負馥赴	孚拂斧夫芙敷莆父袱腐蝠菔氟腑撫符幅輔服鈇俯釜扶甫膚芾輻伏俘匐彿頫伕紼脯縛府浮涪趺福弗怫孵麩紱
屈	蛐嶇區曲趨瞿圈驅砠軀蛆	趣劬取漆曲麴齲瞿渠娶衢璩去
銀	淫齦垠夤吟鄞簷寅霪	蔭聽殷印胤尹因癮飲湮隱陰慇氤姻蚓縯引音茵
特	慝	
成	呈懲誠承丞橙乘城程盛澄	騁秤逞瞠撐稱
藻	蚤澡棗早	竈造噪皁譟躁糟鑿遭燥
薰	燻勛醺勳	汛殉潯巡徇循潠迅訓遜馴訊尋詢璿洵荀巽蕈旬
曳	屹藝肄軼刈誼囈縊逸佾溢劓疫懿鎰毅義邑億液佚役易羿弋裔蜴驛弈帟譯翌異益臆腋亦艾詣議意繹憶掖浥翳奕一抑翼衣	漪尾咦姨椅壹蟻飴旖誼偯迤栘移以彝夷已遺沂宜咿醫頤伊噫疑乙怡貽揖訑迆蛇矣圯胰儀一衣痍倚依
內		哪餒
租		卒俎組嗾祖阻族詛足
極	急唧疾脊即寂楫伋吉擊及嫉汲亟岌藉吃瘠借棘圾級籍輯戢集	唧霽髻寄脊跡際繼冀繫屐居績稷擠犄薺饑譏技記忌羈騎機乩激積覬己悸劑紀季奇給稽既箕計嘰祭戟麂妓蹟躋驥濟鯽畸嵇幾其肌芰期飢癘雞暨洎璣基薊系磯畿姬勣
劃	樺話華猾滑畫劃化嘩豁譁	樺話花華猾滑畫劃化嘩豁譁
琥	唬許虎	瓠壺鬍蝴鵠斛惚戲呼戶滬沍楛護狐互胡湖囫葫扈弧瑚乎忽糊
住	助薴駐箸祝註注蛀柱佇鑄杼	諸逐軸朱躅茱硃渚拄蛛誅術主囑珠豬築朮貯竺侏藷屬煮燭矚株銖竹
遑	韹湟隍磺蝗皇徨凰篁簧黃璜煌惶	幌肓謊洸荒慌晃恍
芙	孚拂夫袱蝠菔氟符幅服扶芾輻伏俘匐彿紼縛浮涪福弗怫紱	富斧夫敷莆父復腐覆阜腑撫駙複輔傅鈇俯釜甫膚咐訃附腹賦賻副頫婦伕脯府付趺孵麩負馥赴
謀	眸牟繆	某
靈	綾零蛉櫺昤菱鴒泠羚玲鈴苓伶齡聆陵凌翎	拎令另嶺領
果	猓槨裹	幗鍋蟈郭摑過堝國
針	禎榛箴斟真診偵砧貞珍楨甄臻	賑鎮疹鴆陣枕振朕診娠震縝
攸	幽悠優憂	遊黝由牖郵友疣莠又尤幼猶猷遊鼬誘宥油右柚祐鈾有侑酉囿佑魷釉
坍	貪探灘攤癱	曇毯覃炭袒痰潭罈彈歎碳嘆譚談探檀坦壇
奩	簾聯蓮簾鰱濂連漣憐鐮廉	鍊戀殮瀲斂練煉鏈楝臉
鯧	倀猖倡昌娼	常場長暢裳腸倡敞萇償唱嚐廠嫦悵氅徜嘗
外		舀歪
憶	詣劓羿浥異益議藝軼意刈鎰縊肄逸抑艾佚奕翌衣佾誼億役翳懿一掖屹易裔繹液弋帟邑腋曳溢臆翼亦囈蜴驛毅義譯弈疫	咿儀揖怡飴咦依姨迆痍胰頤以遺噫移乙矣蛇衣伊夷誼尾漪圯蟻彝已壹一醫沂旖栘倚迤貽椅訑宜疑偯
險	鮮銑蘚蜆顯癬	莧陷限賢獻閒祆秈暹涎鮮纖霰先嫻線仙蜆嫌弦啣閑腺羨絃餡僩掀銜鹹舷憲現峴姍縣
滅	篾蔑	咩羋
原	沅轅垣圓爰緣湲袁園援元騵源媛員猿	怨院鳶苑宛鴛願淵遠冤媛
祇	歧止琪齊琦耆棋氏芷騎祺脂址祁肢期祉祈枝支紙之祗芝錡其淇旗梔織咫泜麒胝臍汁畦鰭吱崎圻奇岐衹蜘知徵隻趾只指卮旨	幟止氏脂執乞祉枝漆迄紙質之祗誌氣稚植織萋咫痣欺汁置汽痔柒企製稽躑蜘躓直悽擲知契炙只憩趾職旨砌七雉秩蛭志芷妻值溪豈綺址磧棄肢啟器峙棲訖治慼支起制芝姪愒窒梔泜淒智緻胝滯吱致杞摭至摯谿輊亟泣識徵隻指戚卮緝殖
蛞	括擴闊廓	
從	樅聰綜糉囪匆蔥縱叢淙	鬃樅聰綜囪匆總縱蔥棕宗叢蹤傯淙
薹	颱苔擡檯跆臺臺	泰苔汰態胎太
咫	芷徵止紙趾祇只指祉旨址	雉秩幟蛭志氏脂值肢執祇峙枝治支制質祗之芝誌姪稚窒植織梔泜痣智緻胝滯汁吱致置痔摭至摯製輊躑躓蜘直擲識知隻炙只職卮殖
淇	歧其琪旗齊琦耆麒棋騎祺臍畦鰭祁崎圻奇岐衹祇期祈枝錡	愒萋淒妻欺溪豈綺磧棄杞乞汽啟柒器棲企訖谿稽漆慼亟迄悽泣起契憩戚砌七緝氣
侈	尺呎齒恥褫	飭喫遲赤癡弛叱踟匙斥持馳池翅魑吃敕栘蚩啻笞熾墀嗤
燭	軸術築朮躅竺逐竹	諸朱蛀茱鑄硃渚助拄箸誅注主囑珠豬薴祝貯柱杼侏藷屬煮駐註矚佇株銖蛛住
兩	倆魎	亮輛良糧粱量晾諒涼樑
止	趾紙芷徵址咫指只旨祉祇	智制脂植痔梔直致摭之製蛭躓質窒雉芝泜值胝躑枝吱峙祇幟肢支擲稚執祗職炙痣識汁置輊只至殖織卮滯隻蜘秩摯知姪氏緻治志誌
吶	鈉那納訥捺娜	拿哪那
訑	咦姨飴疑怡貽誼迤蛇栘移彝夷遺沂圯胰儀宜一痍頤	漪蟻藝屹肄軼刈誼囈迤縊以逸佾已溢劓醫疫噫乙懿鎰毅揖義迆邑億液役佚易羿倚尾弋裔蜴椅壹驛弈旖譯帟翌異益偯臆亦艾腋曳咿議詣意伊繹憶掖浥翳矣奕一翼抑衣依
磬	慶罄親	青卿擎情蜻傾輕鯖氫晴檠頃請清
蹼	莆葡脯蒲菩濮璞樸僕釙匍樸	普埔鋪浦誧僕溥暴撲撲譜瀑圃曝噗
終	忠鐘盅忪衷鍾中	湩種仲重衆腫眾中塚踵
嫂	掃	艘掃繅騷搔
墨	膜末貊莫磨陌默驀沫秣脈茉寞漠沒歿	膜抹蘑摩摸磨模糢謨魔摹麼
袂	媚妹沬瑁魅寐昧	楣每沒莓枚媒美黴眉玫鎂煤梅湄黴
崴	威煨逶萎偎委	尾娓魏衛胃蔚維痿緯萎未韋唯遺惟渭濰圍桅為味穌薇餵幃偽葦慰位危偉洧謂帷鮪微巍褽尉喂闈畏猥諉違委
甜	闐田恬畋填	腆忝添靦天舔
罄	磬慶親	青卿擎情蜻傾輕鯖氫晴檠頃請清
撫	脯腑斧府輔莆父俯釜腐頫甫	孚富拂夫芙敷父復袱蝠菔氟覆阜駙符複幅服馥傅鈇扶咐膚芾訃附輻腹俘賦伏匐賻彿副婦伕紼縛付涪浮趺福弗怫孵負麩紱赴
銓	蜷卷詮犬踡佺荃全權痊泉拳	圈甽犬勸畎券
吒	乍搾柵炸搾詐砟蚱咋	紮查閘眨炸喳札扎渣
振	賑鎮鴆陣枕朕娠震	疹禎榛枕斟箴真診偵砧貞針珍甄楨縝臻
奄	湮殷煙醃淹菸厭咽嫣燕胭焉	釅言雁宴兗演研艷硯嚥鹽顏咽巖厭贗簷閻沿眼彥諺偃魘驗堰郾焰延儼筵燄燕嚴炎唁淹衍豔妍鼴饜掩癌晏
砟	昨乍作搾柵炸搾詐吒蚱咋	紮閘喳左扎柞坐查眨作座炸札鑿做祚渣佐
徐		咻訏墟卹婿序需許洫胥煦虛恤緒酗畜絮頊籲鬚噓栩須續戌蓄敘旭勗
傢	嘉痂袈茄夾加豭葭佳家迦	架假夏鉀頰稼甲挾駕價浹賈莢戛夾嫁胛
糙	操	操嘈漕曹草槽
魘	鼴衍掩偃兗眼儼郾演	豔閻癌堰焰諺菸雁簷驗湮醃贗咽艷殷硯巖炎晏延研妍嚥奄彥煙簷胭沿燕鹽醃饜顏釅筵巖厭嚴淹燄言焉嫣宴唁
存		寸皴村吋忖
唳	慄儷麗礫礪痢歷靂力慄立溧蒞癘壢戾曆琍吏笠粒例利厲釙荔欐俐酈隸蠣勵瀝鬲莉	禮喱澧醴麗犁哩鯉犛貍籬黎娌璃浬釐離理驪邐李鋰梨狸裡罹裡漓蠡蜊俚
諄	肫屯	準
咳	卡慨嗨愾愒殼	氦科孩顆軻骸坷喀剋慨嗨豈刻克苛凱恪嗑亥蝌髁磕緙柯稞蚵棵哈開害可揩課咖駭渴楷窠愷海瞌溘客剴還
岸	按菴暗黯案	鞍庵安鵪俺諳銨氨
佇	鑄住箸杼助註薴駐柱蛀注祝	主軸築朱諸茱矚銖囑朮築屬燭煮渚竹竺拄藷侏硃誅蛛貯躅逐豬珠株
伶	綾零蛉櫺昤菱鴒泠靈羚玲鈴苓齡聆陵凌翎	拎令另嶺領
污	屋嗚鎢巫惡於汙烏圬誣	無巫毋勿騖寤軏梧嫵誤惡舞物堊吾兀誣務鎢悟塢霧吳五侮鼯蕪捂鵡憮晤戊蜈午亡武伍唔
柳	鉚	榴瘤泵餾劉留霤六瀏硫溜陸琉流遛
混	渾魂輥餛琿	渾魂輥餛葷昏琿婚
拼	姘	貧頻顰嬪瀕聘品牝
貓		冒茅茆瑁卯泖髦懋貌毛茂耄貿矛錨帽
睽	夔葵魁揆奎逵	匱愧窺盔餽虧喟傀簣潰
戍	束數庶樹倏術恕述墅漱豎疏署曙	叔橾塾菽淑贖黍屬書輸熟殊數鼠藷樞梳暑孰蜀薯抒疏署蔬舒
撰	篆傳轉僎賺	耑磚囀轉顓專
鳶	宛淵冤鴛	緣院源媛員願原轅願園圓援騵怨猿遠湲元爰袁苑沅垣
懾	蜇哲折摺摘輒謫轍褶	浙遮這著蔗螫赭鷓者宅
殲	縑肩間韉濺奸尖煎兼姦漸湔堅艱菅監緘箋	餞澗鑒劍儉閒毽減諫箭僭踐柬艦件健建撿簡瞼揀筧間檻繭見剪鹼檢監賤濺薦腱囝漸鑑鍵
她	他牠它塌	遝塔漯榻蹋踏獺遢塌躂撻
析	悉禧行谿羲嬉晰釐蟋吸唏曦希蹊稀淅溪畦奚犧譆熙攜烯西兮嘻僖蜥晞棲膝犀熹	細繫席昔惜洗隙褶襲矽習鰓翕係夕蓆熄檄璽息汐系媳錫戲潟徙喜歙
帟	屹藝肄軼刈誼囈縊逸佾溢劓疫懿鎰毅義邑億液佚役易羿弋裔蜴驛弈譯翌異益臆腋亦艾曳詣議意繹憶掖浥翳奕一抑翼衣	漪尾咦姨椅壹蟻飴旖誼偯迤栘移以彝夷已遺沂宜咿醫頤伊噫疑乙怡貽揖訑迆蛇矣圯胰儀一衣痍倚依
杪	緲渺邈秒杳藐眇	描瞄妙苗繆廟
乞	綺起杞啟稽啓豈	器憩旗淒祈谿悽琦琪汽耆麒企漆錡臍慼齊磧泣祁騎溪亟砌欺枝祇契棋畦奇訖戚迄柒崎淇緝七隻祺其期棄圻棲衹氣愒歧岐萋鰭妻
浮	孚拂夫芙袱蝠菔氟符幅服扶芾輻伏俘匐彿紼縛涪福弗怫紱	富斧夫敷莆父復腐覆阜腑撫駙複輔傅鈇俯釜甫膚咐訃附腹賦賻副頫婦伕脯府付趺孵麩負馥赴
粗		卒醋趣鏃促趨錯簇槭蹙蹴
爆	抱鉋刨報鑤豹鮑暴	葆包雹胞飽薄褓堡保褒寶苞
殉	迅徇潠汛巽遜訊馴蕈訓	徇循潯勛尋醺燻勳旬洵璿詢巡荀薰馴
越	曜粵刖悅玥藥說耀月躍軏樂鑰籥嶽閱	約曰
杵	褚處儲礎楚楮	矗齣出畜黜鋤儲除絀跦廚怵雛處櫥歜躇觸初芻
蒐	搜餿颼	叟藪擻嗽嗾
琦	歧淇其琪旗齊耆麒棋騎祺臍畦鰭祁崎圻奇岐衹祇期祈枝錡	愒萋淒妻欺溪豈綺磧棄杞乞汽啟柒器棲企訖谿稽漆慼亟迄悽泣起契憩戚砌七緝氣
悵	暢倡唱	常場長裳倀腸昌倡猖鯧敞萇償娼嚐廠嫦氅徜嘗
鄉	向廂瓖橡鑲象香箱湘巷像項襄嚮相	橡香餉翔嚮相向象饗詳降廂鑲響祥像瓖箱湘巷庠想項襄享
軌	詭晷鬼癸	龜皈桂鱖歸跪閨貴鮭規圭珪瑰傀櫃
頒	搬斑扳般瘢班	半姅舨版板阪伴辦扮瓣絆鈑闆拌
勻	耘筠昀紜芸雲	允醞隕氳韻慍暈蘊運員熨孕
市	室恃螫筮奭勢嗜舐豉士事仕拭識試世釋柿逝是適侍示飾軾誓弒氏式噬使視	濕詩十施屎師史匙提矢射食碩拾蝕駛塒屍噓時什溼豕獅失始蝨實石使
款	梡	髖寬
嫉	急唧疾脊即寂楫伋吉擊及汲亟岌藉吃瘠借棘圾級籍輯戢集極	唧霽髻寄脊跡際繼冀繫屐居績稷擠犄薺饑譏技記忌羈騎機乩激積覬己悸劑紀季奇給稽既箕計嘰祭戟麂妓蹟躋驥濟鯽畸嵇幾其肌芰期飢癘雞暨洎璣基薊系磯畿姬勣
顯	鮮銑險蘚蜆癬	莧陷限賢獻閒祆秈暹涎鮮纖霰先嫻線仙蜆嫌弦啣閑腺羨絃餡僩掀銜鹹舷憲現峴姍縣
篆	賺撰僎轉傳	磚囀專耑轉顓
躲	朵	度惰奪踱舵朵咄跺鐸多剁墮馱
豹	抱鉋刨報鑤爆鮑暴	葆包雹胞飽薄褓堡保褒寶苞
蒸	癥諍爭徵丁猙掙箏怔睜崢錚症正	政整拯掙幀証鄭證症正
尚	上	湯觴晌裳殤賞上商傷
浹	莢戛頰夾挾	嘉架假夏鉀加葭稼傢甲迦駕價痂賈袈夾茄豭嫁佳胛家
羌	鎗槍嗆將鏘搶腔	牆嗆彊戕繈檣搶薔強
縣	莧陷限獻懸霰漩線蜆旋玄腺羨璿餡僩憲現峴還	選晅賢萱蘚閒祆秈暹絢涎鮮纖先嫻銑險渲漩仙炫蜆顯旋壎癬嫌弦啣閑眩煖絃鉉宣暄掀銜鹹舷諼喧姍軒
彊	牆匠戕絳檣將醬降薔強	鎗槍江鏘腔薑羌疆蔣嗆漿講繈姜槳將搶獎韁僵強
匹	否批劈披丕痞被疋壞仳紕霹鈹	啤媲埤劈陂脾裨屁琵僻枇癖疲壞仳紕霹被譬陴披鼙鈹闢否批毗丕沘痞疋罷皮
砠	趨嶇屈圈曲區蛐軀驅瞿蛆	去娶劬取趣麴瞿璩漆齲曲渠衢
曆	慄儷麗礫礪唳痢歷靂力慄立溧蒞癘壢戾琍吏笠粒例利厲釙荔欐俐酈隸蠣勵瀝鬲莉	禮喱澧醴麗犁哩鯉犛貍籬黎娌璃浬釐離理驪邐李鋰梨狸裡罹裡漓蠡蜊俚
鬱	芋與馭御喻育瘉寓禺尉癒諭郁玉澦煜語欲谷裕昱愈聿峪嫗籲預豫域獄毓遇熨堉慾譽禦浴俞燠	與敔魚諛宇雨雩竽禹予余愚禺虞迂齬蝓噢盂圉逾褕圩榆渝語萸漁瑜庾輿嶼歟於腴紆妤隅愉覦羽臾餘淤瘀圄俞娛
舞	嫵午五侮武捂伍鵡憮	無巫毋勿騖寤軏圬屋梧誤惡物汙堊烏吾兀誣務鎢塢悟霧吳鼯於蕪晤嗚戊蜈亡污唔
舍	社赦射葉拾涉攝設	甚舌什奢蛇賒社攝甚舌什奢射蛇葉拾涉賒赦設
訝	亞軋氬	啞鴨亞疋蚜衙涯牙煆雅鴉押呀丫壓芽
暈	醞氳韻慍蘊運員熨孕	勻允耘醞氳筠隕韻昀慍紜蘊芸雲運員熨孕
扶	孚拂夫芙袱蝠菔氟符幅服芾輻伏俘匐彿紼縛浮涪福弗怫紱	富斧夫敷莆父復腐覆阜腑撫駙複輔傅鈇俯釜甫膚咐訃附腹賦賻副頫婦伕脯府付趺孵麩負馥赴
己	幾給脊戟麂濟擠	霽寄擊忌騎悸藉紀瘠計圾籍畸洎璣磯飢既躋唧脊楫居績稷譏羈覬劑吃季借稽祭蹟驥鯽幾集犄姬際伋吉薺饑機及乩亟奇棘箕妓濟嵇其芰戢雞基薊系冀急髻疾跡繼寂即繫屐技記激嫉汲積岌級嘰輯癘肌期暨極畿勣
葡	蒲菩璞脯濮莆樸匍釙蹼僕	撲普噗曝溥瀑圃鋪暴浦誧埔譜僕
皆	街階偕結接嗟揭	睫傑節櫛芥竭姐潔捷姊頡疥擷戒結桔孑藉羯桀借劫拮碣界解訐介屆詰誡截
昀	紜耘雲勻筠雲芸	韻允員孕熨運隕暈醞慍蘊氳
徨	韹湟隍磺蝗皇凰篁簧黃璜煌遑惶	幌肓謊洸荒慌晃恍
璣	畸姬畿其羈肌犄飢癘雞磯乩幾唧積箕幾奇譏激績期屐機嵇跡勣稽蹟基躋嘰居饑	洎棘疾暨忌祭集脊己騎藉芰劑幾記楫瘠覬紀計級極妓冀戢擊寄輯寂給薊及嫉際幾唧麂繼擠急伋薺吉季圾即稷髻霽技汲吃亟既悸躋籍繫岌濟鯽戟驥
噯	曖璦隘艾礙愛	哀藹埃捱唉靄矮皚挨哎
囁	涅鑷蘗齧鎳孽聶臬躡	捏
譽	芋與馭御喻育瘉寓禺鬱尉癒諭玉澦語煜欲谷裕昱愈聿峪嫗籲預豫浴域獄毓遇堉慾禦熨俞燠	與魚諛宇雨雩竽禹予愚禺虞迂齬蝓噢盂圉逾褕圩瘀榆渝語萸漁瑜庾輿嶼歟於腴紆妤隅圄愉羽臾餘淤覦敔俞娛
節	睫傑櫛竭潔捷頡擷結桔孑羯桀劫拮碣訐詰截	芥姐揭姊疥階戒結藉接皆借偕界嗟解介街屆誡
環	洹澴鍰桓梡寰還	幻宦豢皖煥患奐緩梡渙喚瘓歡換
訴	溯嗉塑速縮粟蓿宿素夙肅簌	囌酥蘇俗甦穌
撩	聊嘹潦寥寮繚遼燎僚療	聊嘹潦料寥暸寮了繚遼燎僚療瞭廖
祈	旗琦琪麒耆錡臍齊祁騎枝祇棋畦奇只崎淇其祺期圻衹歧岐鰭	器憩啟淒谿豈悽企汽漆杞起慼磧泣溪亟砌欺契稽訖戚啓迄柒緝七綺棄乞棲氣愒萋妻
兢	晶鯨睛莖京更精荊經粳菁驚旌涇	靜競井淨警敬勁痙頸鏡阱憬璟竟景徑逕靖境
珊	芟扇衫羶跚縿山煽潸姍刪舢杉	汕善擅繕單扇陝訕膳疝禪煽贍鱔閃
蝦	瞎	霞呷狎柙瑕黠遐廈洽下嚇轄狹夏峽挾匣斜暇俠
睿	銳瑞	蕊
閱	曜越粵刖悅玥藥說耀月躍軏樂鑰籥嶽	約曰
凱	愷慨豈剴楷	咳開慨愾揩愒
紹	邵少哨召	少捎韶杓燒芍梢勺稍
瀆	髑櫝讀犢黷牘毒獨	杜蠹堵睹篤賭度鍍嘟渡肚都督妒
轎	教校醮窖叫覺較	攪礁澆矯嚼餃焦跤蕉嬌狡教剿椒交郊較勦鉸腳僥絞膠繳蛟鮫驕姣詨皎角
劣	冽列裂捩鬣獵烈洌	咧
楨	禎診貞真針斟臻珍砧偵榛甄箴	震陣娠鴆診枕縝鎮朕賑振疹
麓	路露鹿戮僇碌氯鷺陸錄穋祿賂	蘆滷盧魯鹵擄臚鑪櫓鱸顱爐嚕廬虜瀘
廟	妙繆	緲杪苗藐描杳瞄渺邈眇秒
集	急唧疾脊即寂楫伋吉擊及嫉汲亟岌藉吃瘠借棘圾級籍輯戢極	唧霽髻寄脊跡際繼冀繫屐居績稷擠犄薺饑譏技記忌羈騎機乩激積覬己悸劑紀季奇給稽既箕計嘰祭戟麂妓蹟躋驥濟鯽畸嵇幾其肌芰期飢癘雞暨洎璣基薊系磯畿姬勣
舌	甚蛇什	社攝捨涉葉舍拾射設歙賒麝奢赦
鬼	詭晷軌癸	龜皈桂鱖歸跪閨貴鮭規圭珪瑰傀櫃
石	十淡提蛋射啖食碩拾誕蝕憚彈啗塒時擔什氮但澹旦實	濕詩室撢恃施螫視屎筮師史匙奭勢嗜舐豉矢市士膽丹事仕拭簞識耽試世釋柿逝是駛適噓屍侍擔單示飾豕軾溼獅失誓弒始氏式蝨噬使疸
鈸	搏荸帛跋蔔駁伯博檗脖勃白膊鉑泊舶拔柏渤箔薄	亳般簸薜笆伯杷吧芭耙菠疤壩跛巴剝擘八琶薄撥玻把靶播霸檗叭蘗扒缽捌爸罷灞
殺	莎沙曬煞鯊砂紗裟杉	廈煞傻霎骰篩
陂	疲脾皮沘埤波枇陴鈹罷紕琵毗坡潑啤鼙裨	劈醱破迫披譬仳鄱否魄樸僻壞剖婆癖泊珀批闢粕叵媲匹丕霹頗痞闢鈹屁被紕疋
淨	鏡靜敬競徑勁痙逕竟靖境	井精荊兢警旌京經粳菁驚頸涇晶鯨睛莖阱憬璟景更
員	醞湲運猿袁韻援原暈媛沅轅垣爰元慍騵蘊圓緣園源熨孕	院隕氳願遠紜勻鳶宛暈芸媛雲耘筠昀鴛淵怨允苑冤
哪	餒那	鈉內那納訥吶拿捺娜
匙	持馳墀池遲栘弛踟	喫恃施褫筮叱奭舐射拭魑試蚩逝侈啻噓侍飾軾獅恥始實噬使濕赤斥師史矢豉食吃碩敕蝕釋柿駛適塒尺豕失齒誓石蝨飭詩室癡屎提勢士翅仕拾識是笞示什溼弒氏視十螫嗜市呎事世屍時熾式嗤
輸	舒橾抒梳書蔬樞殊疏	鼠漱黍庶束署戍曙數薯術贖菽述暑叔淑恕蜀藷疏塾屬墅豎樹倏熟孰
蔽	庇埤幣裨箄襞篦鄙必弊斃比蹕碧詖鉍賁陛避畢壁嗶闢璧臂敝痺愎泌睥婢薜閉祕弼俾	逼鄙匕筆鼻沘比妣彼
羯	捷劫拮櫛桔截詰節訐傑竭桀睫擷孑結潔頡傑碣	姊階芥皆解街嗟戒揭疥界偕藉誡結姐借介接屆
籣	斕藍闌欄襤籃攔瀾嵐蘭婪	攬欖爛懶濫覽纜
堂	醣搪膛棠鏜螳瑭糖塘唐	淌湯趟帑倘鏜儻燙躺
織	脂梔之泜芝胝枝吱祇肢支祗汁只卮隻蜘知氏	智徵制植痔直致摭製蛭址躓質窒雉值躑擲峙祉幟祇趾稚執職炙痣識咫置輊只至殖滯紙芷止秩摯知姪指緻治志旨誌
翮	嗑合蓋河郃和紇闔盍核荷貉禾曷劾盒閡何褐閤涸	嚇郝和訶喝鶴賀暍荷赫呵
軟	阮蠕	
凋	刁叼彫碉鯛貂雕	掉釣吊調弔
圻	歧淇其琪旗齊琦耆麒棋騎祺臍畦鰭祁崎奇岐衹祇期祈枝錡	愒萋淒妻欺溪豈綺磧棄杞乞汽啟柒器棲企訖谿稽漆慼亟迄悽泣起契憩戚砌七緝氣
翼	詣劓羿浥異益議藝軼意刈鎰縊肄逸憶抑艾佚奕翌衣佾誼億役翳懿一掖屹易裔繹液弋帟邑腋曳溢臆亦囈蜴驛毅義譯弈疫	咿儀揖怡飴咦依姨迆痍胰頤以遺噫移乙矣蛇衣伊夷誼尾漪圯蟻彝已壹一醫沂旖栘倚迤貽椅訑宜疑偯
闖	愴搶創	撞牀窗瘡囪創搶愴幢
薊	洎暨寄忌祭騎芰際劑繼薺記季稷髻霽技紀覬既悸計躋繫濟妓鯽驥冀	棘璣羈疾肌集脊己藉雞磯乩積幾績期屐機楫瘠嵇跡蹟基級極居戢畸姬畿其擊輯寂給犄飢及嫉癘幾唧箕麂擠急伋奇吉譏激圾即汲勣稽吃亟躋籍岌嘰濟戟饑
愴	創闖	創瘡撞闖牀搶窗囪幢
琿	餛混渾魂	葷輥混昏渾婚
瞭	廖燎了暸料	寮廖繚聊潦寥撩料療遼僚嘹燎了暸
異	詣劓羿浥益議藝軼意刈鎰縊肄逸憶抑艾佚奕翌衣佾誼億役翳懿一掖屹易裔繹液弋帟邑腋曳溢臆翼亦囈蜴驛毅義譯弈疫	咿儀揖怡飴咦依姨迆痍胰頤以遺噫移乙矣蛇衣伊夷誼尾漪圯蟻彝已壹一醫沂旖栘倚迤貽椅訑宜疑偯
跡	唧畿屐居績犄饑譏羈激機乩積奇稽箕嘰躋蹟畸嵇其癘肌幾期雞璣基磯飢姬勣	急唧霽髻疾脊寄際繼寂即繫楫伋稷擠吉薺技記擊忌騎及悸嫉汲覬己亟藉劑岌紀吃季瘠給借棘計級祭圾戟麂妓驥籍濟鯽輯幾芰戢集暨洎極薊系冀躋既
雕	叼凋鯛彫碉貂刁	釣調掉弔吊
矇	甍蒙檬盟虻朦萌懵濛	艋蜢夢孟猛懵錳
謹	饉覲儘僅瑾盡緊錦	金噤浸晉覲勁縉矜津燼禁斤襟今觔巾僅盡儘近筋進
桓	還環澴洹鍰梡寰	渙幻歡換緩喚宦患奐豢皖煥瘓梡
笑	校嘯傚酵孝肖效	梟銷瀟霄小削蕭哮簫曉嘐硝囂學宵逍消驍篠
新	心薪訢莘昕鋅辛芯馨欣	信釁尋芯
晝	縐胄咒紂冑籀皺宙	妯啁州軸帚洲肘週周粥舟
懣	燜悶	們悶門捫
狸	罹麗蠡犁璃貍漓蜊喱梨籬犛驪離釐黎	裏荔琍儷利厲痢例欐莉曆醴礫李勵鯉瀝慄禮隸理浬蒞釙蠣靂俚立粒礪壢唳力邐娌俐戾澧吏麗蠡鬲溧癘鋰笠裡哩歷酈
鏤	瘺露漏陋	樓簍摟嘍婁螻髏
蹬	凳嶝磴瞪鄧	等登燈
廷	庭蜓亭婷停霆	汀梃廳聽挺艇
愕	啞鄂軛惡俄萼厄堊顎餓詻呃噩遏扼鱷鍔	哦蛾蚵俄娥峨鵝婀阿訛額
鷹	瑛嚶英瓔嬰鸚鶯應膺櫻纓罌	穎盈楹迎應嬴熒螢贏營映瑩縈膺瀛蠅郢景塋硬影
蔚	魏畏褽偽慰尉謂僞遺渭爲喂餵位未胃穌衛味為	違葦帷崴緯薇圍唯煨猥桅諉逶鮪幃維威巍偎萎尾濰惟痿闈委危韋微洧娓偉為
睪	篙羔糕高皋膏	搞誥告攪縞槁杲稿
站	棧綻湛暫佔蘸顫戰	斬嶄沾瞻展盞輾霑佔詹譫氈
飽	葆褓堡保寶	抱鉋刨雹包報胞薄鑤豹爆褒苞鮑暴
膝	悉禧行谿羲嬉晰釐蟋吸唏曦希蹊稀淅溪畦奚犧譆熙攜烯西析兮嘻僖蜥晞棲犀熹	細繫席昔惜洗隙褶襲矽習鰓翕係夕蓆熄檄璽息汐系媳錫戲潟徙喜歙
唔	吾亡誣無毋鼯梧巫吳蕪蜈	武汙鵡晤騖巫侮悟塢誤誣務午五烏伍寤戊惡嗚嫵於物勿憮霧屋舞兀圬鎢捂軏污堊
髁	嗑可課喀緙克刻溘恪客剋	軻坷稞棵渴磕可咳殼窠柯科刻顆苛蚵瞌蝌
輟	啜綽齪	戳
保	葆飽褓堡寶	抱鉋刨雹包報胞薄鑤豹爆褒苞鮑暴
歎	炭探碳嘆	毯覃曇袒痰潭罈彈譚貪坍談探灘攤檀坦癱壇
數	鼠漱黍庶束署戍曙薯率術爍妁鑠勺述暑碩蜀恕藷疏帥屬蟀墅豎樹倏朔	鼠漱黍庶束署戍曙輸薯術贖梳菽述暑舒叔淑恕蜀書藷殊疏塾屬橾墅抒豎說樹蔬倏樞熟孰
蒜	算	痠酸
維	薇圍唯違濰桅惟幃闈帷爲危巍韋微為	葦魏畏褽偽崴慰緯尉猥諉煨謂逶鮪僞遺渭威偎萎喂尾餵痿未位委胃洧穌蔚衛味娓偉為
儈	筷劊檜會塊膾快	
碰		蓬膨彭捧朋澎棚鵬抨篷硼烹砰
昧	瑁妹魅袂媚沬寐	媒玫每眉黴梅楣枚鎂美莓煤沒湄
趾	紙芷徵址止咫指只旨祉祇	智制脂植痔梔直致摭之製蛭躓質窒雉芝泜值胝躑枝吱峙祇幟肢支擲稚執祗職炙痣識汁置輊只至殖織卮滯隻蜘秩摯知姪氏緻治志誌
匡	劻筐框	壙礦況框曠誑眶狂
灼	卓濯着啄茁濁著斫拙琢擢酌鐲	桌涿捉棹
鍰	桓還環澴洹梡寰	渙幻歡換緩喚宦患奐豢皖煥瘓梡
毀	燬賄會悔誨虺蟲	蛔賄會彙彗潰詼燴蕙繪穢輝匯茴揮卉回麾徽灰諱惠迴墮恢暉慧誨晦喙
瘺	鏤露漏陋	樓簍摟嘍婁螻髏
萊	徠來	睞瀨癩籟賴
踱	度惰舵咄跺剁墮馱	奪朵躲鐸多
孟	夢	朦萌虻蒙檬蜢甍盟濛錳矇艋猛懵
咒	縐皺胄紂冑籀晝宙	妯啁州軸帚洲肘週周粥舟
苑	院媛願願怨遠	緣源媛員原轅園鳶圓援騵猿遠湲元宛爰袁沅垣淵冤鴛
蜘	脂梔之泜芝胝枝吱祇肢支祗汁只卮織隻知氏	智徵制植痔直致摭製蛭址躓質窒雉值躑擲峙祉幟祇趾稚執職炙痣識咫置輊只至殖滯紙芷止秩摯知姪指緻治志旨誌
籬	罹麗蠡犁璃貍漓蜊喱狸梨犛驪離釐黎	裏荔琍儷利厲痢例欐莉曆醴礫李勵鯉瀝慄禮隸理浬蒞釙蠣靂俚立粒礪壢唳力邐娌俐戾澧吏麗蠡鬲溧癘鋰笠裡哩歷酈
皎	較勦餃姣狡腳僥繳鉸攪角絞剿矯	教礁較澆跤姣轎驕窖郊鮫嬌膠焦詨校叫交椒蛟覺醮嚼蕉
貴	跪櫃桂鱖	晷龜皈歸詭閨鮭癸規圭珪瑰鬼傀軌
架	稼賈假價嫁駕	鉀加家甲茄胛嘉賈假葭頰傢豭佳戛迦袈莢痂夏挾夾浹
鎮	賑鴆陣枕振朕娠震	疹禎榛枕斟箴真診偵砧貞針珍甄楨縝臻
切	竊鍥愜挈怯妾契	且竊鍥伽愜挈怯妾茄契
漲	瘴脹丈賬帳掌障仗長杖幛	瘴蟑獐掌彰漳脹賬仗幛璋樟章障杖丈帳張長
薩	颯卅	灑撒
柢	砥牴底邸抵詆氐	滴鏑荻締迪帝的嘀狄蒂氐弟諦犒翟笛芽低地敵第娣遞棣滌嫡
窩	倭渦萵	齷斡我渥握沃臥
譏	唧跡畿屐居績犄饑羈激機乩積奇稽箕嘰躋蹟畸嵇其癘肌幾期雞璣基磯飢姬勣	急唧霽髻疾脊寄際繼寂即繫楫伋稷擠吉薺技記擊忌騎及悸嫉汲覬己亟藉劑岌紀吃季瘠給借棘計級祭圾戟麂妓驥籍濟鯽輯幾芰戢集暨洎極薊系冀躋既
伽	茄	契妾竊切挈愜怯鍥且
搭	褡答躂瘩	大靼打達韃瘩答怛
樸	迫莆破蒲璞樸釙葡僕菩濮魄粕醱脯匍泊蹼珀	叵陂暴誧撲普剖僕曝鄱瀑潑圃鋪溥噗波婆坡譜浦埔頗
郝	嚇和喝鶴賀好暍荷赫	毫蓋濠訶盍蠔荷嚎貉皓禾曷盒嗥閡顥褐蚵閤好鶴耗呵昊嗑浩合郃河翮和喝紇闔壕核鄗蒿劾鎬何豪號涸
捻	撚輦攆涊輾碾拈	廿念年黏唸
淘	檮逃桃燾啕洮陶萄濤	韜絛討套饕掏濤滔
孝	校嘯傚笑酵肖效	梟銷瀟霄小削蕭哮簫曉嘐硝囂學宵逍消驍篠
烹	抨砰澎	蓬膨彭捧朋澎棚鵬篷碰硼
摟	簍	簍露嘍漏樓髏陋鏤瘺婁螻
鑠	數碩勺蟀朔爍帥率妁	說
充	憧衝沖舂	崇重蟲衝寵
惱	瑙腦	鬧撓橈鐃呶
噸	燉頓遁盾沌囤盹鈍	敦蹲惇盹躉墩
賒	奢	社攝捨甚涉葉什舍拾射設歙蛇舌麝赦
祭	霽髻寄際繼繫寨稷薺債技記忌騎悸覬劑紀季責計妓驥濟鯽芰暨洎薊系冀躋既	急齋唧窄疾脊跡即寂屐楫居伋績擠吉犄饑譏齊擊羈機及乩嫉積激己汲藉亟岌翟宅吃瘠奇給稽借棘箕級摘圾嘰戟麂躋蹟籍濟輯畸嵇幾其肌期集戢飢雞極癘璣基磯畿姬勣
榔	螂狼郎廊琅瑯	浪朗
寡		瓜蝸括刮褂掛卦聒呱颳
旦	啗擔蛋氮啖但誕澹淡憚彈石	擔單簞疸丹耽膽撢
噱	薛獗蹶劂角孓訣掘鴃抉鱖決譎靴腳倔玨崛爵攫觼覺蕨絕厥嚼	雪穴倔蹶學血嗟削
搗	禱導島倒	蹈盜悼導道到稻叨刀倒
滴	低氐	氐笛嘀娣犒敵邸柢第地砥遞翟迪棣締帝狄嫡的牴抵滌弟芽荻蒂詆鏑底諦
馭	裕瘉澦禦域籲嫗喻獄玉欲譽禺熨峪昱燠癒寓愈諭御谷鬱預語遇與煜慾芋育聿尉俞堉鬱豫浴毓	妤娛瘀宇逾褕竽蝓雨雩渝覦迂漁於語紆與噢齬餘餘俞歟羽虞盂隅榆敔愚魚圉禺禹嶼輿愉圄淤腴臾諛庾圩瑜予萸於
勿	鎢誤惡戊悟塢霧騖物寤軏堊兀晤務	無巫毋圬屋梧嫵惡舞汙烏吾誣鎢吳五侮鼯於蕪捂鵡憮嗚蜈午亡武伍污唔
萱	喧壎煖暄軒晅宣諼	鉉懸漩還炫絢渲眩選旋縣璿玄
蘸	棧站綻湛暫佔顫戰	斬嶄沾瞻展盞輾霑佔詹譫氈
蠻	饅鰻漫蹣瞞	鏝滿曼縵屘漫蔓幔慢
迎	嬴盈瑩楹熒塋瀛縈螢贏營蠅	穎瑛嚶瓔櫻應纓嬰映鸚鶯膺鷹罌郢英景硬影
肪	妨坊防房	放坊彷訪枋倣芳舫紡仿方
相	向廂瓖橡鑲象香箱湘巷像項襄鄉嚮	橡香餉翔鄉嚮向象饗詳降廂鑲響祥像瓖箱湘巷庠想項襄享
饑	畸姬畿其璣羈肌犄飢癘雞磯乩幾積唧箕幾奇譏激績期屐機嵇跡勣稽蹟基躋嘰居	洎棘疾暨忌祭集脊己騎藉芰劑幾記楫瘠覬紀計級極妓冀戢擊寄輯寂給薊及嫉際幾唧麂繼擠急伋薺吉季圾即稷髻霽技汲吃亟既悸躋籍繫岌濟鯽戟驥
垃	肋勒樂叻	了
糸	汨覓祕祕冪密蜜謐泌	靡謎敉彌瀰弭麋瞇米咪糜迷
剔	梯踢	緹題隄悌銻堤涕蹄惕替提剃啼嚏逖體屜
嗣	賜祀泗兕肆食飼巳伺似耜寺駟姒俟四	撕司廝絲斯鷥私思嘶死
未	魏畏褽偽慰尉謂僞遺渭爲喂餵位胃穌蔚衛味為	違葦帷崴緯薇圍唯煨猥桅諉逶鮪幃維威巍偎萎尾濰惟痿闈委危韋微洧娓偉為
蓊		嗡翁甕
盃	杯揹卑背俾碑悲裨	北貝鋇倍背焙輩狽備臂邶憊悖被孛蓓
跌	迭耋絰喋牒疊碟諜蝶	爹
斕	藍闌欄襤籃攔籣瀾嵐蘭婪	攬欖爛懶濫覽纜
套		檮韜絛逃討桃燾啕淘洮陶萄饕掏濤滔
盡	緊晉噤進覲燼僅禁勁謹縉儘近錦浸	金謹錦浸饉覲瑾矜津禁斤襟緊觔巾僅儘今筋
思	嘶絲斯廝私司鷥撕	寺似鷥伺兕耜食祀泗嗣嘶巳駟廝賜飼肆四俟絲撕斯死私姒司
涯	蚜衙牙押芽	啞鴨亞疋訝軋煆雅鴉押呀丫壓氬
棻	氛吩紛分芬	汾分忿憤份墳糞焚奮粉
賈	鼓稼鉀牯鵠穀滑架甲古駕胛骨罟股假鈷價嫁蠱谷凸轂詁夏瞽	咕顧稼錮鉀加鴣架告家甲僱茄駕胛嘉骨估假蛄鈷價菰故呱嫁佳頰傢葭豭戛姑迦袈孤莢痂辜固夏挾沽夾浹
括	蛞瓜廓蝸擴刮聒呱闊颳	掛卦褂寡
又	囿柚侑佑宥有莠誘釉祐幼右鼬	悠憂攸友優猶疣鈾遊幽莠油由酉魷牖有黝郵尤猷
偎	煨逶威委崴萎	違葦魏畏帷褽偽慰緯尉薇圍唯猥諉桅謂鮪僞幃遺維渭爲巍萎喂尾餵濰惟痿闈未位危委韋胃洧微穌蔚衛味娓偉為
逖	涕悌屜剃替銻嚏惕	剔題梯堤蹄踢啼體隄緹提
泗	賜祀兕肆食飼巳伺嗣似耜寺駟姒俟四	撕司廝絲斯鷥私思嘶死
袈	嘉痂茄夾加豭葭傢佳家迦	架假夏鉀頰稼甲挾駕價浹賈莢戛夾嫁胛
陌	膜末貊莫磨默墨驀沫秣脈茉寞漠沒歿	膜抹蘑摩摸磨模糢謨魔摹麼
級	急唧疾脊即寂楫伋吉擊及嫉汲亟岌藉吃瘠借棘圾籍輯戢集極	唧霽髻寄脊跡際繼冀繫屐居績稷擠犄薺饑譏技記忌羈騎機乩激積覬己悸劑紀季奇給稽既箕計嘰祭戟麂妓蹟躋驥濟鯽畸嵇幾其肌芰期飢癘雞暨洎璣基薊系磯畿姬勣
旁	膀傍螃鎊磅謗棒龐徬蚌	梆胖膀邦傍綁滂乓磅榜幫
齦	夤墾鄞銀淫簷寅肯垠吟啃懇霪	癮聽胤印飲因尹茵音湮姻陰縯慇氤蔭殷隱引蚓
盧	鑪瀘鱸廬蘆爐臚顱	虜路僇嚕擄露錄鷺穋氯陸櫓滷賂戮麓魯鹵碌鹿祿
駿	竣菌浚郡俊雋濬蕈峻	龜均窘君鈞軍
鼻		庇埤幣裨箄襞彼篦蔽鄙筆必弊斃比妣蹕逼碧詖鉍賁陛避畢壁嗶闢璧臂敝痺愎泌睥匕婢薜沘閉祕弼俾
猩	腥興馨惺星	醒性興行倖杏省幸硎悻刑型姓陘形邢
湄	眉楣玫沒莓煤梅枚媒黴黴	每媚袂鎂妹沬瑁魅美寐昧
誌	雉秩幟蛭稚窒志痣智緻滯致置痔至摯峙製輊躓治知識制質炙	姪止植織梔咫泜氏芷脂胝值汁址吱肢執摭祇祉躑枝蜘直支擲知徵隻質紙趾只之指祗職芝旨卮殖
擱	鴿胳割歌疙戈哥	革格隔個膈合鬲蛤鉻骼閤箇閣咯鎘各郃葛
葦	猥諉萎痿鮪委娓洧尾偉緯	違魏畏帷褽偽崴慰尉薇圍唯煨桅謂逶僞幃遺維渭威巍偎爲萎喂餵濰惟闈未位危委韋胃微穌蔚衛味為
加	傢袈迦夾佳家痂茄葭豭嘉	夏稼鉀挾假賈戛夾架浹莢價甲嫁胛駕頰
訏	須墟胥鬚需虛籲戌噓	敘恤畜絮洫蓄婿酗卹許緒頊徐煦勗咻栩續旭序
制	智痔致製蛭躓窒質雉峙幟稚炙痣識置輊至滯秩摯知緻治志誌	徵植脂梔直摭之址質泜芝值胝躑枝吱祉祇肢擲支趾執祗職汁咫只殖織卮紙隻芷止蜘知姪指氏旨
繽	檳豳濱瀕賓儐彬	儐鬢臏殯
奔	賁	苯笨畚本
劬	渠麴衢瞿璩	趨嶇去娶取趣瞿漆蛆屈齲圈砠曲區蛐軀驅
馮	平枰逢縫憑蘋瓶萍屏評坪	豐娉俸諷縫峯風鋒楓乒封蜂烽瘋鳳奉
錡	歧淇其琪旗齊琦耆麒棋騎祺臍畦鰭祁崎圻奇岐衹祇期祈枝	愒萋淒妻欺溪豈綺磧棄杞乞汽啟柒器棲企訖谿稽漆慼亟迄悽泣起契憩戚砌七緝氣
假	夏稼鉀賈架價甲嫁駕胛	稼鉀加架家甲茄駕胛嘉賈價嫁葭佳頰傢豭戛迦袈莢痂夏挾夾浹
翌	屹藝肄軼刈誼囈縊逸佾溢劓疫懿鎰毅義邑億液佚役易羿弋裔蜴驛弈帟譯異益臆腋亦艾曳詣議意繹憶掖浥翳奕一抑翼衣	漪尾咦姨椅壹蟻飴旖誼偯迤栘移以彝夷已遺沂宜咿醫頤伊噫疑乙怡貽揖訑迆蛇矣圯胰儀一衣痍倚依
妣	彼鄙筆匕比沘	弊璧必敝鉍薜嗶痺箄襞避臂斃逼庇畢俾愎陛碧賁泌鄙蹕篦蔽詖埤闢閉弼婢祕比壁睥幣鼻裨
牛		拗忸紐鈕妞扭
麾	墮灰揮恢詼輝暉徽	諱茴蟲晦蕙燴燬彙彗虺賄悔回迴卉誨潰惠毀喙慧繪穢會蛔匯
輿	魚諛雩予竽愚禺虞蝓盂逾褕圩榆渝萸漁瑜歟於腴妤隅愉臾餘覦俞娛	芋與馭御喻育宇雨予禹瘉寓譽禺迂鬱尉齬噢癒圉諭玉澦煜語欲谷庾裕嶼昱愈紆聿峪嫗籲預豫圄域浴羽獄毓遇淤堉慾瘀敔禦熨俞燠
一	劓羿浥益藝軼鎰姨痍肄頤憶遺佚翌伊夷屹栘貽溢臆囈訑疑咿揖議意刈依噫移蛇役圯億沂繹弋迤腋毅譯儀詣怡咦縊逸抑漪彝懿壹醫液帟翼義疫飴異胰艾奕衣佾誼翳掖易裔邑曳亦蜴驛宜弈	劓羿浥益藝軼鎰姨痍肄頤憶遺矣佚翌伊夷屹栘貽溢臆囈訑疑偯咿揖議意刈依以噫移乙蛇役圯億蟻沂繹弋迤腋毅譯儀詣怡咦縊逸抑漪彝懿壹醫倚液帟翼義疫飴異迆胰艾奕衣佾誼尾翳已掖易裔旖邑曳椅亦蜴驛宜弈
誕	啗擔蛋氮啖但澹淡旦憚彈石	擔單簞疸丹耽膽撢
蔥	樅聰從囪匆	從叢淙
毫	蠔蚵嗥鶴號貉濠豪嚎壕	顥鎬涸號郝浩昊蒿好耗鄗皓
魷	鈾遊郵猶猷疣遊尤油由	幼幽黝攸鼬誘悠宥右柚牖祐有侑莠友又酉囿佑優憂釉
卮	肢祇織梔枝泜蜘支氏知隻只祗之脂芝胝汁吱	雉秩幟止蛭志芷值址執祇祉峙治制紙質誌姪稚窒植咫痣智緻滯致置痔摭至摯製輊躑躓直擲知識徵只炙趾指職旨殖
鈹	劈披陂疲脾匹丕霹皮沘埤壞陴枇被罷琵紕毗批啤鼙裨	劈披陂譬疲仳否沘壞僻癖琵批啤闢鼙脾匹媲丕霹皮痞埤闢枇陴被屁紕罷毗疋裨
噓	胥墟屍施溼籲戌獅師濕須蝨詩訏鬚屍失需蝨虛	豕拭恃軾是蓄匙許氏使拾視煦豉續仕噬恤洫蝕誓筮提室嗜頊逝什屎舐敘式絮適飾柿奭士徐碩螫十弒勗市試咻示序始塒畜石婿酗實食勢時卹侍世史識緒矢射事駛釋栩旭
吹	炊	槌錘鎚陲垂綞椎捶炊箠
蒂	棣締第帝娣的地弟遞諦	氐笛嘀犒敵邸柢砥翟迪狄嫡的牴低抵滌芽荻詆鏑滴底
汞	鞏鬨礦共廾拱	鴻黌泓龔紅弘虹肱功轟躬供哄蚣公薨閎共釭宏貢宮烘訌攻恭工洪弓
趺	孵麩膚鈇敷伕夫	氟縛匐馥覆附俯複夫頫蝠紼扶甫芾幅紱袱賻傅付拂涪撫斧赴莆彿服脯賦芙俘訃富府腑腐阜孚弗輻福浮腹伏符菔副復釜怫婦輔咐父負駙
噥	穠儂濃農膿	弄
竹	燭軸術築朮躅竺逐	諸朱蛀茱鑄硃渚助拄箸誅注主囑珠豬薴祝貯柱杼侏藷屬煮駐註矚佇株銖蛛住
掩	眼偃魘郾衍鼴兗儼演	釅言雁宴研艷殷硯嚥鹽菸奄顏咽巖厭贗簷閻沿湮彥諺煙驗堰焰延筵燄燕焉嫣嚴炎唁醃淹豔妍饜癌胭晏
甦	蘇囌酥穌	塑肅粟訴素俗蓿簌宿縮速嗉溯夙
埠	佈鈽布不怖部步簿	卜捕補不埔哺
絀	怵矗處畜黜歜觸	齣出鋤儲除杵礎跦楮廚褚雛處櫥躇楚初芻
乾	竿甘疳柑前尷幹黔箝坩虔潛桿鈐肝錢鉗	簽欠感塹遣倩愆鉛千贛遷稈韆籤譴趕淦阡幹嵌榦仟縴歉桿橄騫謙敢淺牽搴
嶽	曜粵越岳刖悅玥藥說耀月躍軏樂鑰籥閱	約曰
帚	肘	妯縐舟啁軸皺胄州咒宙洲週冑粥籀晝周紂
嗎	嬤瑪媽螞馬嘛蟆碼	瑪嬤痲媽麻螞罵馬嘛蟆碼麼
泣	器憩妻緝棄訖汽迄磧氣愒砌亟企契	旗啟淒祈谿豈悽琦琪麒耆漆杞起錡臍慼齊祁騎溪欺枝祇棋畦奇稽戚啓柒崎淇七隻綺其祺期圻乞棲衹歧岐萋鰭妻
紕	劈披陂疲脾匹丕霹皮沘埤壞陴枇鈹被罷琵毗批啤鼙裨	劈披陂譬疲仳否沘壞僻癖琵批啤闢鼙脾匹媲丕霹皮痞埤闢枇陴鈹被屁罷毗疋裨
嬰	瑛嚶英瓔鸚鶯應膺櫻纓鷹罌	穎盈楹迎應嬴熒螢贏營映瑩縈瀛蠅郢景塋硬影
襯	趁讖櫬稱疢	沈宸忱琛塵晨沉辰陳諶臣娠瞋
恤	序旭緒酗續卹蓄畜絮敘婿頊勗洫	鬚咻噓訏栩須戌胥墟籲煦虛需徐許
赫	賀鶴暍郝嚇荷和喝	褐劾訶曷荷禾郃何嗑河閤呵閡涸闔盒盍翮核合紇貉和蓋喝
讖	櫬稱襯疢趁	晨諶塵宸陳娠忱琛臣瞋辰沉沈
障	瘴脹丈賬帳仗長杖漲幛	璋蟑樟獐掌彰章張長漲漳
壢	慄儷麗礫礪唳痢歷靂力慄立癘溧蒞戾曆琍吏笠粒例利厲釙荔欐俐酈隸蠣勵瀝鬲莉	禮喱澧醴麗犁哩鯉犛貍籬黎娌璃浬釐離理驪邐李鋰梨狸裡罹裡漓蠡蜊俚
夕	隙細翕係系汐繫戲潟歙矽	悉禧行谿羲席嬉晰昔蟋洗惜吸釐唏曦希褶蹊稀淅溪襲習畦奚鰓犧譆熙攜烯西析蓆熄兮檄嘻僖蜥晞棲璽息錫媳膝犀熹徙喜
百	擺佰襬	白敗拜
醋	卒趣鏃促趨錯簇槭蹙蹴	粗
淌	儻倘帑躺	醣搪膛湯鏜趟棠螳燙瑭堂糖塘唐
梱	捆綑	睏髡琨困焜坤錕昆崑
慫	悚聳	嵩誦鬆宋訟頌送鬆崧淞忪
孵	伕夫敷鈇趺麩膚	孚富拂斧夫芙莆父復袱腐蝠菔氟覆阜撫腑符駙複幅輔服馥傅俯釜扶甫咐芾訃附輻腹俘賦伏匐賻彿副頫婦紼脯縛府付涪浮福弗怫負紱赴
御	芋與馭喻育瘉寓禺鬱尉癒諭玉澦語煜欲谷裕昱愈聿峪嫗籲預豫浴域獄毓遇堉慾譽禦熨俞燠	與魚諛宇雨雩竽禹予愚禺虞迂齬蝓噢盂圉逾褕圩瘀榆渝語萸漁瑜庾輿嶼歟於腴紆妤隅圄愉羽臾餘淤覦敔俞娛
嗓		桑喪
鴒	齡蛉菱櫺玲翎聆昤泠苓凌陵綾鈴靈羚零伶	領拎令另嶺
攘	瓤嚷禳壤	禳瓤壤嚷讓
蛋	啗擔氮啖但誕澹淡旦憚彈石	擔單簞疸丹耽膽撢
鄙	庇埤幣裨箄襞彼篦蔽筆必弊斃比妣蹕碧詖鉍賁陛避畢壁嗶闢璧臂敝痺愎泌睥匕婢薜沘閉祕弼俾	庇埤幣裨箄襞彼篦蔽筆必弊斃比妣蹕逼碧詖鉍賁陛避畢壁嗶闢璧臂敝痺愎泌睥匕婢薜鼻沘閉祕弼俾
疲	啤埤枇毗陂陴脾裨沘罷皮琵紕鼙鈹	媲劈匹屁僻癖壞仳紕被霹譬披鈹闢否批丕痞疋
士	室恃螫筮奭勢嗜舐豉市事仕拭識試世釋柿逝是適侍示飾軾誓弒氏式噬使視	濕詩十施屎師史匙提矢射食碩拾蝕駛塒屍噓時什溼豕獅失始蝨實石使
阿	婀啊	厄鵝呃扼哦惡萼顎詻堊啊軛蛾蚵娥峨噩訛餓鱷愕額啞鄂俄遏鍔
歸	龜皈閨鮭規圭珪瑰傀	晷桂鱖詭跪貴癸鬼軌櫃
軀	蛐嶇區曲趨屈瞿圈驅砠蛆	趣劬取漆曲麴齲瞿渠娶衢璩去
鰭	旗祈琦琪麒耆錡臍齊祁騎枝祇棋畦奇只崎淇其祺期圻衹歧岐	器憩啟淒谿豈悽企汽漆杞起慼磧泣溪亟砌欺契稽訖戚啓迄柒緝七綺棄乞棲氣愒萋妻
纏	讒孱蟬毚單饞蟾潺澶嬋禪巉	摻闡儳攙羼剷鏟懺諂產
迨	大貸黛怠逮岱待玳帶殆代戴袋	逮待歹呆
缺	闕	闋雀恪鵲闕瘸榷卻怯確殼
浬	禮澧醴理哩鯉邐李鋰裡裡蠡俚娌	儷哩歷靂力慄立溧黎琍粒璃離利厲狸俐蠣漓蠡莉鬲慄喱麗犁礫礪唳痢犛貍籬蒞癘壢戾曆吏笠釐例釙荔驪欐梨罹隸酈勵瀝蜊
鈇	孵趺麩膚敷伕夫	氟縛匐馥覆附俯複夫頫蝠紼扶甫芾幅紱袱賻傅付拂涪撫斧赴莆彿服脯賦芙俘訃富府腑腐阜孚弗輻福浮腹伏符菔副復釜怫婦輔咐父負駙
池	持馳墀遲栘弛踟匙	飭喫褫赤癡斥叱呎翅魑吃敕蚩侈啻尺笞熾齒恥嗤
邂	蟹榭屜解洩屑駭卸械瀉懈謝褻契燮楔洩紲	攜協歇寫邪斜些挾諧蠍偕鞋擷頡血脅勰
弧	囫糊狐鵠胡鬍蝴葫壺湖斛瑚	戶滬虎沍扈乎瓠忽惚互琥唬戲護楛許呼
培	裴陪賠	珮轡配胚沛壞佩呸
靶	把	鈸芭杷吧琶拔霸扒壩耙跋疤捌巴爸叭八笆灞伯罷
侏	誅硃銖蛛豬諸朱藷茱珠株	主軸杼薴註築柱矚囑朮築屬燭煮鑄住渚助竹竺佇蛀拄箸貯駐躅逐注祝
膊	卜鈸博蔔鉑駁箔荸脖搏檗渤帛薄白柏勃泊伯舶	玻菠薄亳般薜擘蘗簸檗剝跛缽播撥
牖	有黝莠友酉	遊由郵疣莠又尤優憂幼幽猶猷攸遊鼬誘宥油悠右柚祐鈾有侑囿佑魷釉
醃	奄菸煙胭燕醃湮厭骯咽淹焉殷嫣奄菸煙胭燕湮醃厭咽淹焉殷嫣	豔堰儼雁簷硯延妍眼昂彥沿燕鹽筵厭巖言燄宴演閻癌焰盎諺驗衍掩魘贗郾咽艷巖炎晏偃研兗嚥簷鼴顏饜釅嚴淹唁豔閻癌堰焰儼諺雁簷驗衍魘掩贗郾咽艷硯巖炎延晏研偃妍兗眼嚥彥簷沿燕鹽鼴饜顏釅筵巖厭嚴淹燄言宴演唁
剎	差岔詫	搽差察喳叉插茶查
枚	媒玫眉黴梅楣莓煤沒湄	妹瑁每昧魅袂鎂美媚沬寐
鹿	鷺穋氯路僇碌陸祿露錄賂戮麓	鑪魯虜盧瀘鹵鱸廬蘆嚕臚櫓擄爐滷顱
犛	喱璃釐離麗犁驪貍籬狸梨黎罹漓蠡蜊	儷澧醴哩歷靂力慄立溧娌琍粒理利厲邐俐蠣蠡俚莉鬲慄禮麗鯉礫礪唳痢蒞癘壢戾曆吏笠浬例釙荔欐李鋰裡隸酈裡勵瀝
仿	彷訪倣舫紡	放房坊防妨芳肪枋方
疣	鈾遊郵猶猷遊尤油魷由	幼幽黝攸鼬誘悠宥右柚牖祐有侑莠友又酉囿佑優憂釉
澳	拗懊傲奧	鏖凹熬鼇翱遨媼襖敖嗷聱
湛	戰顫佔站暫佔綻棧蘸	嶄詹譫佔氈霑瞻盞沾輾斬展
程	呈懲誠承丞橙乘城成盛澄	騁秤逞瞠撐稱
望	旺妄忘王	罔尢網往魍王汪亡枉惘輞
瀝	荔琍儷痢例利厲欐莉曆礫勵慄隸蒞釙蠣靂立礪壢粒唳力戾俐吏麗癘鬲溧笠歷酈	裏貍醴李離鯉釐黎罹禮漓理浬梨驪狸蜊俚娌邐澧麗蠡犁璃鋰喱籬犛裡哩
牙	蚜衙涯押芽	啞鴨亞疋訝軋煆雅鴉押呀丫壓氬
拌	半姅伴辦扮瓣絆	頒搬斑扳舨版板般瘢阪班鈑闆
害	氦亥嗨駭	孩咳骸海嗨還
糞	分奮忿憤份	棻分汾焚粉吩芬紛墳氛
廄	究舊救臼舅咎柩就疚	九揪韭啾赳鳩灸久酒糾玖
釭	共攻工宮紅蚣恭缸躬肱綱功岡供崗弓龔肛扛公槓剛鋼	礦鞏共汞港貢供廾崗槓拱
拗	曜傲要澳藥奧耀樂鑰懊鷂	吆熬媼餚襖嗷淆洮腰麼鏖瑤凹要崤妖搖敖窈翱爻紐舀牛忸姚榣鼇杳僥謠遙邀堯扭窯夭遨咬聱鈕喲妞
墅	數漱術豎恕庶曙樹束倏署述戍疏	鼠黍署輸數薯贖梳菽暑舒叔淑蜀書藷殊疏塾屬橾抒蔬樞熟孰
蝸	瓜刮括聒呱颳	掛卦褂寡
使	室恃螫屎筮史奭勢嗜矢豉舐市士事仕拭識試世釋柿逝是駛適侍示飾豕軾誓弒始氏式噬視	濕詩室十恃施螫屎筮師史匙提奭實勢嗜舐豉矢射市食士事仕拭碩拾識蝕試世釋柿逝是駛適噓屍塒侍示時什飾豕軾溼獅失誓弒始氏式噬石蝨視
偯	尾椅以蟻已乙矣旖迤迆倚	漪藝屹肄軼刈誼囈迤移縊逸彝溢佾夷沂宜劓醫疫頤噫疑懿鎰毅揖義訑蛇邑億液佚役儀易羿裔姨咦弋蜴壹驛飴弈譯帟翌異益栘臆遺亦艾腋曳咿議詣意伊繹怡貽憶掖浥翳圯胰奕一翼抑衣痍依
良	糧量粱涼樑	亮輛兩倆魎量晾諒涼
側	仄冊廁測策惻	責窄嘖笮怎則賊澤咋擇
莉	荔琍儷痢例利厲欐曆礫勵瀝慄隸蒞釙蠣靂立礪壢粒唳力戾俐吏麗癘鬲溧笠歷酈	裏貍醴李離鯉釐黎罹禮漓理浬梨驪狸蜊俚娌邐澧麗蠡犁璃鋰喱籬犛裡哩
居	唧拘跡鋸畿屐績犄饑疽譏羈激機乩積奇稽姬箕嘰駒狙蹟躋蛆畸車嵇其癘肌幾期沮雞璣基磯飢俱勣	霽菊寄鞠擊悸忌騎己藉屨句紀瘠計圾籍洎掬距躋既咀矩橘唧脊楫巨稷齟覬苣局劑吃季借祭麂驥鯽幾沮集侷懼際伋吉薺及劇亟鉅棘踞妓濟舉芰戢薊系冀炬俱急拒髻疾鋸繼繫寂即颶擠莒遽跼技記倨嫉汲岌桔具給聚級戟輯據暨極瞿足
櫻	瑛嚶英瓔嬰鸚鶯應膺纓鷹罌	穎盈楹迎應嬴熒螢贏營映瑩縈瀛蠅郢景塋硬影
緘	箋監間尖肩縑湔兼姦堅韉漸菅殲奸艱濺煎	件檻劍健僭見艦毽漸諫囝檢柬簡濺減筧踐監箭間閒薦腱鍵剪建鹼瞼繭餞鑑鑒澗賤撿揀儉薦
狡	攪鉸腳僥絞剿姣餃繳矯較勦皎角	礁醮澆嚼焦跤蕉嬌教交叫椒覺轎郊較窖膠蛟鮫驕校姣詨
泡	砲皰炮	咆庖拋刨炮跑袍匏
皋	篙睪羔糕高膏	搞誥告攪縞槁杲稿
率	數蟀慮氯碩綠爍律妁濾鑠勺朔帥	呂閭鋁甩褸履衰說驢膂屢旅摔婁侶縷櫚
蒞	慄儷麗礫礪唳痢歷靂力慄立溧癘壢戾曆琍吏笠粒例利厲釙荔欐俐酈隸蠣勵瀝鬲莉	禮喱澧醴麗犁哩鯉犛貍籬黎娌璃浬釐離理驪邐李鋰梨狸裡罹裡漓蠡蜊俚
癥	睜掙徵錚正箏猙爭崢蒸怔徵丁諍	政掙拯證証鄭正症幀整
眼	偃魘郾衍鼴兗儼掩演	釅言雁宴研艷殷硯嚥鹽菸奄顏咽巖厭贗簷閻沿湮彥諺煙驗堰焰延筵燄燕焉嫣嚴炎唁醃淹豔妍饜癌胭晏
竣	菌浚郡駿俊雋濬蕈峻	龜均窘君鈞軍
恿	擁泳踴永湧勇甬蛹臃俑詠湧壅	擁鄘傭臃邕雍慵用庸壅傭
饒	橈蟯嬈	繞擾
昱	裕瘉澦禦域籲嫗馭喻獄玉欲譽禺熨峪燠癒寓愈諭御谷鬱預語遇與煜慾芋育聿尉俞堉鬱豫浴毓	妤娛瘀宇逾褕竽蝓雨雩渝覦迂漁於語紆與噢齬餘餘俞歟羽虞盂隅榆敔愚魚圉禺禹嶼輿愉圄淤腴臾諛庾圩瑜予萸於
眸	繆牟謀	某
個	各鉻箇	革割閣咯骼各郃隔疙戈閤哥膈胳蛤箇鎘鴿合鬲鉻歌格葛擱
濤	檮韜絛逃桃燾啕淘洮陶萄饕掏滔	檮韜絛逃討桃燾啕淘洮陶萄套饕掏滔
塚	踵腫塚種踵腫塚種	盅仲忠眾鍾衷終忪湩中鐘重種盅仲忠眾鍾衷終忪湩中鐘重種
崩	繃	甭蹦迸
懍	凜	痳霖麟鱗藺林鄰燐淋磷吝躪轔遴臨賃琳璘
娛	魚諛雩予竽愚禺虞蝓盂逾褕圩榆渝萸漁瑜輿歟於腴妤隅愉臾餘覦俞	芋與馭御喻育宇雨予禹瘉寓譽禺迂鬱尉齬噢癒圉諭玉澦煜語欲谷庾裕嶼昱愈紆聿峪嫗籲預豫圄域浴羽獄毓遇淤堉慾瘀敔禦熨俞燠
徜	嚐場常長裳腸萇嫦償嘗	場暢倀昌倡猖敞鯧唱娼廠悵氅
弄		濃儂膿農噥穠
貫	盥鸛慣罐冠灌觀	綸關管倌琯冠莞官鰥矜觀棺館
篾	蔑滅	羋咩
斫	鐲著擢酌濁卓拙濯灼琢啄茁	棹涿捉桌
錙	淄緇貲諮茲姿孳孜資輜滋諮齜玆髭吱	仔訾字恣紫滓籽漬子孳梓自
墳	汾焚	棻分憤奮糞粉忿吩芬紛份氛
摭	直擲執姪質職植值躑殖	雉秩幟止蛭志芷氏脂址肢祇祉峙枝治支制質紙之祗芝誌稚窒織梔咫泜痣智緻胝滯汁吱致置痔摯至製輊躓蜘識知徵隻炙只趾指卮旨
畚	本苯	奔笨賁
蹊	攜曦淅悉熹烯禧犀嬉膝行蜥稀希吸溪畦晰兮析熙釐棲譆谿犧蟋唏羲晞嘻西奚僖	系汐蓆翕戲隙惜習璽徙洗細鰓係媳矽喜息潟夕繫席錫熄歙襲昔檄褶
頭	投	偷透投
厚	逅候後堠鱟	猴吼篌侯喉
標	膘杓鏢鑣彪	婊錶表鰾
鉍	弊璧必敝薜嗶痺箄襞避臂斃庇畢俾愎陛碧賁泌鄙蹕篦蔽詖埤闢閉弼婢祕比壁睥幣裨	彼鄙筆逼匕比沘鼻妣
鉉	眩漩炫絢旋渲	懸漩還煖暄軒宣晅諼萱喧壎選璿旋縣玄
愷	剴楷凱慨豈	開咳揩愒愾慨
弩	努	奴怒駑
虔	乾箝潛前鈐黔錢鉗	簽欠阡嵌仟塹縴遣歉倩愆鉛騫千謙淺遷牽搴韆籤譴
鏟	剷闡諂產	讒孱摻蟬毚單儳饞攙蟾潺澶羼嬋禪巉懺纏
凌	綾零蛉櫺昤菱鴒泠靈羚玲鈴苓伶齡聆陵翎	拎令另嶺領
紲	蟹邂榭屜解洩屑駭卸械瀉懈謝褻契燮楔洩	攜協歇寫邪斜些挾諧蠍偕鞋擷頡血脅勰
謐	汨覓祕祕冪密糸蜜泌	靡謎敉彌瀰弭麋瞇米咪糜迷
盥	貫慣觀罐冠鸛灌	館棺琯關觀莞矜倌管官鰥冠綸
晾	亮輛量諒涼	良兩糧魎粱量倆涼樑
迸	蹦	甭崩繃
陬	鄹鄒啁	揍走驟奏
樂	越玥藥月軏勒嶽閱要悅垃肋叻鷂粵耀拗曜刖說躍鑰籥	約吆餚洮淆腰麼瑤崤要妖搖窈爻舀姚榣杳僥遙謠邀了堯窯夭咬喲曰
樟	璋蟑獐章張彰漳	瘴脹丈賬帳掌障仗長杖漲幛
隧	遂碎祟誶歲穗燧邃	綏髓隨隋雖睢
寐	媚袂妹沬瑁魅昧	楣每沒莓枚媒美黴眉玫鎂煤梅湄黴
彎	蜿灣莞豌剜	萬玩蜿宛碗莞輓汍婉頑晚娩腕綰皖惋挽丸完
蜇	哲折摺摘懾輒謫轍褶	浙遮這著蔗螫赭鷓者宅
杗	芒茫盲氓忙	蟒莽
戲	隙細係翕乎汐忽惚潟繫系夕歙矽呼	羲席許曦淅溪奚鰓瓠譆互蓆兮蜥晞嬉晰昔惜唏襲鬍犧西攜烯熄囫檄嘻錫楛徙喜斛行谿葫扈湖釐瑚戶褶蹊習沍護熙析狐胡蝴璽息犀熹鵠悉禧虎唬蟋洗吸希稀壺弧畦糊僖滬棲媳琥膝
雖	睢綏	遂髓隨碎祟誶穗歲隋隧燧邃
孚	氟縛匐夫蝠紼扶芾幅弗輻紱袱福浮伏符菔拂涪怫彿服芙俘	富馥覆附膚俯鈇複府夫腑腐頫甫阜腹賻副傅復釜敷付撫斧孵赴婦莆趺輔咐父麩脯賦負駙伕訃
顧	固錮估告故僱	咕鼓鴣牯鵠穀滑家古骨罟股賈估蛄鈷菰呱蠱谷姑凸孤轂詁辜沽瞽
釅	豔晏研堰焰嚥諺彥雁沿燕驗饜贗厭咽淹艷燄宴唁硯	閻癌儼菸簷衍魘掩湮醃郾咽殷巖炎延研偃妍兗眼奄煙簷胭沿燕鹽鼴醃顏筵巖厭嚴淹言焉演嫣
蛔	迴茴回	賄會彙蟲彗潰詼燴蕙繪穢輝匯揮卉虺燬麾徽灰毀諱惠墮恢暉慧悔晦誨喙
粹	淬悴萃瘁橇翠脆	衰摧催璀崔
養	怏漾氧癢鞅仰樣煬恙	楊颺羊泱央昜漾殃洋鞅樣鴦怏徉揚氧仰秧烊煬鍚瘍陽暘癢恙佯
渲	鉉眩漩炫絢旋	懸漩還煖暄軒宣晅諼萱喧壎選璿旋縣玄
荃	蜷卷詮犬銓踡佺全權痊泉拳	圈甽犬勸畎券
炙	雉秩幟蛭稚窒志痣智緻滯致置痔至摯峙製輊躓治知識制質誌	姪止植織梔咫泜氏芷脂胝值汁址吱肢執摭祇祉躑枝蜘直支擲知徵隻質紙趾只之指祗職芝旨卮殖
颼	搜餿蒐	叟藪擻嗽嗾
好	顥鎬涸號郝浩昊耗鄗皓	蒿蠔鎬鶴號郝耗嚎皓顥涸蚵昊毫濠豪鄗嗥浩貉壕
俊	竣圳菌浚郡駿雋濬蕈峻	龜均窘尊撙君樽遵鈞軍
漢	瀚旱憾銲撼悍焊捍頷翰汗頜	韓鼾寒罕函含蚶榦酣涵和喊汗
馴	巽洵詢巡蕈徇潯旬遜訓迅潠循汛訊璿尋殉荀	勳巽洵詢巡蕈徇潯醺旬遜訓迅潠循汛訊璿薰勛尋燻殉荀
沔	湎勉靦冕娩緬偭免	棉面綿麵眠
園	沅轅垣圓爰緣湲袁援元騵原源媛員猿	怨院鳶苑宛鴛願淵遠冤媛
薔	牆彊戕檣強	鎗槍嗆繈將鏘搶腔羌強
頻	貧顰嬪瀕	聘品拼牝姘
瀚	憾悍旱頜銲翰撼漢捍汗頷焊	含函和韓榦汗涵蚶罕鼾喊寒酣
慎	脤甚滲沁蜃腎	參甚沈信身紳呻深審瀋娠莘哂申嬸砷伸神
闡	鏟剷諂產	讒孱摻蟬毚單儳饞攙蟾潺澶羼嬋禪巉懺纏
扳	頒搬斑般瘢班	半姅舨版板阪伴辦扮瓣絆鈑闆拌
碘	典點	靛滇鈿店澱奠電墊殿癲玷顛佃巔惦甸
暖	煖	
迺	奶氖奈乃	耐奈
櫥	除鋤芻儲廚雛跦躇	怵齣杵褚絀觸初出矗儲歜楚畜黜處楮礎
劂	鴃掘鱖抉決獗譎蹶腳倔玨角攫爵孓崛觼覺蕨訣厥絕嚼噱	倔蹶嗟
德	得	得的
扼	啞鄂軛惡俄萼厄堊顎詻呃噩遏餓鱷愕鍔	哦蛾蚵俄娥峨鵝婀阿訛額
牡	拇姥姆母畝	慕穆模募墓木目沐睦苜幕暮牧
傅	富父復覆阜駙複咐訃腹附賦賻副婦付負馥赴	孚拂斧夫芙敷莆父袱腐蝠菔氟腑撫符幅輔服鈇俯釜扶甫膚芾輻伏俘匐彿頫伕紼脯縛府浮涪趺福弗怫孵麩紱
勁	靜噤競淨浸晉覲敬縉痙鏡燼禁境竟僅徑盡儘近逕靖進	金精井荊兢謹警錦旌京浸饉覲瑾經粳菁驚矜頸涇晶津鯨睛莖禁斤阱憬襟緊璟觔巾景更僅儘今筋
蟻	迆已椅以乙矣旖倚尾迤偯	劓羿浥益藝軼鎰姨痍肄頤憶遺佚翌伊夷一屹栘貽溢臆囈訑疑咿揖議意刈依噫移蛇役圯億沂繹弋迤腋毅譯儀詣怡咦縊逸抑漪彝懿壹醫液帟翼義疫飴異胰艾奕衣佾誼翳掖易裔邑曳亦蜴驛宜弈
縲	累鐳擂嫘羸雷	磊累壘擂類儡漯淚蕾耒勒
腕	萬玩惋	玩蜿宛碗灣莞輓汍婉頑娩晚剜綰皖彎挽豌丸完
惠	匯繪賄慧卉諱會彙晦誨潰喙彗穢燴蕙	蛔賄會蟲詼輝茴揮虺回麾燬徽灰毀迴墮恢暉悔誨
賤	餞澗鑒劍閒毽諫箭僭踐艦件健建間檻見監濺薦腱漸鑑鍵	尖儉堅艱減菅緘韉柬湔撿簡殲瞼肩筧間揀繭煎姦剪鹼監檢縑濺奸兼漸囝箋
痰	談潭譚覃壇檀罈彈曇	坍癱灘探碳袒嘆毯貪攤炭歎坦
錕	髡琨焜坤昆崑	睏捆綑困梱
恨		痕很狠
贈		繒憎增曾
簪		咱鏨贊偺瓚暫讚
襪		窪娃蛙媧哇呱挖瓦
守	首手	獸綬瘦收狩壽授售受熟
閔	閩澠憫敏抿愍泯皿湣	岷玟民
佻	條調迢蜩	頫眺挑覜窕跳
脾	啤埤枇毗陂陴疲裨沘罷皮琵紕鼙鈹	媲劈匹屁僻癖壞仳紕被霹譬披鈹闢否批丕痞疋
某		眸牟繆謀
澈	坼撤掣徹轍	車扯
嫵	武憮舞鵡五捂伍侮午	汙晤騖巫吾塢悟亡誤誣務無吳烏毋寤戊惡嗚鼯於唔物勿霧屋兀圬鎢軏污梧蕪蜈堊
菠	玻撥般剝缽播	卜鈸博蔔鉑駁箔荸脖搏蘗檗跛播渤帛薄亳白柏膊薜勃泊簸伯舶擘
者	赭	鷓這螫蔗哲褶懾浙宅着摘謫遮蜇轍摺折輒著
鴆	震陣娠枕鎮朕賑振	禎枕診貞縝真針楨斟疹臻珍砧偵榛甄箴
啄	卓灼濯着茁濁著斫拙琢擢酌鐲	桌涿捉棹
箕	唧跡畿屐居績犄饑譏羈激機乩積奇稽嘰躋蹟畸嵇其癘肌幾期雞璣基磯飢姬勣	急唧霽髻疾脊寄際繼寂即繫楫伋稷擠吉薺技記擊忌騎及悸嫉汲覬己亟藉劑岌紀吃季瘠給借棘計級祭圾戟麂妓驥籍濟鯽輯幾芰戢集暨洎極薊系冀躋既
韭	赳酒玖糾灸九久	舊究糾救咎臼舅疚廄就揪柩鳩啾
膏	睪皋高羔糕篙	攪槁誥搞縞告杲稿
藷	數鼠朱諸侏茱硃誅蛛銖暑黍薯蜀屬豬署株珠	軸註築橾朮囑築恕燭屬述豎漱煮渚住鑄助竹竺蛀佇倏拄逐墅疏祝舒主杼薴柱樹叔塾菽術矚淑贖書輸熟束數殊庶樞戍梳箸貯孰駐躅抒注蔬署曙
是	拭恃式軾適柿飾奭氏士使視螫弒市示試豉仕噬誓筮室勢侍世嗜識逝事釋舐	豕屍匙溼獅蝨使拾詩碩失十蝨噓始塒石蝕實食施時提史師濕屍矢什屎射駛
塾	淑熟孰贖叔菽	樹橾術黍恕屬述漱豎書輸束殊數庶鼠倏藷樞梳戍暑薯蜀抒墅疏署蔬曙舒
剃	悌銻涕惕替逖嚏屜	體題隄梯緹剔蹄踢啼堤提
圄	雨語與宇庾敔噢齬圉禹予嶼羽	瘉澦域妤娛瘀馭獄逾峪昱燠褕蝓竽雩渝覦預漁迂語於與紆煜慾芋育餘餘俞歟堉鬱豫毓虞裕盂禦隅籲嫗榆喻愚魚玉欲譽禺熨輿癒寓愈愉諭御谷鬱淤腴臾遇諛圩聿尉瑜予萸浴於
楊	鍚徉颺揚瘍暘陽羊洋烊煬昜佯	怏漾煬殃泱養癢氧鞅仰央秧樣鴦恙
王	旺妄忘亡望	旺罔尢網往魍妄忘汪亡枉惘望輞
煽	鱔扇膳禪擅姍縿訕疝刪繕山舢汕贍善跚杉衫羶珊潸單芟	禪擅繕山舢汕贍跚珊潸單陝鱔扇膳姍縿訕疝刪善羶杉衫閃芟
糖	醣搪膛棠鏜螳瑭堂塘唐	淌湯趟帑倘鏜儻燙躺
燐	痳霖麟鱗林鄰淋磷轔遴臨琳璘	吝懍躪藺凜賃
圩	盂妤隅娛榆愚魚逾禺輿愉褕竽蝓雩渝覦腴漁臾於諛餘餘瑜俞予歟萸於虞	瘉澦域瘀宇馭獄峪昱燠雨預迂語紆與煜齬慾噢芋育俞堉鬱豫羽毓裕禦籲嫗敔喻玉欲圉譽禺禹熨嶼癒寓愈諭圄御谷鬱淤遇庾聿尉予浴
嘰	唧跡畿屐居績犄饑譏羈激機乩積奇稽箕躋蹟畸嵇其癘肌幾期雞璣基磯飢姬勣	急唧霽髻疾脊寄際繼寂即繫楫伋稷擠吉薺技記擊忌騎及悸嫉汲覬己亟藉劑岌紀吃季瘠給借棘計級祭圾戟麂妓驥籍濟鯽輯幾芰戢集暨洎極薊系冀躋既
礦	鞏眶曠汞況共框廾拱壙	劻龔紅肱框功誑躬匡供蚣公筐共釭貢宮攻恭狂工弓
賺	撰篆傳轉僎鑽	纂耑磚囀轉顓專鑽
騰	謄籐滕疼	
呸	壞胚	珮轡裴配佩陪培沛賠
叩	釦佝扣寇	口
姪	直擲執質摭職植值躑殖	雉秩幟止蛭志芷氏脂址肢祇祉峙枝治支制質紙之祗芝誌稚窒織梔咫泜痣智緻胝滯汁吱致置痔摯至製輊躓蜘識知徵隻炙只趾指卮旨
祿	路露鹿戮麓僇碌氯鷺陸錄穋賂	蘆滷盧魯鹵擄臚鑪櫓鱸顱爐嚕廬虜瀘
妻	器憩淒谿悽企汽漆慼磧泣溪亟砌欺契訖戚迄柒緝七棄棲氣愒萋	器憩旗啟淒祈谿豈悽琦琪汽耆麒企漆起錡杞臍慼齊磧泣祁騎溪亟砌欺枝祇契棋畦奇稽訖戚啓迄柒只崎淇緝七綺祺其期棄圻乞棲衹氣愒歧岐萋鰭
飛	菲啡霏妃扉非	菲吠肥誹芾斐腓匪費屝怫翡痱廢沸肺
捏		鎳聶臬蘗涅躡囁鑷齧孽
葬	藏髒臟奘	贓臢臧髒
斬	展盞嶄輾	棧站沾瞻綻霑湛暫佔蘸顫詹譫氈戰
屁	媲闢譬癖僻	啤埤劈陂脾裨匹琵枇疲壞仳紕霹被陴披鼙鈹否批毗丕沘痞疋罷皮
壟	隴攏	聾窿籠龍矓隆瓏朧嚨
洮	濤萄燾淆崤逃謠榣瑤啕僥餚桃姚陶遙餚檮窯淘堯搖爻	要濤韜喲夭耀咬杳窈鑰邀滔吆舀鷂腰樂討絛麼套掏藥拗妖曜饕
沃	齷斡渥握臥	窩我倭萵渦
沒	墨脈楣漠玫煤歿膜末貊默眉茉莫磨陌沫梅寞莓媒驀黴枚秣湄	抹妹袂魔麼膜蘑魅糢鎂摹媚昧摩磨瑁摸模沬寐每謨美
讜	黨擋檔	儅噹鐺擋襠當蕩盪
蜷	卷詮犬銓踡佺荃全權痊泉拳	圈甽犬勸畎券
蘋	平馮枰憑瓶萍屏評坪	娉乒
忌	霽髻寄際繼繫稷薺技記悸騎覬劑紀季計祭妓驥濟鯽芰暨洎薊系冀躋既	急唧疾脊跡即寂楫屐居伋績擠吉犄饑譏擊羈機及乩嫉積激己汲藉亟岌吃瘠奇給稽借棘箕級圾嘰戟麂躋蹟籍濟輯畸嵇幾其肌期集戢飢雞極癘璣基磯畿姬勣
瘦	獸狩壽授售受綬	守收手首熟
滔	韜絛饕掏濤	檮逃討桃燾啕淘洮陶萄套濤
盒	褐劾曷荷禾郃和嗑河閤閡涸闔盍翮核合紇貉何蓋	訶賀鶴赫暍郝嚇荷和呵喝
囂	簫宵霄嘐逍硝消梟削蕭驍哮銷瀟	曉校嘯小傚學笑酵孝肖效篠
洧	葦尾娓猥諉偉痿緯鮪萎委	魏衛胃蔚維萎威未韋唯遺惟渭濰圍桅為崴味穌煨薇逶餵幃偽慰位危謂帷微巍偎褽尉喂闈畏違委
駐	助薴箸祝註注蛀柱佇鑄杼住	諸逐軸朱躅茱硃渚拄蛛誅術主囑珠豬築朮貯竺侏藷屬煮燭矚株銖竹
睡	蛻說稅	誰水
囈	屹藝肄軼刈誼縊逸佾溢劓疫懿鎰毅義邑億液佚役易羿弋裔蜴驛弈帟譯翌異益臆亦艾腋曳詣議意繹憶掖浥翳奕一抑翼衣	漪尾咦姨椅壹蟻飴旖誼偯迤栘移以彝夷已遺沂宜咿醫頤伊噫疑乙怡貽揖訑迆蛇矣圯胰儀一衣痍倚依
冤	鴛鳶淵宛	院願遠湲員猿袁援原媛沅轅垣爰元騵圓怨緣苑園源
蓓	貝鋇倍背焙輩狽備臂邶憊悖被孛	杯盃北揹卑背俾碑悲裨
碼	螞馬嗎瑪	痲媽麻罵嘛嗎蟆嬤麼
角	攪觼蕨矯嚼餃劂掘訣鴃崛狡倔鱖絕剿玨覺較勦鉸獗厥腳僥絞繳抉孓譎爵攫姣蹶決噱皎	礁醮澆嚼焦跤蕉嬌教倔椒交叫覺轎郊較窖膠嗟蛟鮫驕校姣蹶詨
劻	匡筐框	壙礦況框曠誑眶狂
院	怨苑願遠媛	遠湲員猿鳶袁援宛原媛沅轅垣爰元鴛騵淵圓緣園冤源
竭	睫傑節櫛潔捷頡擷結桔孑羯桀劫拮碣訐詰截	芥姐揭姊疥階戒結藉接皆借偕界嗟解介街屆誡
侃	坎檻砍崁	戡看瞰勘刊堪
球	毬裘梂酋仇囚泅求	丘龜鰍秋蚯邱鞦
棕	鬃綜縱宗蹤	綜糉從總縱傯
顛	滇巔癲	點典靛鈿店碘奠電澱殿墊玷佃惦甸
面	麵	眠沔靦綿勉冕棉偭湎娩緬免
懸	還玄漩璿旋縣	選喧晅渲漩眩諼煖炫軒萱壎鉉絢旋宣暄
備	鋇背倍臂貝輩孛悖憊邶狽焙蓓被	碑背杯北卑裨揹悲盃俾
佔	棧站沾瞻占綻霑湛暫蘸顫詹譫氈戰	斬展盞輾湛蘸沾綻佔顫氈戰棧霑暫譫嶄站瞻占詹
証	政掙證鄭正症幀	睜掙拯徵錚正箏癥猙爭整崢蒸怔徵丁諍
蛇	儀怡飴咦姨甚痍胰頤遺移夷誼圯彝一沂栘迤貽什訑舌宜疑	捨劓羿浥益藝軼鎰肄舍射憶矣佚翌伊一屹溢臆囈偯咿葉揖議意刈依麝社以噫乙役億蟻賒繹弋迤腋毅譯奢赦攝詣縊逸抑漪懿壹拾醫倚液帟翼義歙疫涉異迆艾奕衣佾誼尾翳已掖設易裔旖邑曳椅亦蜴驛弈
晴	傾檠擎情	請親傾蜻輕清氫頃青鯖磬卿慶罄
頑	汍玩丸完	萬玩蜿宛碗灣莞輓婉晚娩腕剜綰皖彎惋挽豌
墮	麾恢度輝徽惰踱揮暉灰舵咄跺詼剁馱	蛔賄朵會彙蟲彗潰燴繪蕙穢匯茴奪卉虺鐸回燬躲諱毀惠迴慧悔晦誨喙多
譚	痰談潭覃壇檀罈彈曇	坍癱灘探碳袒嘆毯貪攤炭歎坦
螃	膀旁龐徬	磅胖滂乓
武	嫵舞午五侮伍捂鵡憮	無巫毋勿騖寤軏圬屋梧誤惡物汙堊烏吾兀誣務鎢塢悟霧吳鼯於蕪晤嗚戊蜈亡污唔
封	豐諷峯風鋒楓蜂烽瘋	俸諷逢縫馮鳳奉
喜	鰓徙璽洗	細悉禧行谿羲繫席嬉晰蟋惜昔吸釐唏曦隙希褶蹊稀淅溪襲矽習畦奚係翕犧譆熙夕攜烯析西蓆熄兮檄嘻僖蜥晞棲息錫系媳膝汐戲犀熹潟歙
芋	與馭御喻育瘉寓禺鬱尉癒諭玉澦語煜欲谷裕昱愈聿峪嫗籲預豫浴域獄毓遇堉慾譽禦熨俞燠	與魚諛宇雨雩竽禹予愚禺虞迂齬蝓噢盂圉逾褕圩瘀榆渝語萸漁瑜庾輿嶼歟於腴紆妤隅圄愉羽臾餘淤覦敔俞娛
劾	嗑合蓋河郃翮和紇闔盍核荷貉禾曷盒閡何褐閤涸	嚇郝和訶喝鶴賀暍荷赫呵
鞍	庵安鵪諳銨氨	按菴暗岸俺黯案
爬	耙杷扒琶	葩趴怕啪帕
吮	盾	舜順瞬
歉	倩纖欠塹縴	淺乾鉛謙韆嵌錢潛愆遣籤搴仟千牽簽前遷鉗騫鈐黔箝幹譴虔縴阡
兗	鼴衍魘掩偃眼儼郾演	豔閻癌堰焰諺菸雁簷驗湮醃贗咽艷殷硯巖炎晏延研妍嚥奄彥煙簷胭沿燕鹽醃饜顏釅筵巖厭嚴淹燄言焉嫣宴唁
屋	嗚鎢巫惡於汙污烏圬誣	無巫毋勿騖寤軏梧嫵誤惡舞物堊吾兀誣務鎢悟塢霧吳五侮鼯蕪捂鵡憮晤戊蜈午亡武伍唔
潘	攀	胖拚畔踫磐般蹣叛蟠槃盤判盼
掣	坼撤徹澈轍	車扯
詳	降庠翔祥	橡香餉鄉嚮相向象饗廂鑲響像瓖箱湘巷想項襄享
榫	損筍	飧蓀潠孫
攤	癱坍灘探貪	痰談潭譚探碳袒覃毯嘆壇檀罈炭歎彈坦曇
瑜	盂妤隅娛榆愚魚逾禺輿愉褕竽蝓雩渝覦腴漁臾於諛圩餘餘俞予歟萸於虞	瘉澦域瘀宇馭獄峪昱燠雨預迂語紆與煜齬慾噢芋育俞堉鬱豫羽毓裕禦籲嫗敔喻玉欲圉譽禺禹熨嶼癒寓愈諭圄御谷鬱淤遇庾聿尉予浴
惻	策測冊廁側	
眩	鉉漩炫絢旋渲	懸漩還煖暄軒宣晅諼萱喧壎選璿旋縣玄
僑	樵憔譙橋翹喬瞧	雀巧蹺鍬俏峭誚鵲翹竅悄鞘撬橇殼敲愀
汶	文聞問紊抆免	文聞瘟雯吻紋玟蚊溫穩塭刎
痂	嘉袈茄夾加豭葭傢佳家迦	架假夏鉀頰稼甲挾駕價浹賈莢戛夾嫁胛
霏	菲啡非妃飛扉	費菲痱斐屝肥翡沸腓誹吠怫廢肺芾匪
姅	瓣拌扮辦伴半絆	板搬般斑舨頒瘢阪版班扳闆鈑
妍	炎延研閻癌簷沿簷鹽顏筵巖嚴言巖	豔堰焰儼諺菸雁驗衍魘掩湮醃贗郾咽艷殷硯晏偃研兗眼嚥奄彥煙胭沿燕鼴醃饜釅厭淹燄焉演嫣宴唁
剝	玻菠般缽播撥	卜鈸博蔔鉑駁箔荸脖搏蘗檗跛播渤帛薄亳白柏膊薜勃泊簸伯舶擘
諒	亮輛量晾涼	良兩糧魎粱量倆涼樑
贍	汕善擅繕單扇訕膳疝禪煽鱔	芟閃扇陝羶衫跚縿山煽珊潸姍刪舢杉
飩	囤屯臀豚	褪吞
憔	樵譙橋僑翹喬瞧	雀巧蹺鍬俏峭誚鵲翹竅悄鞘撬橇殼敲愀
餾	陸溜六霤	榴瘤泵劉留瀏硫溜鉚柳琉流遛
文	雯紊聞蚊汶免問紋抆玟	穩雯紊聞瘟刎蚊塭汶免問溫紋吻抆玟
唬	琥虎許	鵠葫扈惚湖呼戶瑚壺弧鬍沍乎瓠護互囫糊狐胡滬蝴忽戲楛斛
焙	鋇背倍臂貝輩備孛悖憊邶狽蓓被	碑背杯北卑裨揹悲盃俾
遽	炬苣颶懼具巨踞瞿鉅倨劇屨距俱聚據句鋸足拒	莒咀舉桔疽橘蛆跼車駒俱拘狙侷掬菊局鋸沮鞠居齟矩
拎		齡領蛉菱櫺玲翎聆昤鴒泠令苓凌陵綾鈴另靈羚零嶺伶
汀	聽廳	廷霆婷聽蜓挺梃停亭艇庭
嗇	澀穡瑟圾色塞	
樣	怏漾養煬恙	楊颺羊泱養央昜殃洋鞅鴦徉揚氧仰秧烊煬鍚瘍陽暘癢佯
黜	怵矗處畜歜絀觸	齣出鋤儲除杵礎跦楮廚褚雛處櫥躇楚初芻
煦	咻栩許	敘絮蓄徐鬚需勗續序噓胥墟畜恤洫酗婿籲卹戌須訏頊緒虛旭
併	病並摒並	丙柄秉兵鉼屏稟冰餅炳
鎢	汙烏寤晤惡戊嗚騖於巫物勿塢悟霧屋誤兀務誣圬軏污堊	武汙鵡晤騖巫侮吾悟塢亡誤誣務無吳午五烏毋伍寤戊惡嗚於鼯嫵唔物勿憮屋霧舞兀圬捂軏污梧蕪蜈堊
報	抱鉋刨鑤豹爆鮑暴	葆包雹胞飽薄褓堡保褒寶苞
牒	碟跌耋迭蝶絰諜喋疊	爹
陴	陂疲脾皮沘埤枇鈹罷紕琵毗啤鼙裨	劈披譬仳匹否媲丕霹痞僻壞闢鈹癖屁被紕批闢疋
筐	劻匡框	誑眶壙礦況狂框曠
澀	瑟穡嗇塞圾色	
氮	啗擔蛋啖但誕澹淡旦憚彈石	擔單簞疸丹耽膽撢
冰	兵	餅秉摒丙鉼炳稟柄屏並併病
式	室恃螫筮奭勢嗜舐豉市士事仕拭識試世釋柿逝是適侍示飾軾誓弒氏噬使視	濕詩十施屎師史匙提矢射食碩拾蝕駛塒屍噓時什溼豕獅失始蝨實石使
懵	艋猛萌錳甍蒙矇檬蜢虻盟朦濛	艋夢猛萌錳甍蒙矇檬蜢虻盟孟朦濛
偉	猥諉葦痿鮪委娓洧萎尾緯	違魏畏帷褽偽崴慰尉薇圍唯煨桅謂逶僞幃遺維渭威巍偎爲萎喂餵濰惟闈未位危委韋胃微穌蔚衛味為
發	伐法	罰法閥琺筏伐乏髮砝
為	魏衛胃蔚維未韋唯遺惟渭濰圍桅味穌薇餵幃偽位慰危謂帷微巍褽尉喂闈畏違	娓維未威韋渭惟桅味煨穌逶餵幃葦慰位洧謂鮪巍褽闈尾魏胃衛蔚痿緯萎唯遺圍濰崴薇偽危偉帷微偎喂尉猥畏諉違委
頜	憾悍旱銲翰撼漢捍瀚汗頷焊	含函和韓榦汗涵蚶罕鼾喊寒酣
痲	麼嘛麻蟆	螞碼瑪嘛嬤媽罵嗎馬蟆
嚀	檸擰獰凝寧	擰佞濘
覃	曇譚潭痰罈談彈檀壇	毯炭袒歎碳嘆貪坍探攤灘坦癱
盎		醃昂骯
叫	教校醮窖覺轎較	攪礁澆矯嚼餃焦跤蕉嬌狡教剿椒交郊較勦鉸腳僥絞膠繳蛟鮫驕姣詨皎角
岔	差剎詫	搽差察喳叉插茶查
坤	錕崑焜琨昆髡	困睏梱綑捆
犢	髑瀆櫝讀黷牘毒獨	杜蠹堵睹篤賭度鍍嘟渡肚都督妒
樅	蔥匆囪從聰	淙從叢
筍	榫損	飧潠孫蓀
闔	嗑合蓋河郃翮和紇盍核荷貉禾曷劾盒閡何褐閤涸	嚇郝和訶喝鶴賀暍荷赫呵
揆	夔葵睽魁奎逵	匱愧窺盔餽虧喟傀簣潰
罐	盥貫鸛慣冠灌觀	綸關管倌琯冠莞官鰥矜觀棺館
鱗	鄰林淋遴痳燐轔琳磷霖臨麟璘	吝凜藺賃躪懍
鉚	柳	榴瘤泵餾劉留霤六瀏硫溜陸琉流遛
傀	龜皈歸閨鮭規圭珪瑰	詭貴睽窺潰軌鱖愧奎魁葵癸喟櫃晷虧桂簣揆逵夔匱餽跪盔鬼
宣	晅萱煖諼軒喧壎暄	選縣渲漩眩玄炫絢璿鉉懸旋還
喔		哦
俟	賜祀泗兕肆食飼巳伺嗣似耜寺駟姒四	撕司廝絲斯鷥私思嘶死
臆	屹藝肄軼刈誼囈縊逸佾溢劓疫懿鎰毅義邑億液佚役易羿弋裔蜴驛弈帟譯翌異益亦艾腋曳詣議意繹憶掖浥翳奕一抑翼衣	漪尾咦姨椅壹蟻飴旖誼偯迤栘移以彝夷已遺沂宜咿醫頤伊噫疑乙怡貽揖訑迆蛇矣圯胰儀一衣痍倚依
桌	涿捉棹	卓灼濯着啄茁濁斫鐲酌拙擢著琢
箴	禎診貞真針楨斟臻珍砧偵榛甄	震陣娠鴆診枕縝鎮朕賑振疹
莆	葡樸濮俯釜府撫腑釙腐樸蹼頫斧輔甫父脯菩蒲璞僕匍	氟縛匐埔馥覆附膚鈇複夫蝠誧紼扶溥暴芾幅噗紱袱賻傅付拂涪赴彿僕服撲撲賦芙俘訃普富圃阜孚弗輻福腹浮伏符菔鋪副復敷浦怫孵婦趺咐父麩譜瀑曝負駙伕
鏗	吭阬坑	
屢	呂鋁褸履膂旅婁侶縷	慮閭率氯綠驢濾律櫚
謄	騰籐滕疼	
沾	瞻霑佔詹譫氈	棧斬站嶄展盞輾綻湛暫佔蘸顫戰
楠	南喃難男	赧囝難
掙	政爭徵猙幀諍睜証證癥丁蒸怔箏崢錚鄭症正	政爭徵猙幀諍整睜証證癥丁蒸拯怔箏崢錚鄭症正
噶	軋	價尬嘎
羈	畸姬畿其璣肌犄飢癘雞磯乩幾積唧箕幾奇譏激績期屐機嵇跡勣稽蹟基躋嘰居饑	洎棘疾暨忌祭集脊己騎藉芰劑幾記楫瘠覬紀計級極妓冀戢擊寄輯寂給薊及嫉際幾唧麂繼擠急伋薺吉季圾即稷髻霽技汲吃亟既悸躋籍繫岌濟鯽戟驥
灑	撒	卅薩颯撒
桿	乾竿疳坩甘柑尷幹肝橄敢感稈趕	橄淦幹贛敢榦感稈桿趕乾竿甘疳柑淦幹榦尷幹坩贛桿肝
爵	觼蕨嚼劂掘訣鴃崛倔鱖絕玨覺獗厥腳抉孓譎攫蹶決噱角	蹶嗟倔
遮	着螫著	鷓這螫蔗哲褶懾浙者宅摘謫赭蜇轍摺折輒著
失	濕屍噓詩溼獅施師蝨	室十恃螫屎筮史提匙奭實勢嗜舐豉矢射市食士事仕拭碩拾識蝕試世釋柿逝是駛適塒侍示時什飾豕軾誓弒始氏式噬石使視
做	祚作座鑿坐柞	昨左作佐砟
塞	瑟穡鰓賽嗇圾澀色腮	鰓賽腮
渙	幻宦煥喚患奐梡豢瘓換	皖環澴洹鍰桓緩梡寰歡還
司	嘶絲思斯廝私鷥撕	思寺似伺兕食耜祀泗嗣巳駟賜飼肆四俟死姒
詣	屹藝肄軼刈誼囈縊逸佾溢劓疫懿鎰毅義邑億液佚役易羿弋裔蜴驛弈帟譯翌異益臆亦艾腋曳議意繹憶掖浥翳奕一抑翼衣	漪尾咦姨椅壹蟻飴旖誼偯迤栘移以彝夷已遺沂宜咿醫頤伊噫疑乙怡貽揖訑迆蛇矣圯胰儀一衣痍倚依
巫	無毋圬屋梧惡汙吾烏誣鎢鼯於吳蕪嗚蜈亡污唔	無毋勿騖寤軏圬屋梧嫵誤惡舞物汙堊烏吾兀誣務鎢悟塢霧吳五侮於鼯蕪捂鵡憮晤嗚戊蜈午亡武伍污唔
遁	鈍燉囤噸頓盾沌盹	蹲躉墩敦惇盹
虻	甍蒙矇檬盟朦萌懵濛	艋蜢夢孟猛懵錳
而	兒	爾洱二邇貳餌兒耳
湲	緣媛源員原轅園圓援騵猿元爰袁沅垣	宛院苑媛願淵願冤鴛鳶怨遠
傘	糝散	參散三
散	糝傘	參糝傘三
匏	炮咆庖刨袍	泡皰炮拋砲跑
轄	霞峽黠挾呷遐匣洽狎柙斜瑕狹暇俠	夏廈下嚇暇蝦瞎
穡	澀瑟嗇圾色塞	
謊	恍洸幌晃	凰遑湟肓黃篁晃慌簧韹煌蝗隍皇徨荒璜惶磺
兆	櫂詔罩趙晁肇炤棹照召	找釗晁招着著朝沼爪嘲昭召
鼯	吾亡誣無毋梧唔巫吳蕪蜈	武汙鵡晤騖巫侮悟塢誤誣務午五烏伍寤戊惡嗚嫵於物勿憮霧屋舞兀圬鎢捂軏污堊
聖	賸乘剩勝盛	笙牲昇聲陞省甥繩澠勝生升
琢	卓灼濯着啄茁濁著斫拙擢酌鐲	桌涿捉棹
示	室恃螫筮奭勢嗜舐豉市士事仕拭識試世釋柿逝是適侍飾軾誓弒氏式噬使視	濕詩十施屎師史匙提矢射食碩拾蝕駛塒屍噓時什溼豕獅失始蝨實石使
鰻	蠻蹣漫饅瞞	蔓慢屘漫幔曼滿縵鏝
賓	檳豳瀕濱繽儐彬	儐鬢臏殯
宿	訴岫縮粟簌秀速繡朽夙肅嗉溴塑蓿嗅素溯袖臭鏽	咻囌酥岫俗脩秀繡朽溴蘇嗅穌修袖休臭甦羞鏽
韁	疆漿江姜將薑僵	匠蔣講彊槳絳將獎醬降強
令	另	零菱泠靈鴒齡聆綾拎蛉櫺羚玲鈴苓陵領昤嶺伶凌翎
悉	禧行谿羲嬉晰釐蟋吸唏曦希蹊稀淅溪畦奚犧譆熙攜烯西析兮嘻僖蜥晞棲膝犀熹	細繫席昔惜洗隙褶襲矽習鰓翕係夕蓆熄檄璽息汐系媳錫戲潟徙喜歙
鰾		鏢鑣表彪錶膘標杓婊
稠	籌惆躊裯仇疇愁鯈酬綢儔	醜抽溴臭
誧	普埔溥譜圃浦	葡鋪濮樸釙蹼樸莆僕暴撲撲瀑脯菩蒲璞曝噗僕匍
絳	匠彊將醬降強	疆蔣講漿江姜槳將韁薑獎僵
脤	腎蜃滲甚沁慎	哂砷信審甚瀋申莘伸呻娠深身嬸紳參神沈
惡	巫勿騖厄寤軏呃扼圬屋誤萼物顎詻汙堊烏兀誣務軛鎢塢悟霧於噩餓鱷愕晤啞鄂嗚戊俄遏鍔污	無巫毋勿騖軏鵝寤圬哦屋嫵誤舞梧物婀汙堊烏吾兀誣務阿鎢蛾塢悟蚵霧娥吳峨於侮蕪五捂鼯訛鵡憮晤額嗚戊俄蜈午亡武伍污唔
誅	硃銖蛛豬諸朱藷茱侏珠株	主軸杼薴註築柱矚囑朮築屬燭煮鑄住渚助竹竺佇蛀拄箸貯駐躅逐注祝
玨	鴃掘鱖抉決獗譎蹶劂腳倔角攫爵孓崛觼覺蕨訣厥絕嚼噱	倔蹶嗟
頌	訟誦送宋	淞崧悚慫嵩忪鬆聳
補	卜捕埔哺	埠佈鈽布不怖部步簿
蔑	滅篾	咩羋
飪	衽刃紉妊韌認仞軔任賃	仁荏稔壬人忍兒任
瀕	貧頻顰嬪檳豳濱繽賓儐彬	殯聘品儐拼鬢牝姘臏
黔	潛鈐箝乾幹前鉗虔錢	倩淺鉛謙韆嵌歉纖愆遣籤塹搴仟千牽欠簽遷騫譴縴阡
靴	噱薛	血雪削穴學
倭	窩萵渦	臥我沃斡齷渥握
痞	仳否匹疋	劈披陂譬疲沘壞僻癖琵批啤闢鼙脾匹媲丕霹皮埤闢枇陴鈹屁被罷紕毗裨
明	螟冥酩暝茗鳴名瞑銘	暝命
贅	綴墜惴	追椎錐隹
麩	伕夫敷鈇趺孵膚	孚富拂斧夫芙莆父復袱腐蝠菔氟覆阜撫腑符駙複幅輔服馥傅俯釜扶甫咐芾訃附輻腹俘賦伏匐賻彿副頫婦紼脯縛府付涪浮福弗怫負紱赴
正	政爭徵猙幀諍掙睜証證癥丁蒸怔箏崢錚鄭症	政爭徵猙幀諍整掙睜証證癥丁蒸拯怔箏崢錚鄭症
漱	數墅術豎恕庶曙樹束倏署述戍疏	鼠黍署輸數薯贖梳菽暑舒叔淑蜀書藷殊疏塾屬橾抒蔬樞熟孰
雀	闋巧恪鵲闕悄榷卻怯確殼愀	憔譙俏殼蹺缺翹竅鞘瞧鍬闕僑瘸峭喬樵誚橋撬橇敲
嘀	迪狄笛嫡犒荻的敵鏑滌芽翟	氐娣邸柢第地砥遞棣締帝的牴低抵弟蒂詆滴底諦
瓔	纓應嬰罌瑛英鷹嚶鶯櫻膺鸚	瑩景郢迎營映贏盈熒應縈嬴穎塋楹蠅瀛硬影螢
訥	納那鈉吶娜捺	那拿哪
這	浙蔗鷓宅	遮懾謫赭者轍哲蜇折著摘摺輒螫褶
葷	昏婚	混渾魂輥餛琿
邪	諧挾頡擷偕斜攜勰協鞋脅	卸洩歇榭蠍寫屑血楔蟹邂契褻懈謝駭械燮解些瀉紲屜
肝	柑乾幹尷甘坩疳竿杆桿	敢淦幹橄榦桿感稈趕贛
翕	潟戲夕隙係繫矽系汐歙細	攜烯嬉蓆膝惜璽洗溪析媳棲息蟋羲錫蹊昔褶曦淅悉熹禧犀行蜥稀希吸習徙晰畦兮鰓熙釐喜谿譆犧唏晞嘻西席奚熄襲僖檄
錯	卒厝趣醋鏃促趨簇槭撮措挫銼蹙蹴	搓蹉磋撮粗嵯
濛	甍蒙矇檬盟虻朦萌懵	艋蜢夢孟猛懵錳
膿	濃儂農噥穠	弄
總	傯	鬃綜糉從縱棕宗蹤
圾	急唧疾脊即寂楫伋吉嗇擊及嫉汲亟岌藉吃穡瘠借棘級澀籍輯瑟戢集極塞色	唧霽髻寄脊跡際繼冀繫屐居績稷擠犄薺饑譏技記忌羈騎機乩激積覬己悸劑紀季奇給稽既箕計嘰祭戟麂妓蹟躋驥濟鯽畸嵇幾其肌芰期飢癘雞暨洎璣基薊系磯畿姬勣
譆	攜曦淅悉熹烯禧犀嬉膝行蜥稀希吸溪畦晰兮析熙釐棲谿犧蟋唏羲晞嘻西奚蹊僖	系汐蓆翕戲隙惜習璽徙洗細鰓係媳矽喜息潟夕繫席錫熄歙襲昔檄褶
綱	缸鋼岡崗槓剛扛釭肛	崗槓港
恥	尺呎齒褫侈	飭喫遲赤癡弛叱踟匙斥持馳池翅魑吃敕栘蚩啻笞熾墀嗤
縱	鬃綜糉從棕宗蹤	鬃綜糉從總棕宗蹤傯
礙	曖噯艾璦愛隘	靄哀藹埃捱哎矮挨唉皚
體		隄悌踢啼提題梯剔涕替逖惕嚏緹銻蹄剃堤屜
鉑	荸搏帛蔔駁伯博檗脖勃白鈸膊泊舶柏渤箔薄	玻撥亳般簸薜播檗菠蘗跛缽剝擘薄
毽	件檻劍健僭見艦漸諫濺踐監箭間閒薦腱建鍵餞鑑鑒澗賤薦	箋縑兼姦韉漸殲奸囝艱柬檢簡濺減筧監間肩尖湔剪鹼瞼繭堅菅緘撿揀儉煎
各	個鉻箇	革割閣咯骼郃隔疙戈閤哥膈胳蛤鎘鴿個鬲歌格葛擱
胛	賈假夏鉀甲	嘉架假頰加葭稼傢挾迦駕價浹痂賈莢戛袈夾茄豭嫁佳家
嘉	袈加迦夾佳家痂茄葭豭傢	夏稼鉀挾假賈戛夾架浹莢價甲嫁胛駕頰
佞	濘	檸擰嚀獰凝寧
矢	史豕始屎使駛	濕詩室十恃施螫筮師匙提奭實勢嗜舐豉射市食士事仕拭碩拾識蝕試世釋柿逝是適噓屍塒侍示時什飾溼軾獅失誓弒氏式蝨噬石使視
速	溯嗉訴塑縮粟蓿宿素夙肅簌	囌酥蘇俗甦穌
瑰	龜皈歸閨鮭規圭珪傀	晷桂鱖詭跪貴癸鬼軌櫃
壎	萱喧煖暄軒晅宣諼	鉉懸漩還炫絢渲眩選旋縣璿玄
晶	鯨睛莖京更精荊經粳菁兢驚旌涇	靜競井淨警敬勁痙頸鏡阱憬璟竟景徑逕靖境
共	拱龔鞏紅廾肱功躬供蚣公礦釭貢宮攻恭汞工弓	拱龔鞏紅廾肱功躬供蚣公礦釭貢宮攻恭汞工弓
芳	枋坊方	放房坊妨防彷訪倣舫肪紡仿
用	傭	湧擁俑永泳傭蛹雍慵甬恿臃鄘踴壅庸勇詠邕踊
弟	棣締第帝娣蒂的地遞諦	氐笛嘀犒敵邸柢砥翟迪狄嫡的牴低抵滌芽荻詆鏑滴底
捉	桌涿棹	卓灼濯着啄茁濁斫鐲酌拙擢著琢
闢	庇媲埤幣裨屁箄襞僻篦蔽鄙癖辟必弊斃比蹕碧詖譬鉍賁陛避畢壁嗶璧臂敝痺愎泌睥婢薜閉祕弼俾	啤埤劈陂脾裨匹琵彼枇鄙筆疲比壞妣仳紕霹被逼陴披鼙鈹否批毗匕丕沘痞疋罷鼻皮
臺	台抬跆颱薹苔擡檯	泰汰苔太態胎
伍	嫵舞午五侮武捂鵡憮	無巫毋勿騖寤軏圬屋梧誤惡物汙堊烏吾兀誣務鎢塢悟霧吳鼯於蕪晤嗚戊蜈亡污唔
剌	蠟邋臘辣落	喇蠟拉邋臘辣落啦
礁	蛟鮫嬌教蕉驕澆姣膠交焦椒詨郊跤	攪醮矯嚼餃狡教剿叫覺轎較鉸勦腳僥窖絞繳校姣皎角
會	塊賄劊膾彙檜蟲彗潰燴繪蕙穢筷匯卉虺儈燬毀諱快惠慧悔晦誨喙	蛔賄彙蟲彗詼燴潰蕙繪穢輝匯茴揮卉虺回燬麾徽灰毀諱惠迴墮恢暉慧悔晦誨喙
毒	讀髑獨黷瀆櫝犢牘	度妒賭肚睹蠹嘟都督杜堵篤鍍渡
際	霽髻寄繼繫稷薺技記忌騎悸覬劑紀季計祭妓驥濟鯽芰暨洎薊系冀躋既	急唧疾脊跡即寂楫屐居伋績擠吉犄饑譏擊羈機及乩嫉積激己汲藉亟岌吃瘠奇給稽借棘箕級圾嘰戟麂躋蹟籍濟輯畸嵇幾其肌期集戢飢雞極癘璣基磯畿姬勣
炤	召棹趙照兆肇罩櫂詔晁	釗召著朝昭招嘲沼找爪晁
詢	徇循尋潯旬洵璿巡荀馴	迅徇潠勛汛醺燻勳巽遜訊殉薰馴蕈訓
慶	磬親罄	請擎傾蜻輕檠清氫情青頃晴鯖卿
肺	吠芾費屝怫痱廢沸	菲啡肥誹霏斐妃腓扉匪翡非飛
斟	禎榛箴真診偵砧貞針珍楨甄臻	賑鎮疹鴆陣枕振朕診娠震縝
疆	僵江薑姜將繮漿韁	獎絳彊槳蔣講將強醬匠降
澡	蚤藻棗早	竈造噪皁譟躁糟鑿遭燥
咩	羋	篾蔑滅
跋	拔鈸	芭把杷吧琶霸扒壩耙疤捌巴靶爸叭八笆灞伯罷
接	皆街階偕結嗟揭	睫傑節櫛芥竭姐潔捷姊頡疥擷戒結桔孑藉羯桀借劫拮碣界解訐介屆詰誡截
戰	棧站綻湛暫佔蘸顫	斬嶄沾瞻展盞輾霑佔詹譫氈
羔	皋睪高糕膏篙	攪槁誥搞縞告杲稿
襟	津金觔巾禁斤今筋矜浸	晉饉噤燼覲進儘僅禁瑾近勁謹盡緊縉錦浸
胃	魏畏褽偽慰尉謂僞遺渭爲喂餵位未穌蔚衛味為	違葦帷崴緯薇圍唯煨猥桅諉逶鮪幃維威巍偎萎尾濰惟痿闈委危韋微洧娓偉為
熙	悉禧行谿羲嬉晰釐蟋吸唏曦希蹊稀淅溪畦奚犧譆西攜烯析兮嘻僖蜥晞棲膝犀熹	細繫席昔惜洗隙褶襲矽習鰓翕係夕蓆熄檄璽息汐系媳錫戲潟徙喜歙
波	坡陂潑	叵珀迫鄱剖破樸婆泊魄粕頗醱
奧	拗懊澳傲	鏖凹熬鼇翱遨媼襖敖嗷聱
誚	殼鞘俏蹺撬竅翹峭	樵巧雀憔蹺敲撬悄橇譙愀鍬瞧鵲喬僑橋翹
墀	持弛馳池踟匙遲栘	赤熾翅褫啻尺恥蚩癡呎侈癡叱敕吃齒斥嗤魑飭笞喫
義	詣劓羿浥異益議藝軼意刈鎰縊肄逸憶抑艾佚奕翌衣佾誼億役翳懿一掖屹易裔繹液弋帟邑腋曳溢臆翼亦囈蜴驛毅譯弈疫	咿儀揖怡飴咦依姨迆痍胰頤以遺噫移乙矣蛇衣伊夷誼尾漪圯蟻彝已壹一醫沂旖栘倚迤貽椅訑宜疑偯
負	富父復覆阜駙複傅咐訃腹附賦賻副婦付馥赴	孚拂斧夫芙敷莆父袱腐蝠菔氟腑撫符幅輔服鈇俯釜扶甫膚芾輻伏俘匐彿頫伕紼脯縛府浮涪趺福弗怫孵麩紱
貍	喱璃釐離麗犁犛驪籬狸梨黎罹漓蠡蜊	儷澧醴哩歷靂力慄立溧娌琍粒理利厲邐俐蠣蠡俚莉鬲慄禮麗鯉礫礪唳痢蒞癘壢戾曆吏笠浬例釙荔欐李鋰裡隸酈裡勵瀝
宋	訟頌誦送	淞崧悚慫嵩忪鬆聳
農	濃儂膿噥穠	弄
恬	闐田畋填甜	腆忝添靦天舔
氛	棻分吩芬紛	分汾焚奮糞粉忿墳憤份
笙	牲昇聲陞甥勝生升	賸省繩乘剩澠勝聖盛
腑	頫斧莆輔甫父脯俯釜府撫腐	氟縛匐馥覆附膚鈇複夫蝠紼扶芾幅紱袱賻傅付拂涪赴彿服賦芙俘訃富阜孚弗輻福浮腹伏符菔副復敷怫婦孵趺咐父麩負伕駙
哥	鴿胳割歌疙戈擱	革格隔個膈合鬲蛤鉻骼閤箇閣咯鎘各郃葛
間	餞澗尖劍鑒閒堅毽艱菅諫箭緘僭踐韉艦件健湔建殲肩檻見煎姦監賤縑濺薦腱奸兼漸鑑鍵箋	餞澗鑒劍儉尖閒堅毽艱減菅諫箭緘僭踐韉柬艦件健湔建撿簡殲瞼肩筧揀檻繭見煎姦剪鹼檢監賤縑濺薦腱奸囝漸兼鑑鍵箋
蜊	喱璃釐離麗犁犛驪貍籬狸梨黎罹漓蠡	儷澧醴哩歷靂力慄立溧娌琍粒理利厲邐俐蠣蠡俚莉鬲慄禮麗鯉礫礪唳痢蒞癘壢戾曆吏笠浬例釙荔欐李鋰裡隸酈裡勵瀝
酋	仇毬泅求裘球梂囚	蚯丘邱龜秋鞦鰍
吳	無梧巫毋蜈鼯亡蕪吾誣唔	巫勿騖寤軏圬屋嫵誤惡舞物汙堊烏兀誣務鎢悟塢霧五於侮捂鵡晤嗚戊午武伍污憮
稈	敢橄感趕杆桿	淦柑乾幹尷榦甘桿疳坩肝竿贛
判	拚盼畔叛	胖潘踫磐般蹣蟠攀盤槃
紂	胄晝宙咒縐籀皺冑	粥軸帚舟妯周肘啁週洲州
壅	鄘擁踴傭泳雍永慵湧庸勇蛹甬邕臃俑詠湧恿	鄘擁踴泳傭雍永慵湧庸勇傭甬蛹邕臃用俑詠湧恿
箱	廂瓖香鑲湘襄鄉相	橡餉翔鄉嚮相向象饗詳降響祥像巷庠想項享
廊	螂狼郎琅瑯榔	浪朗
榦	涵函含淦幹韓贛汗寒	乾悍疳漢尷感汗頷蚶罕稈肝酣趕憾竿旱頜甘柑和幹桿橄坩銲翰撼敢捍鼾桿瀚喊焊
沉	沈宸忱塵晨辰陳諶臣娠	襯趁琛讖櫬稱瞋疢
鍵	餞澗鑒劍閒毽諫箭僭踐艦件健建間檻見監賤濺薦腱漸鑑	尖儉堅艱減菅緘韉柬湔撿簡殲瞼肩筧間揀繭煎姦剪鹼監檢縑濺奸兼漸囝箋
艮	亙	跟亙根
餚	瑤姚榣崤窯僥遙謠搖餚爻洮堯淆	吆藥腰麼要妖窈樂舀鷂杳耀邀拗曜夭咬鑰喲
購	遘夠雊媾詬搆構垢	苟鉤狗溝勾枸句
柔	鞣揉蹂	肉
僱	固顧錮估告故雇	咕鼓鴣牯鵠穀滑家古骨罟股賈估蛄鈷菰呱蠱谷姑凸孤轂詁辜沽瞽
嶝	瞪凳磴蹬鄧	燈登等
甥	笙牲昇聲陞勝生升	賸省繩乘剩澠勝聖盛
悸	洎暨寄忌祭薊騎芰際劑繼薺記季稷髻霽技紀覬既計躋繫濟妓鯽驥冀	棘璣羈疾肌集脊己藉雞磯乩積幾績期屐機楫瘠嵇跡蹟基級極居戢畸姬畿其擊輯寂給犄飢及嫉癘幾唧箕麂擠急伋奇吉譏激圾即汲勣稽吃亟躋籍岌嘰濟戟饑
蜆	癬現僩霰險峴腺餡鮮羨憲獻顯限莧銑陷縣線蘚	僩纖峴餡涎顯限嫌莧銑舷暹銜啣鹹秈癬現險霰嫻祆姍腺閒鮮絃閑羨鹹憲獻仙弦陷掀縣線先賢蘚
汙	屋誣烏圬鎢惡嗚污於巫	武鵡晤騖巫侮吾悟塢亡誤誣務無吳午五毋伍寤戊惡鼯嫵唔物勿憮霧舞兀鎢捂軏梧蕪蜈堊
挨	埃哀唉哎	靄皚藹曖捱噯艾矮礙璦愛隘
鴕	駝佗馱跎陀沱	妥託柝脫橢拖唾拓
瞼	繭筧減囝檢撿柬簡揀剪鹼儉	件檻箋劍健僭見縑艦兼姦韉毽漸殲諫奸艱濺踐監箭間閒肩尖湔薦腱鍵建堅餞鑑鑒菅澗緘賤薦煎
平	馮枰憑蘋瓶萍屏評坪	娉乒
固	顧錮估告故僱	咕鼓鴣牯鵠穀滑家古骨罟股賈估蛄鈷菰呱蠱谷姑凸孤轂詁辜沽瞽
顰	頻瀕嬪貧	拼品姘聘牝
承	呈懲誠丞橙乘城成程盛澄	騁秤逞瞠撐稱
蜈	無梧巫毋鼯吳亡蕪吾誣唔	巫勿騖寤軏圬屋嫵誤惡舞物汙堊烏兀誣務鎢悟塢霧五於侮捂鵡晤嗚戊午武伍污憮
葉	攝捨涉曄謁夜麝社業舍射靨鄴咽拾設拽頁歙赦	椰捨甚耶噎冶什野也賒爺蛇舌奢琊
湍		糰團
準	准	肫諄屯
儉	瞼揀筧柬簡繭囝剪減撿鹼檢	餞澗尖劍鑒閒堅毽艱菅諫箭緘僭踐韉艦件健湔建殲肩間檻見煎姦監賤縑濺薦腱奸兼漸鑑鍵箋
達	靼韃瘩答怛	大躂搭打瘩褡答
撙		尊遵圳樽俊
擄	滷魯鹵櫓虜	蘆路盧露臚鑪鹿鱸麓戮顱僇爐碌氯嚕鷺廬陸錄穋祿瀘賂
馨	欣興心鋅新芯莘惺薪星辛腥猩訢昕	邢醒性興信幸芯形行刑倖杏尋悻釁陘省姓型硎
研	釅言雁宴艷硯嚥鹽顏咽巖厭贗簷閻沿彥諺驗堰焰延筵燄燕嚴炎唁淹豔妍饜癌晏	言釅雁宴兗演艷殷硯嚥鹽菸奄顏巖厭咽簷閻贗沿眼湮彥諺煙偃魘驗堰郾焰延筵儼燄燕焉嫣嚴炎唁醃淹衍豔妍鼴饜掩癌胭晏
耦	偶藕嘔	甌歐區鷗毆嘔噢
潛	鈐黔箝乾幹前鉗虔錢	倩淺鉛謙韆嵌歉纖愆遣籤塹搴仟千牽欠簽遷騫譴縴阡
鈉	那納訥吶捺娜	拿哪那
辱	汝入女褥孺乳茹	燸如濡汝入嚅女褥孺蠕乳儒茹
閘	札紮炸扎	搾炸柵扎渣吒乍喳蚱眨砟咋詐查
洸	幌謊胱光晃恍	韹湟獷隍磺蝗皇徨荒凰篁晃逛肓廣簧璜黃慌遑煌惶
徒	荼凸餘突塗屠途圖酴	土禿菟吐兔
琯	館莞管	盥棺關觀莞矜倌鸛灌貫慣官鰥罐冠綸
煬	烊鍚養佯揚瘍洋怏颺羊楊徉樣漾昜恙暘陽	鍚佯仰瘍鴦洋颺怏羊楊央徉秧樣漾恙鞅烊養泱揚殃癢昜暘氧陽
滯	智制痔致製蛭躓窒質雉峙幟稚炙痣識置輊至秩摯知緻治志誌	徵植脂梔直摭之址質泜芝值胝躑枝吱祉祇肢擲支趾執祗職汁咫只殖織卮紙隻芷止蜘知姪指氏旨
尺	呎齒恥褫侈	飭喫遲赤癡弛叱踟匙斥持馳池翅魑吃敕栘蚩啻笞熾墀嗤
壬	仁人兒任	刃衽妊紉稔仞忍軔任荏韌認飪賃
蹉	磋撮搓	措錯嵯厝挫銼撮
蘆	鑪盧瀘鱸廬爐臚顱	虜路僇嚕擄露錄鷺穋氯陸櫓滷賂戮麓魯鹵碌鹿祿
揹	杯盃卑背俾碑悲裨	北貝鋇倍背焙輩狽備臂邶憊悖被孛蓓
慾	裕瘉澦禦域籲嫗馭喻獄玉欲譽禺熨峪昱燠癒寓愈諭御谷鬱預語遇與煜芋育聿尉俞堉鬱豫浴毓	妤娛瘀宇逾褕竽蝓雨雩渝覦迂漁於語紆與噢齬餘餘俞歟羽虞盂隅榆敔愚魚圉禺禹嶼輿愉圄淤腴臾諛庾圩瑜予萸於
斛	瑚壺鬍鵠蝴胡糊湖葫囫弧狐	瓠互琥虎扈許惚唬乎戲呼戶忽滬楛沍護
鋇	貝倍背焙輩狽備臂邶憊悖被孛蓓	杯盃北揹卑背俾碑悲裨
我		臥窩沃斡萵齷倭渥渦握
岫	溴袖宿嗅臭秀鏽繡	脩宿朽休修咻羞
艱	縑肩間韉濺奸尖煎兼姦漸湔堅緘菅監殲箋	餞澗鑒劍儉閒毽減諫箭僭踐柬艦件健建撿簡瞼揀筧間檻繭見剪鹼檢監賤濺薦腱囝漸鑑鍵
澤	責窄嘖笮則賊咋擇	仄怎側
骨	罟股鼓賈凸鵠牯穀滑轂詁鈷瞽古蠱谷	咕顧鼓錮鴣牯鵠穀滑告家古僱罟股賈估蛄鈷菰故呱蠱谷姑凸孤轂詁辜固沽瞽
茆	泖卯	貿帽瑁貓耄冒矛懋髦錨貌毛茅茂
漩	縣渲眩玄炫絢璿鉉懸旋還	選晅萱絢懸還渲炫旋壎玄眩煖璿鉉宣暄諼軒喧縣
囑	屬拄煮矚主貯渚	諸逐軸朱蛀躅茱鑄硃助蛛箸誅術注珠豬薴祝築朮柱竺杼侏藷燭駐註佇株銖竹住
狀	壯撞	奘裝樁妝莊
傳	船撰篆轉僎賺	耑磚囀轉釧顓專川舛穿串喘
棘	急唧疾脊即寂楫伋吉擊及嫉汲亟岌藉吃瘠借圾級籍輯戢集極	唧霽髻寄脊跡際繼冀繫屐居績稷擠犄薺饑譏技記忌羈騎機乩激積覬己悸劑紀季奇給稽既箕計嘰祭戟麂妓蹟躋驥濟鯽畸嵇幾其肌芰期飢癘雞暨洎璣基薊系磯畿姬勣
痛	慟	童桐瞳統桶同筒僮恫彤銅潼通峒
修	咻羞脩休	袖溴秀岫繡臭朽嗅宿鏽
栽	哉災	宰載仔再在
每	鎂美	妹楣袂玫煤沒眉魅媚昧瑁梅莓沬寐媒黴枚湄
溘	髁嗑可課喀緙克刻恪客剋	軻坷稞棵渴磕可咳殼窠柯科刻顆苛蚵瞌蝌
睦	慕穆募墓木目沐苜幕暮牧	牡模拇姥姆母畝
穠	儂濃噥農膿	弄
冀	霽髻寄際繼繫稷薺技記忌騎悸覬劑紀季計祭妓驥濟鯽芰暨洎薊系躋既	急唧疾脊跡即寂楫屐居伋績擠吉犄饑譏擊羈機及乩嫉積激己汲藉亟岌吃瘠奇給稽借棘箕級圾嘰戟麂躋蹟籍濟輯畸嵇幾其肌期集戢飢雞極癘璣基磯畿姬勣
豐	豐諷峯風鋒楓封蜂烽瘋	俸諷逢縫馮鳳奉
涉	社攝捨葉舍拾射設歙麝赦	捨甚什賒蛇舌奢
膾	筷劊檜會塊儈快	
李	裏澧蠡鋰禮俚理浬娌裡醴邐哩鯉	荔琍儷利厲痢貍例欐莉曆礫勵離釐黎罹瀝慄隸漓蒞梨犛釙蠣驪狸靂蜊立粒礪壢唳力戾俐吏麗蠡鬲溧璃犁癘笠喱籬哩歷酈
涎	嫌銜嫻鹹舷啣弦閑賢閒絃	莧陷限獻蘚祆秈暹鮮纖霰先銑險線仙蜆顯癬腺羨餡僩掀憲現峴姍縣
起	綺杞啟稽啓乞豈	器憩旗淒祈谿悽琦琪汽耆麒企漆錡臍慼齊磧泣祁騎溪亟砌欺枝祇契棋畦奇訖戚迄柒崎淇緝七隻祺其期棄圻棲衹氣愒歧岐萋鰭妻
繒	憎增曾	贈
技	霽髻寄際繼繫稷薺記忌騎悸覬劑紀季計祭妓驥濟鯽芰暨洎薊系冀躋既	急唧疾脊跡即寂楫屐居伋績擠吉犄饑譏擊羈機及乩嫉積激己汲藉亟岌吃瘠奇給稽借棘箕級圾嘰戟麂躋蹟籍濟輯畸嵇幾其肌期集戢飢雞極癘璣基磯畿姬勣
菽	淑熟孰贖叔塾	樹橾術黍恕屬述漱豎書輸束殊數庶鼠倏藷樞梳戍暑薯蜀抒墅疏署蔬曙舒
聯	憐漣奩簾蓮濂鐮鰱連廉	瀲煉楝斂鏈臉鍊戀殮練
佳	傢袈加迦夾家痂茄葭豭嘉	夏稼鉀挾假賈戛夾架浹莢價甲嫁胛駕頰
鈞	均龜君軍	竣菌浚窘郡駿俊雋濬蕈峻
汍	玩丸完頑	惋彎灣莞碗蜿腕挽萬宛玩輓晚皖綰豌剜娩婉
髦	錨毛茅矛	懋泖貌貿帽茆瑁卯貓茂耄冒
懋	貌貿帽瑁茂耄冒	髦泖錨毛茆卯貓茅矛
邀	要妖吆夭喲腰麼	藥餚洮淆瑤崤要搖窈樂爻舀鷂姚榣杳僥遙謠耀堯拗曜窯夭咬鑰
捲	卷	倦卷雋捐鐫眷娟圈絹身涓鵑狷
衹	歧淇其琪旗齊琦耆麒棋騎祺臍畦鰭祁崎圻奇岐祇期祈枝錡	愒萋淒妻欺溪豈綺磧棄杞乞汽啟柒器棲企訖谿稽漆慼亟迄悽泣起契憩戚砌七緝氣
晦	匯繪賄慧卉諱會彙誨潰喙彗惠穢燴蕙	蛔賄會蟲詼輝茴揮虺回麾燬徽灰毀迴墮恢暉悔誨
瞽	轂凸股谷鵠滑蠱牯罟賈鼓穀古詁鈷骨	菰孤鴣告沽蛄僱咕辜錮顧鈷估僱姑呱固故骨家
唾	柝拓	妥託駝脫馱佗跎橢拖陀鴕沱
晏	豔研堰焰嚥諺彥雁沿燕驗饜釅贗厭咽淹艷燄宴唁硯	閻癌儼菸簷衍魘掩湮醃郾咽殷巖炎延研偃妍兗眼奄煙簷胭沿燕鹽鼴醃顏筵巖厭嚴淹言焉演嫣
叵	剖頗	醱破迫粕陂鄱樸魄波婆泊坡珀潑
穀	轂凸股谷鵠滑蠱牯瞽罟賈鼓古詁鈷骨	菰孤鴣告沽蛄僱咕辜錮顧鈷估僱姑呱固故骨家
邇	餌耳爾洱	兒而貳二
偏	扁翩篇	遍片胼騙便駢
靄	藹矮	哀噯璦捱哎愛曖艾埃隘唉皚挨礙
縉	覲浸盡燼晉進噤近禁僅勁儘	饉金矜緊津僅禁儘筋襟覲觔斤浸謹瑾錦巾今
蹤	鬃綜縱棕宗	綜糉從總縱傯
怩	妮尼泥霓呢倪	暱泥睨膩溺你擬妳旎匿逆
虐	瘧	
汛	迅徇潠巽遜訊殉馴蕈訓	徇循潯勛尋醺燻勳旬洵璿詢巡荀薰馴
輻	孚拂夫芙袱蝠菔氟符幅服扶芾伏俘匐彿紼縛浮涪福弗怫紱	富斧夫敷莆父復腐覆阜腑撫駙複輔傅鈇俯釜甫膚咐訃附腹賦賻副頫婦伕脯府付趺孵麩負馥赴
於	巫魚諛雩予竽愚禺虞圬屋惡蝓盂逾褕圩汙榆渝萸烏漁瑜誣鎢輿歟於腴妤隅嗚愉臾餘污覦俞娛	無與穀鬱尉梧誤舞癒玉語唔谷務悟五侮愈蕪聿羽獄蜈午淤堉瘀譽熨宇寤寓物吾兀塢昱紆峪鵡預豫域遇亡武伍慾禦俞芋馭御喻巫勿育雨予軏禹瘉迂嫵齬噢圉諭澦堊誣庾裕嶼鼯捂嫗憮籲晤戊圄敔毋騖禺惡煜欲鎢霧吳毓浴燠
礪	慄儷麗礫唳痢歷靂力慄立癘溧蒞壢戾曆琍吏笠粒例利厲釙荔欐俐酈隸蠣勵瀝鬲莉	禮喱澧醴麗犁哩鯉犛貍籬黎娌璃浬釐離理驪邐李鋰梨狸裡罹裡漓蠡蜊俚
剪	瞼揀筧柬簡繭儉囝減撿鹼檢	餞澗尖劍鑒閒堅毽艱菅諫箭緘僭踐韉艦件健湔建殲肩間檻見煎姦監賤縑濺薦腱奸兼漸鑑鍵箋
僮	瞳銅同潼桐峒童彤	通筒桶痛統恫慟
鍋	蟈堝郭	幗裹摑過果國猓槨
靼	瘩答達韃怛	瘩答搭大打褡躂
距	拒懼鋸巨颶遽倨劇苣句屨具鉅聚踞據瞿足炬俱	橘拘菊鋸居鞠莒跼疽齟桔局駒狙蛆舉車沮掬侷俱咀矩
斜	霞呷狎柙瑕黠諧頡遐擷洽邪勰鞋轄偕狹攜峽挾匣俠暇協脅	卸洩歇榭蝦蠍寫屑血廈楔蟹下嚇邂瞎契褻懈謝駭械燮解夏些瀉暇紲屜
隄	題堤蹄啼緹提	悌屜體剃嚏剔涕梯踢替銻逖惕
統	筒桶	童桐瞳慟同通僮恫彤銅潼痛峒
耕	庚更羹粳賡	亙埂哽更耿梗
破	迫樸泊魄粕醱珀	叵波鄱陂剖潑婆坡頗
央	殃泱鞅秧鴦	楊颺羊養昜漾洋鞅樣怏徉揚氧仰烊煬鍚瘍陽暘癢恙佯
屠	酴凸餘塗徒突途圖荼	土禿菟吐兔
嬉	悉禧行谿羲晰釐蟋吸唏曦希蹊稀淅溪畦奚犧譆熙攜烯西析兮嘻僖蜥晞棲膝犀熹	細繫席昔惜洗隙褶襲矽習鰓翕係夕蓆熄檄璽息汐系媳錫戲潟徙喜歙
聆	齡蛉菱櫺玲翎昤鴒泠苓凌陵綾鈴靈羚零伶	領拎令另嶺
鷥	撕司廝絲斯私思嘶	賜祀泗肆兕食飼巳嗣伺耜似寺駟姒俟思死四
先	鮮纖掀仙祆秈暹姍	莧陷限賢獻閒蘚涎鮮霰嫻銑險線蜆顯癬嫌弦啣閑腺羨絃餡僩銜鹹舷憲現峴縣
吼		猴逅厚候後堠鱟篌侯喉
旬	徇循尋潯洵璿詢巡荀馴	迅徇潠勛汛醺燻勳巽遜訊殉薰馴蕈訓
楔	燮屑解褻懈卸契瀉洩蟹駭邂榭械謝紲屜	寫血挾諧頡擷偕歇蠍邪斜些攜勰協鞋脅
目	慕穆募墓木沐睦苜幕暮牧	牡模拇姥姆母畝
囤	燉頓遁盾噸沌盹鈍臀豚飩屯	敦蹲惇盹躉墩吞褪
豬	諸誅朱珠茱株銖蛛硃侏藷	軸蛀躅鑄渚助拄箸術注主囑薴祝築朮貯柱竺杼屬煮燭駐註矚佇逐竹住
嘲	釗潮晁招着巢朝昭著召	櫂詔趙吵炤找罩剿肇沼爪勦兆抄鈔照召晁超炒棹著
瞧	樵憔譙橋僑翹喬	雀巧蹺鍬俏峭誚鵲翹竅悄鞘撬橇殼敲愀
彥	豔晏研堰焰嚥諺雁沿燕驗饜釅贗厭咽淹艷燄宴唁硯	閻癌儼菸簷衍魘掩湮醃郾咽殷巖炎延研偃妍兗眼奄煙簷胭沿燕鹽鼴醃顏筵巖厭嚴淹言焉演嫣
痿	葦尾娓猥諉偉洧緯鮪萎委	魏衛胃蔚維萎威未韋唯遺惟渭濰圍桅為崴味穌煨薇逶餵幃偽慰位危謂帷微巍偎褽尉喂闈畏違委
卷	倦痊絹蜷銓踡荃權全詮狷圈雋捲犬泉佺拳眷	娟勸捲倦券捐身畎狷犬甽鐫圈鵑涓雋眷絹
稻	蹈盜悼導道到倒	導島搗禱叨刀倒
沆	行	行吭桁杭航
淙	從叢	蔥匆樅囪從聰
盯	丁叮釘酊仃	頂訂釘鼎定酊錠
斯	嘶絲思廝私司鷥撕	思寺似伺兕食耜祀泗嗣巳駟賜飼肆四俟死姒
賣	脈麥邁	買埋霾
隊	兌碓對	堆
矛	茅髦錨毛	冒茆瑁卯泖茂懋貌耄貿貓帽
膽	疸撢	啗擔蛋單氮啖簞誕但澹淡旦丹耽憚彈石
痢	荔琍儷例利厲欐莉曆礫勵瀝慄隸蒞釙蠣靂立礪壢粒唳力戾俐吏麗癘鬲溧笠歷酈	裏貍醴李離鯉釐黎罹禮漓理浬梨驪狸蜊俚娌邐澧麗蠡犁璃鋰喱籬犛裡哩
宴	釅雁研艷硯嚥厭咽贗沿彥諺驗堰焰燄燕唁淹豔饜晏	言兗演研殷鹽菸奄顏咽巖厭閻簷沿眼湮煙偃魘郾延儼筵燕焉嫣嚴炎醃淹衍妍鼴掩癌胭
偵	禎榛箴斟真診砧貞針珍楨甄臻	賑鎮疹鴆陣枕振朕診娠震縝
瘉	裕澦禦域籲嫗馭喻獄玉欲譽禺熨峪昱燠癒寓愈諭御谷鬱預語遇與煜慾芋育聿尉俞堉鬱豫浴毓	妤娛瘀宇逾褕竽蝓雨雩渝覦迂漁於語紆與噢齬餘餘俞歟羽虞盂隅榆敔愚魚圉禺禹嶼輿愉圄淤腴臾諛庾圩瑜予萸於
勵	荔琍儷痢例利厲欐莉曆礫瀝慄隸蒞釙蠣靂立礪壢粒唳力戾俐吏麗癘鬲溧笠歷酈	裏貍醴李離鯉釐黎罹禮漓理浬梨驪狸蜊俚娌邐澧麗蠡犁璃鋰喱籬犛裡哩
鎬	顥涸號浩昊好耗鄗皓	蠔蚵嗥鶴號郝蒿好毫貉濠豪嚎壕
倔	觼蕨嚼劂掘訣鴃崛鱖絕玨覺獗厥腳抉孓譎爵攫蹶決噱角	觼蕨嚼劂掘訣鴃崛鱖絕玨覺獗厥腳抉孓嗟譎爵攫蹶決噱角
齬	雨語與宇庾敔噢圉禹予嶼羽圄	瘉澦域妤娛瘀馭獄逾峪昱燠褕蝓竽雩渝覦預漁迂語於與紆煜慾芋育餘餘俞歟堉鬱豫毓虞裕盂禦隅籲嫗榆喻愚魚玉欲譽禺熨輿癒寓愈愉諭御谷鬱淤腴臾遇諛圩聿尉瑜予萸浴於
昌	鯧娼猖倡倀	腸嘗暢嫦常嚐徜敞萇氅場裳唱倡悵償廠長
故	固顧錮估告僱	咕鼓鴣牯鵠穀滑家古骨罟股賈估蛄鈷菰呱蠱谷姑凸孤轂詁辜沽瞽
氓	芒忙茫盲杗	蟒莽
蛤	革格隔膈合鬲閤閣咯鎘骼郃葛	個戈哈割鉻胳鴿箇歌疙各葛擱哥
疏	漱庶束署戍曙數輸術梳述舒恕書殊橾墅抒豎樹蔬倏樞	鼠漱黍庶束署戍曙輸數薯術贖梳菽述暑舒叔淑恕蜀書藷殊塾屬橾墅抒豎樹蔬倏樞熟孰
其	唧旗祈跡屐琦居績琪耆犄麒錡饑譏臍齊祁羈騎機乩鰭積激枝祇棋畦奇稽箕嘰躋蹟只崎淇畸嵇祺幾肌期飢癘圻雞衹璣基歧岐磯畿姬勣	霽憩寄擊悸忌騎溪己藉紀瘠訖計圾籍洎躋既器唧脊豈楫稷慼泣覬劑吃季借稽戚祭麂驥鯽七幾集棄愒欺萋啟淒谿悽際伋企吉薺漆磧及砌亟啓棘迄妓濟綺芰戢乞氣薊系冀急髻疾繼繫寂即擠汽起杞技記嫉汲岌契給級柒戟輯緝暨極棲妻
轍	澈坼撤蜇哲掣徹褶摘摺謫折輒懾	浙車赭者宅鷓蔗遮着這扯螫著
惶	凰隍遑皇徨簧璜黃湟篁韹煌磺蝗	幌恍慌荒謊肓洸晃
童	桐瞳同僮潼銅彤峒	統慟桶筒恫痛通
科	窠柯軻顆蚵稞棵瞌蝌磕刻苛	緙咳坷喀恪剋可嗑殼溘課克渴客刻髁
畔	判拚盼叛	胖潘踫磐般蹣蟠攀盤槃
鋸	拒拘懼巨颶居遽疽倨劇苣屨句具鉅聚踞駒狙蛆車據沮瞿距足炬俱	橘拒拘菊懼巨炬颶居鞠莒遽跼疽齟倨劇苣桔屨局句具鉅聚踞駒狙蛆舉車據沮掬瞿距足侷俱咀矩
齡	綾零蛉櫺昤菱泠靈羚玲鈴苓伶鴒聆陵凌翎	拎令另嶺領
掘	觼蕨嚼劂訣鴃崛倔鱖絕玨覺獗厥腳抉孓譎爵攫蹶決噱角	蹶嗟倔
沼	找爪	櫂詔釗罩趙着招肇兆著朝炤召棹嘲照昭晁
壺	囫糊狐鵠胡鬍蝴葫湖弧斛瑚	戶滬虎沍扈乎瓠忽惚互琥唬戲護楛許呼
則	責窄嘖笮賊澤咋擇	仄怎側
撿	瞼揀筧柬簡繭儉囝剪減鹼檢	餞澗尖劍鑒閒堅毽艱菅諫箭緘僭踐韉艦件健湔建殲肩間檻見煎姦監賤縑濺薦腱奸兼漸鑑鍵箋
翳	屹藝肄軼刈誼囈縊逸佾溢劓疫懿鎰毅義邑億液佚役易羿弋裔蜴驛弈帟譯翌異益臆亦艾腋曳詣議意繹憶掖浥奕一抑翼衣	漪尾咦姨椅壹蟻飴旖誼偯迤栘移以彝夷已遺沂宜咿醫頤伊噫疑乙怡貽揖訑迆蛇矣圯胰儀一衣痍倚依
畦	悉旗禧行谿祈羲嬉琦晰琪蟋耆麒吸釐錡唏曦希臍齊祁騎蹊稀淅溪枝祇棋奚奇犧譆熙攜烯西析崎淇只兮祺其嘻期僖蜥圻晞棲衹膝歧岐犀熹鰭	器憩細啟萋淒谿豈悽繫席汽昔惜洗企漆起隙杞慼磧褶泣溪亟砌欺襲矽契習鰓係翕稽訖戚啓迄柒夕蓆熄緝七檄綺棄乞璽棲息錫媳氣愒汐戲系潟妻徙喜歙
座	祚作做鑿坐柞	昨左作佐砟
牟	眸繆謀	某
逵	夔葵睽魁揆奎	匱愧窺盔餽虧喟傀簣潰
柏	卜鈸博蔔鉑駁箔荸脖搏檗渤帛薄白膊勃泊伯舶	玻菠薄亳般薜擘蘗簸檗剝跛缽播撥
篤	賭堵睹肚	髑杜瀆蠹櫝讀犢黷度鍍嘟渡肚都督妒牘毒獨
府	脯撫斧腑輔莆父俯釜腐頫甫	孚富拂夫芙敷父復袱蝠菔氟覆阜駙符複幅服馥傅鈇扶咐膚芾訃附輻腹俘賦伏匐賻彿副婦伕紼縛付涪浮趺福弗怫孵負麩紱赴
嘈	槽漕曹	草糙操
膘	標杓鏢鑣彪	婊錶表鰾
棲	悉禧行淒谿悽羲嬉晰釐蟋吸漆唏曦希慼蹊稀淅溪欺畦奚戚犧柒譆熙攜烯西析七兮嘻僖蜥晞熹膝犀萋妻	憩席錡臍騎祇鰓翕訖蓆淇祺器祈豈琪昔惜麒齊泣襲枝係稽夕崎熄檄棄錫愒歧徙喜細啟企耆隙磧褶祁砌亟習奇啓迄綺其圻乞璽息氣岐系鰭歙旗繫琦汽洗起杞矽契棋畦只緝期衹汐媳戲潟妻
浥	屹藝肄軼刈誼囈縊逸佾溢劓疫懿鎰毅義邑億液佚役易羿弋裔蜴驛弈帟譯翌異益臆腋亦艾曳詣議意繹憶掖翳奕一抑翼衣	漪尾咦姨椅壹蟻飴旖誼偯迤栘移以彝夷已遺沂宜咿醫頤伊噫疑乙怡貽揖訑迆蛇矣圯胰儀一衣痍倚依
蔆	稜楞	愣冷楞
木	慕穆募墓目沐睦苜幕暮牧	牡模拇姥姆母畝
施	濕屍噓詩失獅溼師蝨	室十恃螫屎筮史提匙奭實勢嗜舐豉矢射市食士事仕拭碩拾識蝕試世釋柿逝是駛適塒侍示時什飾豕軾誓弒始氏式噬石使視
妝	莊裝樁	壯撞狀奘
廁	伺次側冊賜刺測策惻	疵祠詞瓷茨雌辭慈此差磁
騎	霽旗髻祈寄際繼繫琦稷琪耆麒薺錡臍記技齊忌祁悸鰭覬劑枝祇棋畦紀季奇計祭妓只驥濟崎淇鯽祺其芰期圻暨洎衹歧岐薊系冀躋既	憩擊溪己藉瘠訖圾籍畸璣磯躋飢器唧脊豈楫居績譏慼泣羈吃借稽戚麂蹟七幾集棄愒欺萋犄姬啟淒谿悽伋企吉漆饑磧機及乩砌亟奇啓棘迄箕濟嵇其綺戢雞乞氣基急疾跡即寂屐擠汽起杞激嫉汲積岌契給級柒嘰戟輯緝癘肌期極棲妻畿勣
摹	膜蘑摩磨模糢謨魔	抹墨脈漠沒麼歿膜末貊默茉莫磨摸陌沫寞驀秣
喂	魏畏褽偽慰尉謂僞遺渭爲餵位未胃穌蔚衛味為	違葦帷崴緯薇圍唯煨猥桅諉逶鮪幃維威巍偎萎尾濰惟痿闈委危韋微洧娓偉為
語	芋與馭御喻育宇雨予禹瘉寓譽禺鬱尉齬噢癒圉諭玉澦煜欲谷庾裕嶼昱愈聿峪嫗籲預豫圄域浴羽獄毓遇堉慾敔禦熨俞燠	與諛虞鬱尉癒逾玉漁谷輿於愈聿妤隅羽獄淤堉榆譽覦瘀熨宇雩竽愚寓蝓萸昱紆峪預豫域愉臾遇慾禦俞娛芋馭御喻魚育雨予禹瘉迂齬噢圉褕諭澦渝瑜庾裕嶼腴嫗籲餘圄敔禺盂圩煜欲歟毓浴燠
熊	雄	兄兇洶胸匈
妄	旺王忘望	罔尢網往魍王汪亡枉惘輞
腮	鰓塞	賽塞
孱	禪蟾嬋巉璨饞澶讒潺蟬毚單燦纏	懺攙儳慘慚鏟蠶殘剷摻諂餐產闡參羼
沽	咕姑估鴣孤蛄鈷家辜菰呱	顧錮鼓牯鵠穀滑告古僱骨罟股賈估鈷故蠱谷凸轂詁固瞽
幡	番蕃繙翻帆	氾犯範泛梵礬販反藩汎蕃樊墦凡飯煩範釩繁返帆
濘	佞	檸獰嚀寧能擰凝
喇	啦拉	落啦拉臘蠟邋剌辣
齋	摘齊	債宅責窄祭寨翟
察	搽茶查	差剎喳叉岔詫插
俑	擁泳踴永湧勇甬蛹臃詠湧壅恿	擁鄘傭臃邕雍慵用庸壅傭
彬	檳豳濱瀕繽賓儐	儐鬢臏殯
琪	歧淇其旗齊琦耆麒棋騎祺臍畦鰭祁崎圻奇岐衹祇期祈枝錡	愒萋淒妻欺溪豈綺磧棄杞乞汽啟柒器棲企訖谿稽漆慼亟迄悽泣起契憩戚砌七緝氣
將	羌江彊薑僵絳疆姜鏘繮漿醬搶降嗆槍腔鎗強韁匠	薔戕江彊薑蔣講僵檣獎絳槳疆姜漿搶醬降嗆強繈韁牆匠
腫	種塚踵	湩終種仲忠鐘重衆盅忪眾衷鍾中
回	蛔迴茴	賄會彙蟲彗潰詼燴蕙繪穢輝匯揮卉虺燬麾徽灰毀諱惠墮恢暉慧悔晦誨喙
潸	扇姍縿刪山舢煽跚杉衫羶珊芟	鱔扇膳禪擅疝訕繕汕贍煽善閃單陝
討		檮韜絛逃桃燾啕淘洮陶萄套饕掏濤滔
乓	磅滂	胖膀旁螃龐徬
彫	刁凋叼碉鯛貂雕	掉釣吊調弔
蘇	甦穌囌酥	溯嗉訴塑速縮粟宿俗蓿素夙肅簌
攜	悉禧行谿羲嬉晰釐蟋吸唏諧曦希頡擷蹊邪稀淅溪勰鞋畦奚犧偕譆熙西烯析兮挾嘻僖蜥晞棲斜膝犀熹協脅	卸細洩歇席繫榭蠍昔惜洗屑寫血隙楔褶蟹邂襲矽契習褻懈鰓係翕謝駭夕械蓆熄燮解檄瀉歙璽息錫汐媳潟些戲系徙喜紲屜
對	隊兌碓	堆
佈	怖簿鈽步埠不布部	捕埔不補哺卜
嶇	蛐區曲趨屈瞿圈驅砠軀蛆	趣劬取漆曲麴齲瞿渠娶衢璩去
鬧		呶瑙惱橈腦鐃撓
籥	粵越嶽耀閱悅躍月樂鑰刖軏藥嶽曜說玥	曰約
怡	咦姨飴疑貽誼訑迤蛇栘移彝夷遺沂圯胰儀宜一痍頤	漪蟻藝屹肄軼刈誼囈迤縊以逸佾已溢劓醫疫噫乙懿鎰毅揖義迆邑億液役佚易羿倚尾弋裔蜴椅壹驛弈旖譯帟翌異益偯臆亦艾腋曳咿議詣意伊繹憶掖浥翳矣奕一翼抑衣依
窮	瓊穹	穹
把	靶	鈸芭杷吧琶拔霸扒壩耙跋疤捌巴爸叭八笆灞伯罷
緞	鍛段斷	端耑短
廾	礦鞏共汞拱	共攻工宮紅蚣恭躬肱功釭弓供貢龔公
啪	拍趴葩	杷排牌帕爬耙派怕扒俳琶徘湃
忘	旺妄王望	罔尢網往魍王汪亡枉惘輞
冠	盥綸關貫鸛慣倌罐灌莞官鰥矜觀棺	盥綸關貫管鸛慣倌罐琯灌莞官鰥矜觀棺館
置	智制痔致製蛭躓窒質雉峙幟稚炙痣識輊至滯秩摯知緻治志誌	徵植脂梔直摭之址質泜芝值胝躑枝吱祉祇肢擲支趾執祗職汁咫只殖織卮紙隻芷止蜘知姪指氏旨
簿	埠佈鈽布不怖部步	卜捕補不埔哺
晤	鎢誤惡戊勿悟塢霧騖物寤軏堊兀務	無巫毋圬屋梧嫵惡舞汙烏吾誣鎢吳五侮鼯於蕪捂鵡憮嗚蜈午亡武伍污唔
澄	呈懲誠承丞橙乘城成程盛	騁秤逞瞠撐稱
桐	童瞳同僮潼銅彤峒	統慟桶筒恫痛通
硿	倥崆空	倥孔恐控空
飴	咦姨疑怡貽誼訑迤蛇栘移彝夷遺沂圯胰儀宜一痍頤	漪蟻藝屹肄軼刈誼囈迤縊以逸佾已溢劓醫疫噫乙懿鎰毅揖義迆邑億液役佚易羿倚尾弋裔蜴椅壹驛弈旖譯帟翌異益偯臆亦艾腋曳咿議詣意伊繹憶掖浥翳矣奕一翼抑衣依
笛	迪狄嘀嫡犒荻的敵鏑滌芽翟	氐娣邸柢第地砥遞棣締帝的牴低抵弟蒂詆滴底諦
桶	筒統	童桐瞳慟同通僮恫彤銅潼痛峒
屐	畸姬畿其璣羈肌犄飢癘雞磯乩幾唧積箕幾奇譏激績期機嵇跡勣稽蹟基躋嘰居饑	洎棘疾暨忌祭集脊己騎藉芰劑幾記楫瘠覬紀計級極妓冀戢擊寄輯寂給薊及嫉際幾唧麂繼擠急伋薺吉季圾即稷髻霽技汲吃亟既悸躋籍繫岌濟鯽戟驥
梯	剔踢	緹題隄悌銻堤涕蹄惕替提剃啼嚏逖體屜
衣	咿詣劓揖羿浥異益議藝軼意刈鎰依縊肄逸憶噫抑艾佚奕翌伊佾誼億漪役翳懿壹一掖醫屹易裔繹液弋帟邑腋曳溢臆翼亦囈蜴驛毅義譯弈疫	劓羿浥益藝軼鎰姨痍肄頤憶遺矣佚翌伊夷一屹栘貽溢臆囈訑疑偯咿揖議意刈依以噫移乙蛇役圯億蟻沂繹弋迤腋毅譯儀詣怡咦縊逸抑漪彝懿壹醫倚液帟翼義疫飴異迆胰艾奕佾誼尾翳已掖易裔旖邑曳椅亦蜴驛宜弈
舔	腆忝靦	添闐田天恬畋填甜
嫌	銜嫻鹹舷啣弦閑賢閒絃涎	莧陷限獻蘚祆秈暹鮮纖霰先銑險線仙蜆顯癬腺羨餡僩掀憲現峴姍縣
薴	鑄住箸杼助註駐柱蛀注佇祝	主軸築朱諸茱矚銖囑朮築屬燭煮渚竹竺拄藷侏硃誅蛛貯躅逐豬珠株
廓	括蛞擴闊	
芣		否缶
罵		瑪嬤痲媽麻螞馬嘛嗎蟆碼麼
麴	劬渠衢瞿璩	趨嶇去娶取趣瞿漆蛆屈齲圈砠曲區蛐軀驅
朮	軸竹築築燭竺躅逐	主杼薴註柱諸朱茱矚銖囑屬煮鑄住渚助佇蛀藷拄侏硃誅蛛箸貯駐注豬祝珠株
戟	幾脊己擠幾濟給麂	洎棘璣羈暨疾忌肌祭集脊騎藉芰雞磯乩劑積幾記績期機屐瘠楫跡嵇覬紀蹟基計級極居妓冀畸戢姬畿其擊寄輯寂犄薊及飢嫉癘際幾唧箕繼急伋薺奇吉譏激季圾稷即髻霽汲技稽勣吃亟既悸躋籍繫岌嘰濟鯽驥饑
鎘	郃革隔格咯骼閣膈閤葛鬲蛤	哥歌各戈疙個箇鉻擱割胳葛鴿
退	蛻	推腿頹
宮	躬供龔釭紅蚣公攻恭共工肱功弓	供鞏汞礦共廾拱貢
詬	購構雊垢遘媾夠搆	勾狗句枸鉤溝苟
欣	心薪訢莘昕鋅辛新芯馨	信釁尋芯
鼬	幼誘宥右柚祐有侑莠又囿佑釉	遊幽黝猶猷遊攸油悠由牖鈾有郵友疣莠酉尤優魷憂
鏝	蔓慢漫幔曼縵	蠻屘蹣漫鰻饅滿瞞
再	載在	宰災栽載仔哉
競	鏡靜敬徑淨勁痙逕竟靖境	井精荊兢警旌京經粳菁驚頸涇晶鯨睛莖阱憬璟景更
曙	數漱墅術豎恕庶樹束倏署述戍疏	鼠黍署輸數薯贖梳菽暑舒叔淑蜀書藷殊疏塾屬橾抒蔬樞熟孰
榮	鎔蓉榕戎容熔融絨溶茸嶸	茸冗
茫	氓芒忙盲杗	蟒莽
嘴		堆醉最罪蕞
睜	癥諍爭徵丁猙掙箏怔崢錚症蒸正	政整拯掙幀証鄭證症正
灣	彎蜿莞豌剜	萬玩蜿宛碗莞輓汍婉頑晚娩腕綰皖惋挽丸完
爪	找沼	櫂詔釗趙炤罩肇朝抓嘲昭着兆照召晁撾棹著招
嬤	媽嗎	螞碼痲麼瑪嘛麻罵嗎馬蟆
唸	念廿	輦碾黏拈攆年輾撚捻涊
迭	碟跌耋牒蝶絰諜喋疊	爹
貽	咦姨飴疑怡誼訑迤蛇栘移彝夷遺沂圯胰儀宜一痍頤	漪蟻藝屹肄軼刈誼囈迤縊以逸佾已溢劓醫疫噫乙懿鎰毅揖義迆邑億液役佚易羿倚尾弋裔蜴椅壹驛弈旖譯帟翌異益偯臆亦艾腋曳咿議詣意伊繹憶掖浥翳矣奕一翼抑衣依
傲	拗懊澳奧	鏖凹熬鼇翱遨媼襖敖嗷聱
知	智制脂痔梔致之製蛭躓窒泜雉質芝胝枝吱峙祇幟肢支稚祗炙痣識汁置輊只至織卮滯隻蜘秩摯氏緻治志誌	智徵制脂植痔梔直致摭之製蛭址躓質窒雉芝泜值胝躑枝吱峙祉幟肢支祇稚執祗趾職炙痣識汁咫置輊只至殖織卮滯紙隻芷止蜘秩摯姪擲氏緻治志指旨誌
歌	鴿胳割疙戈擱哥	革格隔個膈合鬲蛤鉻骼閤箇閣咯鎘各郃葛
鏑	荻迪的犒嘀翟狄滌笛芽敵嫡	滴低締底帝的地蒂第氐牴娣砥遞諦弟柢棣邸抵詆
艇	挺梃	庭蜓亭汀婷廳廷聽停霆
藐	緲杪杳渺邈眇秒	苗繆廟描瞄妙
巨	拒懼鋸颶遽倨劇苣句屨具鉅聚踞據瞿距足炬俱	橘拘菊鋸居鞠莒跼疽齟桔局駒狙蛆舉車沮掬侷俱咀矩
睹	肚篤賭堵	讀度妒蠹督毒牘鍍嘟瀆犢渡髑都黷肚獨杜櫝
稍	捎梢燒	少哨韶紹杓芍邵勺召
祥	降庠翔詳	橡香餉鄉嚮相向象饗廂鑲響像瓖箱湘巷想項襄享
篙	皋睪高羔糕膏	攪槁誥搞縞告杲稿
淦	幹贛榦	乾竿甘疳柑尷感幹桿橄坩敢桿稈肝趕
想	響享餉饗	橡香翔鄉嚮相向象詳降廂鑲祥像瓖箱湘巷庠項襄
弗	氟縛匐夫蝠紼扶芾幅孚輻紱袱福浮伏符菔拂涪怫彿服芙俘	富馥覆附膚俯鈇複府夫腑腐頫甫阜腹賻副傅復釜敷付撫斧孵赴婦莆趺輔咐父麩脯賦負駙伕訃
剴	愷楷凱慨豈	開咳揩愒愾慨
醞	韻慍暈蘊運員熨孕	勻允耘氳隕筠昀紜暈芸雲
踢	梯剔	緹題隄悌銻堤涕蹄惕替提剃啼嚏逖體屜
彰	璋蟑樟獐章張漳	瘴脹丈賬帳掌障仗長杖漲幛
嘟	都督	髑杜瀆蠹櫝堵讀睹犢篤黷賭度鍍渡肚妒牘毒獨
饗	餉響享想	祥像湘詳襄嚮降翔庠鄉鑲瓖橡巷廂象箱香項向相
姜	僵江薑疆繮將漿韁	獎絳彊槳蔣講將強醬匠降
仕	拭恃式軾適是柿飾奭氏士使視螫弒市示試豉噬誓筮室勢侍世嗜識逝事釋舐	豕屍匙溼獅蝨使拾詩碩失十蝨噓始塒石蝕實食施時提史師濕屍矢什屎射駛
丫	押煆鴨呀壓鴉	訝啞衙涯雅亞蚜氬軋押芽牙疋
璋	獐漳蟑樟彰章張	脹丈障賬長仗掌幛漲帳杖瘴
閡	嗑合蓋河郃翮和紇闔盍核荷貉禾曷劾盒何褐閤涸	嚇郝和訶喝鶴賀暍荷赫呵
歹	逮	待迨代大貸黛逮殆戴玳呆袋岱帶怠
縑	箋監間尖肩湔兼姦堅韉漸菅殲奸緘艱濺煎	件檻劍健僭見艦毽漸諫囝檢柬簡濺減筧踐監箭間閒薦腱鍵剪建鹼瞼繭餞鑑鑒澗賤撿揀儉薦
韜	滔濤絛掏饕	洮桃討濤萄陶燾套檮淘逃啕
雊	購構垢遘媾夠詬搆	勾狗句枸鉤溝苟
鋰	禮澧醴浬理哩鯉邐李裡裡蠡俚娌	儷哩歷靂力慄立溧黎琍粒璃離利厲狸俐蠣漓蠡莉鬲慄喱麗犁礫礪唳痢犛貍籬蒞癘壢戾曆吏笠釐例釙荔驪欐梨罹隸酈勵瀝蜊
寮	遼嘹僚繚燎聊潦寥撩療	廖燎了暸撩料瞭
糕	皋睪高羔膏篙	攪槁誥搞縞告杲稿
撥	玻菠般剝缽播	卜鈸博蔔鉑駁箔荸脖搏蘗檗跛播渤帛薄亳白柏膊薜勃泊簸伯舶擘
呶	鐃撓橈	瑙惱鬧腦
善	汕擅繕單扇訕膳疝禪煽贍鱔	芟閃扇陝羶衫跚縿山煽珊潸姍刪舢杉
留	榴瘤泵劉瀏硫琉流遛	餾霤六陸溜鉚柳
趙	櫂詔罩晁肇兆炤棹照召	找釗晁招着著朝沼爪嘲昭召
梭	莎縮嗦娑唆簑蓑	索瑣所鎖
演	眼偃魘郾衍鼴兗儼掩	釅言雁宴研艷殷硯嚥鹽菸奄顏咽巖厭贗簷閻沿湮彥諺煙驗堰焰延筵燄燕焉嫣嚴炎唁醃淹豔妍饜癌胭晏
苒	染冉髯	然燃髯
霤	餾陸六溜	留劉柳泵琉瀏流瘤溜鉚遛硫榴
賀	赫鶴暍郝嚇荷和喝	褐劾訶曷荷禾郃何嗑河閤呵閡涸闔盒盍翮核合紇貉和蓋喝
蕃	繙礬番藩墦樊凡煩翻釩幡繁帆	氾繙犯範泛梵礬番販反藩汎樊墦凡飯煩翻範釩幡繁返帆
嚐	場常長裳腸萇嫦償嘗徜	場暢倀昌倡猖敞鯧唱娼廠悵氅
皁	竈造噪譟躁燥	蚤糟鑿澡遭藻棗早
畎	甽犬	蜷卷犬權圈詮銓勸踡佺全荃券泉痊拳
情	請擎檠晴傾	請親傾蜻輕清氫頃青鯖磬卿慶罄
痠	酸	蒜算
塗	酴凸餘突徒屠途圖荼	土禿菟吐兔
事	室恃螫筮奭勢嗜舐豉市士仕拭識試世釋柿逝是適侍示飾軾誓弒氏式噬使視	濕詩十施屎師史匙提矢射食碩拾蝕駛塒屍噓時什溼豕獅失始蝨實石使
鉸	較勦餃姣皎狡腳僥繳攪角絞剿矯	教礁較澆跤姣轎驕窖郊鮫嬌膠焦詨校叫交椒蛟覺醮嚼蕉
挖	窪蛙媧哇呱	娃襪瓦
邑	詣劓羿浥異益議藝軼意刈鎰縊肄逸憶抑艾佚奕翌衣佾誼億役翳懿一掖屹易裔繹液弋帟腋曳溢臆翼亦囈蜴驛毅義譯弈疫	咿儀揖怡飴咦依姨迆痍胰頤以遺噫移乙矣蛇衣伊夷誼尾漪圯蟻彝已壹一醫沂旖栘倚迤貽椅訑宜疑偯
肌	唧跡畿屐居績犄饑譏羈激機乩積奇稽箕嘰躋蹟畸嵇其癘幾期雞璣基磯飢姬勣	急唧霽髻疾脊寄際繼寂即繫楫伋稷擠吉薺技記擊忌騎及悸嫉汲覬己亟藉劑岌紀吃季瘠給借棘計級祭圾戟麂妓驥籍濟鯽輯幾芰戢集暨洎極薊系冀躋既
暉	墮灰麾揮恢詼輝徽	諱茴蟲晦蕙燴燬彙彗虺賄悔回迴卉誨潰惠毀喙慧繪穢會蛔匯
算	蒜	痠酸
繈	搶強	鎗牆槍彊鏘腔羌薔嗆戕將檣搶強
私	嘶絲思斯廝司鷥撕	思寺似伺兕食耜祀泗嗣巳駟賜飼肆四俟死姒
夫	孚拂芙敷袱蝠菔氟符幅服鈇扶膚芾輻伏俘匐彿伕紼縛浮涪趺福弗怫孵麩紱	孚富拂斧芙莆敷父復袱腐蝠菔氟覆阜撫腑符駙複幅輔服馥傅鈇俯釜扶甫膚咐芾訃附輻腹俘賦伏匐賻彿副頫婦伕紼脯縛府付涪浮趺福弗怫孵負麩紱赴
零	綾蛉櫺昤菱鴒泠靈羚玲鈴苓伶齡聆陵凌翎	拎令另嶺領
慨	凱咳愷愾豈愒剴楷	凱咳愷開愾豈揩愒剴楷
訢	欣薪鋅辛心新馨芯莘昕	信尋釁芯
鳩	啾揪糾	酒玖赳舊究糾救咎臼舅灸廄九就韭柩久疚
糰	團	湍
輝	麾恢徽揮灰暉詼墮	蛔賄會彙蟲彗潰燴繪蕙穢匯茴卉虺回燬毀諱惠迴慧悔晦誨喙
舐	拭恃式軾適是柿飾奭氏士使視螫弒市示試豉仕噬誓筮室勢侍世嗜識逝事釋	豕屍匙溼獅蝨使拾詩碩失十蝨噓始塒石蝕實食施時提史師濕屍矢什屎射駛
念	唸廿	撚輦攆涊輾捻碾年拈黏
斂	瀲煉楝鏈鍊戀殮練	憐漣奩簾蓮濂鐮臉聯鰱連廉
媛	院緣源員願原轅願園圓援騵怨猿遠湲元爰袁苑沅垣	緣員原園鳶圓援遠湲宛袁沅冤院源願轅願騵怨猿元爰苑垣淵鴛
壤	嚷攘	瓤讓攘禳
衍	眼偃魘郾鼴兗儼掩演	釅言雁宴研艷殷硯嚥鹽菸奄顏咽巖厭贗簷閻沿湮彥諺煙驗堰焰延筵燄燕焉嫣嚴炎唁醃淹豔妍饜癌胭晏
腦	瑙惱	鬧撓橈鐃呶
鑰	越玥藥月軏嶽閱要悅樂鷂粵耀拗曜刖說躍籥	約吆餚洮淆腰麼瑤崤要妖搖窈爻舀姚榣杳僥遙謠邀堯窯夭咬喲曰
國	摑幗	鍋蟈郭裹過堝果猓槨
拳	荃蜷銓卷權全詮犬泉痊佺踡	券畎圈甽犬勸
篠	小曉	梟嘯逍囂酵哮消削硝銷效笑霄驍校簫肖傚嘐瀟蕭孝學宵
氬	訝軋亞	啞衙涯鴨呀壓鴉雅亞蚜丫押煆芽牙疋
芥	解介借屆疥誡戒界藉	睫傑節櫛竭姐揭潔捷姊頡擷階結桔孑接羯皆桀劫偕拮碣嗟解訐街詰截
密	泌糸汨蜜祕冪謐覓	靡瀰米謎敉糜弭瞇咪迷麋彌
鞣	柔蹂揉	肉
琵	陂疲脾皮沘埤枇陴鈹罷紕毗啤鼙裨	劈披譬仳匹否媲丕霹痞僻壞闢鈹癖屁被紕批闢疋
竈	造噪皁譟躁燥	蚤糟鑿澡遭藻棗早
垓	賅該	蓋改丐溉鈣概
韶	勺芍杓	召邵紹捎哨燒少稍梢
跆	薹颱苔擡檯臺臺	泰苔汰態胎太
忸	鈕扭紐	妞女拗牛
碩	十提數率射食爍妁鑠勺拾蝕帥塒蟀時什朔實石	濕詩室恃施螫屎筮師史匙奭勢嗜舐豉矢市士事仕拭識試世釋柿逝是駛適噓屍侍示飾豕軾溼獅失說誓弒始氏式蝨噬使視
借	急唧芥疾脊即寂吉疥擊及戒嫉藉吃棘級圾籍界輯解介集屆極誡	睫傑節櫛竭寄跡際繼姐居績擠揭薺潔捷姊譏頡技記擷階忌騎激機結積己桔孑接羯劑皆桀紀季奇給稽劫偕嘰拮碣箕祭計妓濟鯽嗟畸解幾其肌訐期街雞詰基系冀飢既截
枯	骷窟哭	庫苦酷楛褲
狹	霞峽黠挾轄呷遐匣洽狎柙斜瑕暇俠	夏廈下嚇暇蝦瞎
鍚	烊佯揚瘍洋颺羊楊徉昜暘陽煬	泱養仰鴦怏殃央秧癢樣漾恙氧鞅煬
拍	啪	派排牌俳徘湃
湎	沔勉靦冕娩緬偭免	棉面綿麵眠
鄭	政掙幀証證症正	癥諍爭徵丁猙拯掙箏整怔睜崢錚蒸正
嚷	壤攘	瓤讓攘禳
奢	賒	社攝捨甚涉葉什舍拾射設歙蛇舌麝赦
猜		踩睬採纔材才菜綵財裁彩蔡
行	悉禧谿羲型嬉形晰釐邢蟋吸唏曦希硎蹊稀淅溪畦奚犧譆沆熙攜烯西杭析吭兮嘻航僖蜥晞棲膝桁犀熹陘刑	細杏繫席馨姓昔惜洗醒猩隙腥褶襲矽習性鰓翕省係倖悻沆夕杭惺蓆星熄吭檄航興璽幸汐息媳潟桁戲錫系徙喜歙
鱸	蘆爐盧廬臚鑪瀘顱	路滷露魯擄鹵櫓鹿麓戮僇碌氯嚕鷺陸錄穋祿虜賂
倪	妮尼泥霓呢怩	暱泥睨膩溺你擬妳旎匿逆
蒿		蠔鎬鶴號郝耗嚎皓顥涸蚵好昊毫濠豪鄗嗥浩貉壕
潼	瞳銅同桐峒僮童彤	通筒桶痛統恫慟
冥	瞑名螟酩明茗鳴銘暝	命暝
筷	塊劊膾會檜儈快	
阜	富腹馥覆賻附副傅復付複赴婦咐父賦負駙訃	氟縛匐膚鈇俯府腑夫腐頫蝠紼扶甫幅芾孚弗輻紱福袱浮伏符菔釜敷拂涪撫怫斧孵莆趺輔彿服父麩脯芙伕俘
煉	瀲楝斂鏈鍊戀殮練	憐漣奩簾蓮濂鐮臉聯鰱連廉
魅	媚袂妹沬瑁寐昧	楣每沒莓枚媒美黴眉玫鎂煤梅湄黴
萼	愕詻鱷遏俄軛啞噩惡呃鍔顎扼鄂餓厄堊	額俄蛾哦婀訛娥阿峨鵝蚵
耜	賜祀泗兕肆食飼巳伺嗣似寺駟姒俟四	撕司廝絲斯鷥私思嘶死
濩	禍貨獲豁或壑霍惑擭穫	夥夥活豁和火
砌	器憩妻緝棄訖汽迄泣磧氣愒亟企契	旗啟淒祈谿豈悽琦琪麒耆漆杞起錡臍慼齊祁騎溪欺枝祇棋畦奇稽戚啓柒崎淇七隻綺其祺期圻乞棲衹歧岐萋鰭妻
習	惜檄褶錫息媳席襲蓆昔熄	細悉禧行谿羲繫嬉晰蟋釐洗吸唏曦隙希蹊稀淅溪矽畦奚鰓係翕犧譆熙夕攜烯析西兮嘻僖蜥晞棲璽系汐膝潟戲犀熹徙喜歙
軔	衽刃紉妊韌認仞飪任賃	仁荏稔壬人忍兒任
啓	起豈乞稽	泣迄戚漆畦臍妻七隻鰭氣奇砌契悽企祈騎枝旗棲欺歧柒器棋棄汽齊其溪崎期
迄	器憩妻緝棄訖汽泣磧氣愒砌亟企契	旗啟淒祈谿豈悽琦琪麒耆漆杞起錡臍慼齊祁騎溪欺枝祇棋畦奇稽戚啓柒崎淇七隻綺其祺期圻乞棲衹歧岐萋鰭妻
堯	洮淆崤謠榣瑤僥餚姚遙餚窯搖爻	邀要喲耀夭咬吆鷂杳舀腰樂窈麼鑰藥妖拗曜
拽	曄頁靨射咽夜鄴葉謁業	也噎琊椰野爺冶耶
八	笆吧疤捌芭巴扒叭	吧鈸灞琶拔霸靶壩耙把伯跋罷爸杷
刖	粵越嶽耀閱悅躍月樂鑰軏嶽藥曜籥說玥	曰約
睥	弊璧必敝鉍薜嗶痺箄襞避臂斃庇畢俾愎陛碧賁泌鄙蹕篦蔽詖埤闢閉弼婢祕比壁幣裨	彼鄙筆逼匕比沘鼻妣
二	貳	爾洱邇而餌兒耳
宥	幼鼬誘右柚祐有侑莠又囿佑釉	遊幽黝猶猷遊攸油悠由牖鈾有郵友疣莠酉尤優魷憂
荻	鏑迪的犒嘀翟狄滌笛芽敵嫡	滴低締底帝的地蒂第氐牴娣砥遞諦弟柢棣邸抵詆
瞪	嶝凳磴蹬鄧	等登燈
遏	啞鄂軛惡俄萼厄堊顎詻呃噩扼餓鱷愕鍔	哦蛾蚵俄娥峨鵝婀阿訛額
憤	分奮糞忿份	棻分汾焚粉吩芬紛墳氛
俾	弊璧必鉍敝盃薜嗶揹卑背痺箄襞避杯臂斃庇畢愎碧陛賁泌鄙蹕篦蔽碑詖埤闢閉弼祕婢比壁睥幣悲裨	筆貝北鋇匕背輩沘妣邶臂逼憊悖孛蓓鄙倍焙狽彼備被比鼻
餞	件檻劍健僭見艦漸毽諫濺踐監箭間閒薦腱建鍵鑑鑒澗賤薦	箋縑兼姦韉漸殲奸囝艱柬檢簡濺減筧監間肩尖湔剪鹼瞼繭堅菅緘撿揀儉煎
軻	窠科柯刻顆蚵苛瞌稞棵蝌磕	嗑課客恪溘坷渴剋髁可咳喀殼緙克刻
騖	戊晤惡寤物勿悟塢霧兀誤務鎢軏堊	武汙鵡巫侮吾亡誣無吳午五烏毋伍惡嗚鼯嫵於唔憮屋舞圬鎢捂污梧蕪蜈
戴	待迨代大貸黛逮殆玳袋岱帶怠	呆待逮歹
瓊	窮穹	穹
盼	判拚畔叛	胖潘踫磐般蹣蟠攀盤槃
茹	燸入儒嚅濡蠕如褥辱孺	燸儒嚅汝濡乳如蠕褥女入辱孺
稱	襯趁讖櫬秤瞠撐疢	呈秤辰程諶臣撐懲沈橙瞠誠宸忱琛塵城成娠盛澄承丞乘逞沉晨陳騁瞋
冗	茸	鎔蓉榕戎榮容熔融絨溶茸嶸
瞠	稱撐	呈稱乘澄丞懲橙秤成逞誠城程承騁盛
籤	纖牽簽搴鉛愆千謙嵌遷韆騫縴仟阡	倩潛鈐欠黔淺箝乾幹遣前歉鉗塹譴虔縴錢
獵	冽列裂捩劣鬣烈洌	咧
顥	皓昊浩鎬鄗好號涸耗	毫濠壕蠔嚎貉嗥蒿郝蚵豪鶴好號
捩	洌冽烈獵裂列劣鬣	咧
煎	縑肩間韉濺奸尖兼姦漸湔堅緘艱菅監殲箋	餞澗鑒劍儉閒毽減諫箭僭踐柬艦件健建撿簡瞼揀筧間檻繭見剪鹼檢監賤濺薦腱囝漸鑑鍵
曩		囊
截	睫傑節櫛竭潔捷頡擷結桔孑羯桀劫拮碣訐詰	芥姐揭姊疥階戒結藉接皆借偕界嗟解介街屆誡
繩	澠	賸笙昇牲聲陞省甥乘剩勝聖生盛升
妙	繆廟	緲杪苗藐描杳瞄渺邈眇秒
梔	肢祇織枝泜蜘支氏知隻只祗之脂胝芝卮汁吱	雉秩幟止蛭志芷值址執祇祉峙治制紙質誌姪稚窒植咫痣智緻滯致置痔摭至摯製輊躑躓直擲知識徵只炙趾指職旨殖
梳	輸舒橾抒書蔬樞殊疏	鼠漱黍庶束署戍曙數薯術贖菽述暑叔淑恕蜀藷疏塾屬墅豎樹倏熟孰
塭	瘟溫	雯玟紋紊蚊抆刎汶文聞問吻穩免
傾	輕擎蜻檠清氫情青晴卿鯖頃	請擎輕蜻檠清氫情青頃鯖晴卿磬親慶罄
投	頭	頭偷透
賸	勝乘聖盛剩	勝升澠生繩牲省笙甥聲昇陞
苦	楛	庫骷酷窟枯哭褲
卵		亂巒鸞鑾灤
牌	排徘俳	派拍湃啪
巾	津金觔禁斤襟今筋矜浸	晉饉噤燼覲進儘僅禁瑾近勁謹盡緊縉錦浸
軾	拭恃式適是柿飾奭氏士使視螫弒市示試豉仕噬誓筮室勢侍世嗜識逝事釋舐	豕屍匙溼獅蝨使拾詩碩失十蝨噓始塒石蝕實食施時提史師濕屍矢什屎射駛
就	舊究救咎臼舅廄柩疚	赳酒玖糾灸九韭揪久鳩啾
桁	行吭杭恆航衡橫	行沆亨橫哼
詆	砥牴底柢邸抵氐	滴鏑荻締迪帝的嘀狄蒂氐弟諦犒翟笛芽低地敵第娣遞棣滌嫡
蔓	鏝縵曼漫幔慢	饅鰻屘蹣漫蠻瞞滿
熨	裕瘉員澦禦域籲嫗馭喻獄玉欲孕譽禺峪昱燠癒寓愈慍諭御韻谷鬱運預語遇暈與煜醞慾蘊芋育聿尉俞堉鬱豫浴毓	妤娛瘀宇耘逾芸褕竽蝓雨雩渝筠覦迂漁昀於語暈紆與噢齬氳紜餘餘俞雲歟羽虞盂隅榆敔愚魚圉禺禹隕嶼輿愉圄雲淤腴臾諛庾圩允勻瑜予萸於
髏	樓嘍婁螻	簍瘺鏤摟露漏陋
需	鬚噓訏須胥墟戌虛籲	咻卹婿序許洫煦徐恤緒酗畜絮頊栩續蓄敘旭勗
惜	習檄褶錫息媳席襲蓆昔熄	細悉禧行谿羲繫嬉晰蟋釐洗吸唏曦隙希蹊稀淅溪矽畦奚鰓係翕犧譆熙夕攜烯析西兮嘻僖蜥晞棲璽系汐膝潟戲犀熹徙喜歙
擒	禽芹勤秦琴噙	嶔寢欽沁侵親撳
扁	匾褊偏貶篇翩	鞭遍邊釆卞胼辯編蝙變弁辨便駢騙汴片辮砭
添	天	舔恬腆忝靦闐田畋填甜
糢	磨摹模摩蘑謨魔膜	默麼沒秣漠陌膜磨末抹寞摸脈貊墨茉歿驀沫莫
碾	撚輦攆涊輾捻拈	廿念年黏唸
嵩	鬆鬆崧淞忪	誦宋訟悚頌送慫聳
因	湮殷音陰慇茵氤應姻	淫蔭霪聽胤印尹吟癮鄞簷飲隱垠夤銀蚓縯引齦寅
咽	葉釅曄雁謁夜宴研艷殷硯業嚥射菸奄靨鄴厭贗沿湮彥諺煙驗堰焰拽燕燄焉嫣唁醃淹頁豔饜胭晏	言釅雁宴兗演研耶艷殷硯嚥也鹽菸奄顏厭巖簷閻贗沿眼湮椰彥諺噎煙魘驗偃堰郾焰延爺儼筵燄燕焉嫣琊嚴冶野炎唁醃淹衍豔妍鼴饜掩癌胭晏
值	執職植質姪直躑擲殖摭	智徵制脂痔梔致之製蛭址躓質窒雉芝泜胝枝吱峙祉幟肢支祇稚趾祗炙痣識汁咫置輊只至織卮滯紙隻芷止蜘秩摯知指氏緻治志旨誌
畋	甜填恬田闐	靦腆舔添忝天
烏	屋嗚鎢巫惡於汙污圬誣	無巫毋勿騖寤軏梧嫵誤惡舞物堊吾兀誣務鎢悟塢霧吳五侮鼯蕪捂鵡憮晤戊蜈午亡武伍唔
簧	韹湟隍磺蝗皇徨凰篁黃璜煌遑惶	幌肓謊洸荒慌晃恍
戚	七漆萋淒棲谿慼悽柒欺溪妻	器憩旗啟祈豈琦琪汽耆麒企錡起杞臍齊磧泣祁騎砌亟枝祇契棋畦奇稽訖啓迄只崎淇緝綺祺其期棄圻乞衹氣愒歧岐鰭妻
詁	轂凸股谷鵠滑蠱牯瞽罟賈鼓穀古鈷骨	菰孤鴣告沽蛄僱咕辜錮顧鈷估僱姑呱固故骨家
峨	額俄蛾哦訛娥鵝蚵	詻愕鱷遏俄軛啞噩惡呃鍔顎婀餓扼阿鄂厄堊萼
突	酴凸餘塗徒屠途圖荼	土禿菟吐兔
喪	桑	桑嗓
驍	梟逍囂哮消削硝銷霄簫嘐蕭瀟宵	效笑小嘯校肖傚酵孝學篠曉
齒	尺呎恥褫侈	飭喫遲赤癡弛叱踟匙斥持馳池翅魑吃敕栘蚩啻笞熾墀嗤
炯	窘迥	
緇	淄錙貲諮茲姿孳孜資輜滋諮齜玆髭吱	仔訾字恣紫滓籽漬子孳梓自
墾	肯啃懇齦	
哂	審嬸瀋沈	砷信滲甚申莘腎伸呻娠深身蜃沁脤參紳慎神
薇	圍唯違濰桅惟幃維帷闈危巍爲韋微為	葦魏畏褽偽崴慰緯尉猥諉煨謂逶鮪僞遺渭威偎萎喂尾餵痿未位委胃洧穌蔚衛味娓偉為
潦	聊嘹寥撩寮繚遼燎僚療	料撩暸了燎瞭廖
饞	讒孱蟬毚單蟾潺澶嬋禪巉纏	摻闡儳攙羼剷鏟懺諂產
化	樺話華畫劃	樺花華猾滑劃嘩豁譁
生	笙牲昇聲陞甥身勝升	賸省繩乘剩澠勝聖盛
瞥	撇	撇
耘	勻筠昀紜芸雲	允醞隕氳韻慍暈蘊運員熨孕
濂	簾聯蓮簾鰱奩連漣憐鐮廉	鍊戀殮瀲斂練煉鏈楝臉
辜	咕姑估鴣孤沽蛄鈷家菰呱	顧錮鼓牯鵠穀滑告古僱骨罟股賈估鈷故蠱谷凸轂詁固瞽
髮	法	發乏琺法筏砝伐閥罰
戾	慄儷麗礫礪唳痢歷靂力慄立溧蒞癘壢曆琍吏笠粒例利厲釙荔欐俐酈隸蠣勵瀝鬲莉	禮喱澧醴麗犁哩鯉犛貍籬黎娌璃浬釐離理驪邐李鋰梨狸裡罹裡漓蠡蜊俚
燄	豔晏研堰焰嚥諺彥雁沿燕驗饜釅贗厭咽淹艷宴唁硯	閻癌儼菸簷衍魘掩湮醃郾咽殷巖炎延研偃妍兗眼奄煙簷胭沿燕鹽鼴醃顏筵巖厭嚴淹言焉演嫣
蓉	鎔榕戎榮容熔融絨溶茸嶸	茸冗
囊		曩
芰	洎暨寄忌祭薊騎際劑繼薺記季稷髻霽技紀覬既悸計躋繫濟妓鯽驥冀	棘璣羈疾肌集脊己藉雞磯乩積幾績期屐機楫瘠嵇跡蹟基級極居戢畸姬畿其擊輯寂給犄飢及嫉癘幾唧箕麂擠急伋奇吉譏激圾即汲勣稽吃亟躋籍岌嘰濟戟饑
餽	匱愧喟簣潰	夔葵窺睽盔虧魁揆傀奎逵
但	啗擔蛋氮啖誕澹淡旦憚彈石	擔單簞疸丹耽膽撢
咬	窈杳舀夭	吆藥餚洮淆腰麼瑤崤要妖搖樂爻鷂姚榣僥遙謠耀邀堯拗曜窯夭鑰喲
串	釧	船傳川舛穿喘
攔	蘭斕襤瀾嵐藍籣闌婪籃欄	覽爛纜欖攬濫懶
佬	老姥	烙勞嘮酪牢癆絡撈
壯	撞狀	奘裝樁妝莊
殿	靛鈿澱墊店奠電玷佃惦甸	點典滇碘癲顛巔
償	腸嘗嫦嚐徜萇裳場長常	暢鯧敞悵娼氅昌場猖唱倡倀廠
杷	耙扒吧罷琶爬	跋笆伯吧芭帕耙疤怕壩啪巴八把靶霸葩叭扒鈸捌爸罷拔灞趴
檳	繽彬瀕豳儐濱賓	殯儐臏鬢
菸	奄煙胭燕醃湮醃厭咽淹焉殷嫣	豔閻癌堰焰儼諺雁簷驗衍魘掩贗郾咽艷硯巖炎延晏研偃妍兗眼嚥彥簷沿燕鹽鼴饜顏釅筵巖厭嚴淹燄言宴演唁
豁	樺獲壑華穫猾或滑惑貨濩劃禍嘩譁霍擭	樺或惑火擭獲話花貨濩禍化穫夥嘩活壑華畫劃和霍
壘	耒漯儡蕾磊累	擂雷淚嫘縲羸勒鐳累類
篡	爨竄	
處	怵杵褚絀觸儲矗歜楚畜黜楮礎	齣杵絀出櫥跦楮觸矗楚廚黜除鋤歜畜雛躇礎怵初褚芻儲
暮	慕穆募墓木目沐睦苜幕牧	牡模拇姥姆母畝
剜	彎灣豌莞蜿	惋丸完碗莞頑蜿腕萬挽宛玩輓晚皖綰汍娩婉
媳	惜習檄褶錫息席襲蓆昔熄	細悉禧行谿羲繫嬉晰蟋釐洗吸唏曦隙希蹊稀淅溪矽畦奚鰓係翕犧譆熙夕攜烯析西兮嘻僖蜥晞棲璽系汐膝潟戲犀熹徙喜歙
棒	旁傍鎊磅謗蚌	梆邦膀傍綁榜幫
卒	趣醋嗾鏃促趨錯簇槭族足蹙蹴	組俎祖租阻詛粗
掄	侖綸淪論崙倫輪	侖綸淪論崙倫輪
徠	來萊	睞癩籟賴瀨
擁	湧俑永泳傭蛹雍慵甬恿臃鄘踴壅庸勇詠邕踊	湧俑永泳傭蛹雍慵甬恿臃鄘踴用壅庸勇詠邕
徇	汛殉巡潯循潠訓迅遜馴訊尋詢洵荀璿巽蕈旬	汛殉燻潯巡薰循醺迅訓潠遜馴尋訊勛詢璿荀洵巽勳蕈旬
傭	壅庸邕臃雍擁鄘慵用	湧擁俑永泳傭蛹雍慵甬恿臃鄘踴用壅庸勇詠邕踊
毛	茅髦錨矛	冒茆瑁卯泖茂懋貌耄貿貓帽
交	蛟礁鮫教嬌驕蕉澆姣膠椒焦詨郊跤	攪醮矯嚼餃狡教剿叫覺轎較鉸勦腳僥窖絞繳校姣皎角
注	助薴駐箸祝註蛀柱佇鑄杼住	諸逐軸朱躅茱硃渚拄蛛誅術主囑珠豬築朮貯竺侏藷屬煮燭矚株銖竹
幃	危維帷微巍韋唯惟闈圍濰為桅違薇	尾娓魏衛胃蔚痿緯萎威未遺渭為崴味穌煨逶餵偽葦位慰偉洧謂鮪偎褽尉喂畏猥諉委
慘		參孱璨蠶餐燦慚殘
氖	迺奶奈乃	耐奈
舒	輸橾抒梳書蔬樞殊疏	鼠漱黍庶束署戍曙數薯術贖菽述暑叔淑恕蜀藷疏塾屬墅豎樹倏熟孰
夤	垠吟銀鄞齦淫簷寅霪	癮聽胤印飲因尹茵音湮姻陰縯慇氤蔭殷隱引蚓
才	材纔財裁	踩睬猜採菜綵彩蔡
侮	嫵舞午五武捂伍鵡憮	無巫毋勿騖寤軏圬屋梧誤惡物汙堊烏吾兀誣務鎢塢悟霧吳鼯於蕪晤嗚戊蜈亡污唔
愈	芋與馭御喻育瘉寓禺鬱尉癒諭玉澦語煜欲谷裕昱聿峪嫗籲預豫浴域獄毓遇堉慾譽禦熨俞燠	與魚諛宇雨雩竽禹予愚禺虞迂齬蝓噢盂圉逾褕圩瘀榆渝語萸漁瑜庾輿嶼歟於腴紆妤隅圄愉羽臾餘淤覦敔俞娛
憫	閩皿湣愍閔澠敏泯抿	民岷玟
乳	汝女辱	燸如濡入嚅褥辱蠕孺儒茹
殖	執職植質姪值直躑擲摭	智徵制脂痔梔致之製蛭址躓質窒雉芝泜胝枝吱峙祉幟肢支祇稚趾祗炙痣識汁咫置輊只至織卮滯紙隻芷止蜘秩摯知指氏緻治志旨誌
晞	攜曦淅悉熹烯禧犀嬉膝行蜥稀希吸溪晰畦兮析熙釐棲譆谿犧蟋唏嘻羲西奚蹊僖	系汐蓆翕戲隙惜習璽徙洗細鰓係媳矽喜息潟夕繫席錫熄歙襲昔檄褶
論	侖掄綸淪崙倫輪	侖掄綸淪崙倫輪
考	烤拷	犒靠銬
刨	咆庖抱鉋炮報鑤豹爆袍鮑暴匏	砲葆拋泡雹炮包胞飽薄堡褓保跑褒寶苞皰
別		彆癟鱉
蟑	獐漳樟彰章璋張	脹丈障賬長仗掌幛漲帳杖瘴
觼	鴃掘鱖抉獗決譎蹶劂腳倔玨角攫爵孓崛覺蕨訣厥絕嚼噱	倔蹶嗟
斥	啻飭熾敕赤翅叱	喫褫遲癡弛踟匙持呎馳池魑吃栘蚩侈尺笞墀齒恥嗤
籃	蘭攔斕襤瀾嵐藍籣闌婪欄	覽爛纜欖攬濫懶
蹈	盜悼導道到稻倒	導島搗禱叨刀倒
悅	曜越粵刖玥藥說耀月躍軏樂鑰籥嶽閱	約曰
熒	嬴盈瑩楹塋瀛縈螢迎贏營蠅	穎瑛嚶瓔櫻應纓嬰映鸚鶯膺鷹罌郢英景硬影
宛	皖娩鳶婉蜿碗鴛淵挽莞冤晚輓綰	萬院願遠湲員猿玩袁蜿援灣原莞媛汍沅轅垣源爰元騵頑腕剜圓彎惋怨緣苑園豌丸完
倣	訪舫仿彷紡	放防妨芳坊肪枋房方
恆	橫桁衡	哼橫亨
效	校嘯傚笑酵孝肖	梟銷瀟霄小削蕭哮簫曉嘐硝囂學宵逍消驍篠
萸	盂妤隅娛榆愚魚逾禺輿愉褕竽蝓雩渝覦腴漁臾於諛圩餘餘瑜俞予歟於虞	瘉澦域瘀宇馭獄峪昱燠雨預迂語紆與煜齬慾噢芋育俞堉鬱豫羽毓裕禦籲嫗敔喻玉欲圉譽禺禹熨嶼癒寓愈諭圄御谷鬱淤遇庾聿尉予浴
去	趣漆娶	取趨渠驅娶砠劬曲齲衢蛐區麴屈圈軀璩蛆嶇瞿
荼	徒凸餘塗酴屠突圖途	禿土兔吐菟
廂	瓖香鑲箱湘襄鄉相	橡餉翔鄉嚮相向象饗詳降響祥像巷庠想項享
霓	妮尼泥呢倪怩	暱泥睨膩溺你擬妳旎匿逆
痣	雉秩幟蛭稚窒志智緻滯致置痔至摯峙製輊躓治知識制質炙誌	姪止植織梔咫泜氏芷脂胝值汁址吱肢執摭祇祉躑枝蜘直支擲知徵隻質紙趾只之指祗職芝旨卮殖
延	沿嚴言炎鹽簷妍顏筵巖閻癌研	釅雁宴兗演研艷殷硯嚥菸奄咽厭贗沿眼湮彥諺煙偃魘驗堰郾焰儼燄燕焉嫣唁醃淹衍豔鼴饜掩胭晏
鮫	教礁澆跤姣驕郊嬌焦膠詨交椒蛟蕉	教較餃勦姣轎皎狡窖腳繳僥鉸攪角校絞叫矯剿覺醮嚼
糟	遭	蚤竈造噪皁譟躁鑿澡燥藻棗早
衫	芟扇羶跚縿山煽珊潸姍刪舢杉	汕善擅繕單扇陝訕膳疝禪煽贍鱔閃
腓	肥	費痱菲斐屝翡沸非妃飛誹吠怫扉廢霏肺芾啡匪
瀏	劉留泵琉遛流榴硫瘤	霤鉚柳餾陸六溜
續	序恤旭緒酗卹蓄畜絮敘婿頊勗洫	鬚咻噓訏栩須戌胥墟籲煦虛需徐許
灌	盥貫鸛慣罐冠觀	綸關管倌琯冠莞官鰥矜觀棺館
瀉	燮屑解褻懈卸契楔洩蟹駭邂榭械謝紲屜	寫血挾諧頡擷偕歇蠍邪斜些攜勰協鞋脅
騷	繅艘搔	嫂掃
譯	詣劓羿浥異益議藝軼意刈鎰縊肄逸憶抑艾佚奕翌衣佾誼億役翳懿一掖屹易裔繹液弋帟邑腋曳溢臆翼亦囈蜴驛毅義弈疫	咿儀揖怡飴咦依姨迆痍胰頤以遺噫移乙矣蛇衣伊夷誼尾漪圯蟻彝已壹一醫沂旖栘倚迤貽椅訑宜疑偯
崇	重蟲	憧充舂沖衝寵
捱	皚	哀噯璦藹哎愛曖艾埃隘唉靄矮挨礙
奘	藏臟葬	贓臧妝髒樁壯臢撞裝莊狀
路	鷺穋氯僇碌陸鹿祿露錄賂戮麓	鑪魯虜盧瀘鹵鱸廬蘆嚕臚櫓擄爐滷顱
邸	砥牴底柢抵詆氐	滴鏑荻締迪帝的嘀狄蒂氐弟諦犒翟笛芽低地敵第娣遞棣滌嫡
怒		駑努弩奴
芝	脂梔之泜胝枝吱祇肢支祗汁只卮織隻蜘知氏	智徵制植痔直致摭製蛭址躓質窒雉值躑擲峙祉幟祇趾稚執職炙痣識咫置輊只至殖滯紙芷止秩摯知姪指緻治志旨誌
壽	獸瘦狩授售受綬	守收手首熟
吱	脂淄玆錙梔輜之資泜孳芝茲胝枝祇肢支祗貲汁只孜姿織卮髭隻諮蜘滋知齜氏緇	智字徵制訾仔植恣子痔自直致摭籽製蛭址滓躓質窒雉孳值躑擲峙祉幟祇梓趾稚執職炙痣識咫置輊只至殖滯紙紫芷漬止秩摯知姪指緻治志旨誌
辭	疵祠詞瓷茨雌慈磁	疵刺伺次雌廁賜此差
謫	蜇哲折摺摘懾輒轍褶	浙遮這著蔗螫赭鷓者宅
燒	捎稍梢	少哨韶紹杓芍邵勺召
莊	妝裝樁	壯撞狀奘
敝	弊璧必鉍薜嗶痺箄襞避臂斃庇畢愎俾陛碧賁泌鄙蹕篦蔽詖埤闢閉弼婢祕比壁睥幣裨	彼鄙筆逼匕比沘鼻妣
蝴	囫糊狐鵠胡鬍葫壺湖弧斛瑚	戶滬虎沍扈乎瓠忽惚互琥唬戲護楛許呼
狂	誑	劻匡眶曠筐礦況框壙
綢	籌惆躊裯仇疇愁稠鯈酬儔	醜抽溴臭
換	幻宦煥喚患奐梡渙豢瘓	皖環澴洹鍰桓緩梡寰歡還
滂	乓磅	旁胖膀螃徬龐
髻	洎暨寄忌祭薊騎芰際劑繼薺記季稷霽技紀覬既悸計躋繫濟妓鯽驥冀	棘璣羈疾肌集脊己藉雞磯乩積幾績期屐機楫瘠嵇跡蹟基級極居戢畸姬畿其擊輯寂給犄飢及嫉癘幾唧箕麂擠急伋奇吉譏激圾即汲勣稽吃亟躋籍岌嘰濟戟饑
瞰	看勘	侃戡坎看檻勘砍刊堪崁
黠	狎暇俠轄霞斜柙挾峽匣洽狹遐呷瑕	下暇蝦嚇夏廈瞎
記	霽髻寄際繼繫稷薺技忌騎悸覬劑紀季計祭妓驥濟鯽芰暨洎薊系冀躋既	急唧疾脊跡即寂楫屐居伋績擠吉犄饑譏擊羈機及乩嫉積激己汲藉亟岌吃瘠奇給稽借棘箕級圾嘰戟麂躋蹟籍濟輯畸嵇幾其肌期集戢飢雞極癘璣基磯畿姬勣
獷	廣	逛胱洸光
煜	裕瘉澦禦域籲嫗馭喻獄玉欲譽禺熨峪昱燠癒寓愈諭御谷鬱預語遇與慾芋育聿尉俞堉鬱豫浴毓	妤娛瘀宇逾褕竽蝓雨雩渝覦迂漁於語紆與噢齬餘餘俞歟羽虞盂隅榆敔愚魚圉禺禹嶼輿愉圄淤腴臾諛庾圩瑜予萸於
潮	朝嘲巢晁	超炒剿吵抄勦鈔
沙	莎殺煞鯊砂紗裟杉	廈煞傻霎
君	均龜鈞軍	竣菌浚窘郡駿俊雋濬蕈峻
喲	要妖吆夭邀腰麼	藥餚洮淆瑤崤要搖窈樂爻舀鷂姚榣杳僥遙謠耀堯拗曜窯夭咬鑰
犒	荻鏑迪的嘀狄銬敵靠翟芽笛滌嫡	滴低締底帝的地考蒂烤第氐牴娣砥遞諦弟柢棣拷邸抵詆
柙	狎暇俠轄霞斜挾峽匣洽狹黠遐呷瑕	下暇蝦嚇夏廈瞎
運	醞韻慍暈蘊員熨孕	勻允耘氳隕筠昀紜暈芸雲
潰	賄會彙彗穢繪燴蕙匯愧卉喟簣諱匱惠餽慧誨晦喙	蛔賄會蟲睽窺詼輝茴揮奎魁葵虺回燬麾虧徽灰揆毀逵夔傀迴墮恢暉盔悔誨
擇	責窄嘖笮則賊澤咋	仄怎側
背	鋇倍貝杯裨焙碑孛備悖悲被輩憊卑盃臂邶狽揹蓓俾	鋇倍貝杯裨焙碑孛備悖悲被輩憊北卑盃臂邶狽揹蓓俾
隔	革格膈合鬲蛤閤閣咯鎘骼郃葛	個戈胳割鉻鴿箇歌疙各葛擱哥
脖	卜鈸博蔔鉑駁箔荸搏檗渤帛薄白柏膊勃泊伯舶	玻菠薄亳般薜擘蘗簸檗剝跛缽播撥
昂		盎醃骯
抗	伉亢炕	扛慷糠康
緩	皖	宦環患豢喚還洹桓梡寰瘓煥鍰澴幻奐渙歡換
廚	除鋤芻儲雛櫥跦躇	怵齣杵褚絀觸初出矗儲歜楚畜黜處楮礎
財	才纔裁材	踩睬猜採菜綵彩蔡
棧	站綻湛暫佔蘸顫戰	斬嶄沾瞻展盞輾霑佔詹譫氈
蝙	編砭邊鞭	辯扁遍貶變汴匾褊卞弁釆辨辮便
韹	湟隍磺蝗皇徨凰篁簧黃璜煌遑惶	幌肓謊洸荒慌晃恍
孜	淄錙緇貲諮茲姿孳資輜滋諮齜玆髭吱	仔訾字恣紫滓籽漬子孳梓自
拐	枴	乖怪
郢	景穎影	纓瑩罌櫻鶯映贏鸚盈應縈英鷹硬蠅螢迎營膺熒嬰瑛嬴嚶瓔楹塋瀛
超	勦鈔剿抄	潮炒巢吵朝嘲晁
彌	靡瀰謎糜迷麋	靡米泌敉密糸祕弭汨瞇咪蜜冪謐覓
秉	餅鉼丙稟屏柄炳	摒冰兵並併病
瞑	名螟酩明茗冥鳴銘暝	命暝
愚	魚諛雩予竽禺虞蝓盂逾褕圩榆渝萸漁瑜輿歟於腴妤隅愉臾餘覦俞娛	芋與馭御喻育宇雨予禹瘉寓譽禺迂鬱尉齬噢癒圉諭玉澦煜語欲谷庾裕嶼昱愈紆聿峪嫗籲預豫圄域浴羽獄毓遇淤堉慾瘀敔禦熨俞燠
空	控倥崆硿	崆孔倥硿控恐
名	螟冥酩暝茗鳴明瞑銘	暝命
胱	洸光	獷逛廣
撳	沁	擒禽嶔噙侵琴勤親秦寢欽芹
凸	鼓牯鵠穀滑古屠骨罟股賈鈷塗蠱荼酴谷轂詁徒途圖突餘瞽	咕顧錮鴣告家僱骨估禿蛄鈷菰故呱姑土孤菟吐辜兔固沽
憎	繒曾增	贈
繃	崩	甭蹦迸
鄗	皓昊浩鎬顥好號涸耗	毫濠壕蠔嚎貉嗥蒿郝蚵豪鶴好號
升	笙牲昇聲陞甥勝生	賸省繩乘剩澠勝聖盛
隻	肢祇織梔枝泜蜘支氏知只祗之脂胝芝卮汁吱	雉秩幟止蛭志芷值址執祇祉峙治制紙質誌姪稚窒植咫痣智緻滯致置痔摭至摯製輊躑躓直擲知識徵只炙趾指職旨殖
崧	嵩鬆鬆淞忪	誦宋訟悚頌送慫聳
脯	斧莆父腐蒲璞撫腑輔朴樸俯釜釙葡僕甫菩濮頫府匍蹼	孚富拂夫芙敷父復負袱暴蝠誧菔撲氟覆普阜駙符複幅服傅鈇浦扶僕咐膚曝芾訃附輻腹俘賦伏匐賻瀑彿圃鋪副溥噗婦伕紼縛紱付涪浮趺福弗怫埔孵譜麩馥赴
媒	玫眉黴梅楣枚莓煤沒湄	妹瑁每昧魅袂鎂美媚沬寐
皴	村	忖寸吋存
磚	耑專顓	撰篆囀轉傳僎賺
聞	雯紊文蚊汶免問紋抆玟	穩雯紊文瘟刎蚊塭汶免問溫紋吻抆玟
風	豐諷峯鋒楓封蜂烽瘋	俸諷逢縫馮鳳奉
茸	鎔蓉榕戎榮冗容熔融絨溶嶸	鎔蓉榕戎榮冗容熔融絨溶嶸
孰	淑熟贖叔塾菽	樹橾術黍恕屬述漱豎書輸束殊數庶鼠倏藷樞梳戍暑薯蜀抒墅疏署蔬曙舒
箋	監間尖肩縑湔兼姦堅韉漸菅殲奸緘艱濺煎	件檻劍健僭見艦毽漸諫囝檢柬簡濺減筧踐監箭間閒薦腱鍵剪建鹼瞼繭餞鑑鑒澗賤撿揀儉薦
陞	勝升生牲笙甥聲昇	勝澠繩乘賸省聖盛剩
稿	攪槁搞縞杲	睪皋高誥羔告糕膏篙
玫	媒眉黴梅楣枚莓煤沒湄	妹瑁每昧魅袂鎂美媚沬寐
髒	贓葬臧藏臢	贓葬奘藏臟
永	壅勇恿泳詠臃蛹湧擁俑踊踴甬	壅庸傭邕臃雍擁鄘慵用
媽	嬤嗎	瑪痲麻螞罵馬嘛嗎蟆碼麼
扎	閘炸渣紮喳札查	閘搾炸柵渣吒紮乍喳札蚱眨砟咋詐查
敬	鏡靜競徑淨勁痙逕竟靖境	井精荊兢警旌京經粳菁驚頸涇晶鯨睛莖阱憬璟景更
澱	靛鈿墊店奠電惦玷佃殿甸	點典滇碘癲顛巔
祁	歧淇其琪旗齊琦耆麒棋騎祺臍畦鰭崎圻奇岐衹祇期祈枝錡	愒萋淒妻欺溪豈綺磧棄杞乞汽啟柒器棲企訖谿稽漆慼亟迄悽泣起契憩戚砌七緝氣
蕊		睿銳瑞
凝	檸獰嚀寧擰	佞濘擰
轅	沅垣圓爰緣湲袁園援元騵原源媛員猿	怨院鳶苑宛鴛願淵遠冤媛
亙	更艮	艮粳梗庚根更跟埂耿羹耕哽賡
簣	匱愧餽喟潰	夔葵窺睽盔虧魁揆傀奎逵
腹	富父復覆阜駙複傅咐訃附賦賻副婦付負馥赴	孚拂斧夫芙敷莆父袱腐蝠菔氟腑撫符幅輔服鈇俯釜扶甫膚芾輻伏俘匐彿頫伕紼脯縛府浮涪趺福弗怫孵麩紱
蘊	醞韻慍暈運員熨孕	勻允耘氳隕筠昀紜暈芸雲
懦	糯諾	挪娜
瓢	嫖	飄剽漂驃縹票瞟
黝	牖有莠友酉	遊由郵疣莠又尤優憂幼幽猶猷攸遊鼬誘宥油悠右柚祐鈾有侑囿佑魷釉
邏	鑼騾玀羅鏍儸螺囉蘿籮	裸落洛酪絡烙咯駱犖囉珞雒
尊	遵樽	俊撙圳
堤	緹題隄蹄啼提	梯悌銻剔涕踢惕替嚏剃逖體屜
縴	簽欠阡嵌塹仟歉倩愆鉛千騫謙牽搴遷韆籤	簽乾欠前塹遣黔倩愆鉛箝千遷韆鈐籤譴鉗阡嵌仟歉騫虔謙潛淺牽搴錢
抱	鉋刨報鑤豹爆鮑暴	葆包雹胞飽薄褓堡保褒寶苞
囿	幼鼬誘宥右柚祐有侑莠又佑釉	遊幽黝猶猷遊攸油悠由牖鈾有郵友疣莠酉尤優魷憂
熬	鏖鼇翱遨敖嗷聱	拗凹傲澳奧媼襖懊
撻	遝漯榻蹋踏獺遢塌躂	他塔牠她它塌
呃	愕詻鱷遏俄軛啞噩惡鍔顎扼鄂餓厄堊萼	額俄蛾哦婀訛娥阿峨鵝蚵
墓	慕穆募木目沐睦苜幕暮牧	牡模拇姥姆母畝
苛	窠科柯軻顆蚵稞棵瞌蝌磕刻	緙咳坷喀恪剋可嗑殼溘課克渴客刻髁
貊	默沒秣漠陌膜磨末寞脈墨茉歿驀沫莫	磨摹模摩摸抹糢麼蘑謨魔膜
綾	齡蛉菱櫺玲翎聆昤鴒泠苓凌陵鈴靈羚零伶	領拎令另嶺
玲	綾零蛉櫺昤菱鴒泠靈羚鈴苓伶齡聆陵凌翎	拎令另嶺領
隋	隨	誶穗髓邃隧綏遂碎歲睢燧祟雖
房	妨坊防肪	放坊彷訪枋倣芳舫紡仿方
隱	引蔭印胤尹癮縯聽蚓飲	淫蔭霪聽殷胤印尹吟因癮鄞簷飲湮垠夤銀陰慇氤姻蚓縯引齦音茵寅
卑	碑背杯裨揹悲盃俾	鋇背倍臂貝輩備孛悖憊北邶狽焙蓓被
瘡	囪窗創	撞牀創闖搶愴幢
偶	耦藕嘔	甌嘔區噢歐毆鷗
綰	宛輓皖晚碗莞蜿娩婉挽	惋彎灣丸完莞頑腕蜿萬玩汍剜豌
曇	痰談譚潭覃壇檀罈彈	坍癱灘探碳袒嘆毯貪攤炭歎坦
溯	嗉訴塑速縮粟蓿宿素夙肅簌	囌酥蘇俗甦穌
槁	搞攪縞杲稿	誥告篙睪羔糕高皋膏
髭	淄錙緇貲諮茲姿孳孜資輜滋諮齜玆吱	仔訾字恣紫滓籽漬子孳梓自
蒙	朦虻萌濛檬甍盟矇懵	夢孟蜢錳艋猛懵
南	男楠難喃	囝難赧
喱	璃釐離麗犁犛驪貍籬狸梨黎罹漓蠡蜊	儷澧醴哩歷靂力慄立溧娌琍粒理利厲邐俐蠣蠡俚莉鬲慄禮麗鯉礫礪唳痢蒞癘壢戾曆吏笠浬例釙荔欐李鋰裡隸酈裡勵瀝
驛	屹藝肄軼刈誼囈縊逸佾溢劓疫懿鎰毅義邑億液佚役易羿弋裔蜴弈帟譯翌異益臆亦艾腋曳詣議意繹憶掖浥翳奕一抑翼衣	漪尾咦姨椅壹蟻飴旖誼偯迤栘移以彝夷已遺沂宜咿醫頤伊噫疑乙怡貽揖訑迆蛇矣圯胰儀一衣痍倚依
埔	誧捕普溥譜圃補哺卜浦	簿步濮樸部蹼樸怖暴菩布噗匍佈葡鋪釙莆僕鈽埠不撲撲瀑脯蒲璞曝僕
呂	鋁褸履膂屢旅婁侶縷	慮閭率氯綠驢濾律櫚
埃	哀挨唉哎	靄皚藹曖捱噯艾矮礙璦愛隘
概	鈣丐蓋溉	賅該垓改
吩	棻分芬紛氛	分汾焚奮糞粉忿墳憤份
哉	栽災	仔在再宰載
嬪	頻瀕貧顰	拼品姘聘牝
炫	渲漩眩鉉絢旋	選還晅縣玄漩諼煖萱軒壎璿喧懸旋宣暄
盹	燉頓遁盾噸沌囤鈍躉	燉頓遁盾噸敦蹲沌惇囤鈍躉墩
坐	祚作做座鑿柞	昨左作佐砟
降	絳彊詳祥將強庠翔醬匠	橡香江薑蔣講餉僵鄉嚮相獎向象饗疆姜槳將繮漿廂項鑲響像瓖箱湘巷想韁襄享
瓠	互戶滬楛沍護扈	壺鬍鵠蝴胡琥湖葫囫弧虎許斛瑚惚唬乎戲呼糊忽狐
竟	鏡靜敬競徑淨勁痙逕靖境	井精荊兢警旌京經粳菁驚頸涇晶鯨睛莖阱憬璟景更
右	囿柚侑佑宥有莠誘又釉祐幼鼬	悠憂攸友優猶疣鈾遊幽莠油由酉魷牖有黝郵尤猷
造	竈噪皁譟躁燥	蚤糟鑿澡遭藻棗早
左	佐	祚昨作座做鑿坐砟柞
羽	與圄庾齬噢嶼圉宇雨予禹語敔	芋與馭御喻魚育諛雩予竽瘉愚禺虞迂鬱寓尉蝓癒盂逾褕諭玉圩澦瘀榆渝語煜漁欲谷瑜萸輿裕歟於昱愈腴紆聿妤峪嫗隅籲預豫娛域愉浴臾獄毓餘遇淤堉慾覦譽禦熨俞燠
鬲	慄儷咯麗礫礪鎘蛤唳痢歷靂力慄立溧蒞癘壢隔閣膈閤葛戾曆琍吏笠粒郃例格利骼厲釙荔欐俐酈隸革蠣勵瀝莉	禮喱澧醴哥麗犁哩鯉箇犛貍籬黎娌葛鴿璃浬釐歌離各理戈疙個擱鉻驪邐李鋰割胳梨狸裡罹裡漓蠡蜊俚
飾	室恃螫筮奭勢嗜舐豉市士事仕拭識試世釋柿逝是適侍示軾誓弒氏式噬使視	濕詩十施屎師史匙提矢射食碩拾蝕駛塒屍噓時什溼豕獅失始蝨實石使
肘	帚	妯縐舟啁軸皺胄州咒宙洲週冑粥籀晝周紂
怎		仄則擇側澤賊責笮嘖窄咋
秒	緲杪藐杳渺邈眇	苗繆廟描瞄妙
曷	嗑合蓋河郃翮和紇闔盍核荷貉禾劾盒閡何褐閤涸	嚇郝和訶喝鶴賀暍荷赫呵
豈	凱綺起愷杞啟稽慨乞啓剴楷	器憩旗慨祈淒谿悽琦琪汽耆麒企漆錡臍慼齊磧泣祁騎溪亟砌欺枝祇契棋畦奇開訖戚迄柒揩愾崎淇緝七隻咳祺其期棄圻棲衹氣愒歧岐萋鰭妻
豺	柴儕	拆差釵
班	頒搬斑扳般瘢	半姅舨版板阪伴辦扮瓣絆鈑闆拌
駕	稼賈假架價嫁	鉀加家甲茄胛嘉賈假葭頰傢豭佳戛迦袈莢痂夏挾夾浹
翱	鼇熬鏖嗷遨聱敖	凹澳懊奧媼襖拗傲
陸	鷺穋氯餾霤六路僇碌溜鹿祿露錄賂戮麓	瘤劉留虜鱸廬嚕爐擄臚櫓流滷顱榴泵鑪瀘硫鉚琉遛魯盧鹵瀏溜蘆柳
悲	碑背杯卑裨揹盃俾	鋇背倍臂貝輩備孛悖憊北邶狽焙蓓被
悄	雀巧愀鵲	憔譙俏殼蹺翹竅鞘瞧鍬僑峭喬樵誚橋撬橇敲
兀	戊晤惡寤騖物勿悟塢霧誤務軏鎢堊	武汙鵡巫侮吾亡誣無吳午五烏毋伍惡嗚鼯嫵於唔憮屋舞圬鎢捂污梧蕪蜈
槃	盤蹣般胖蟠磐踫	叛拚潘判盼攀畔
汕	鱔扇善膳禪擅訕疝單繕贍煽	扇縿姍刪山舢煽跚羶杉衫珊潸閃芟陝
撞	壯幢牀狀	窗瘡囪創奘闖裝樁搶愴妝莊
窖	教校醮叫覺轎較	攪礁澆矯嚼餃焦跤蕉嬌狡教剿椒交郊較勦鉸腳僥絞膠繳蛟鮫驕姣詨皎角
鵡	嫵舞午五侮武捂伍憮	無巫毋勿騖寤軏圬屋梧誤惡物汙堊烏吾兀誣務鎢塢悟霧吳鼯於蕪晤嗚戊蜈亡污唔
臾	盂妤隅娛榆愚魚逾禺輿愉褕竽蝓雩渝覦腴漁於諛圩餘餘瑜俞予歟萸於虞	瘉澦域瘀宇馭獄峪昱燠雨預迂語紆與煜齬慾噢芋育俞堉鬱豫羽毓裕禦籲嫗敔喻玉欲圉譽禺禹熨嶼癒寓愈諭圄御谷鬱淤遇庾聿尉予浴
夾	嘉豭戛加挾迦袈浹佳莢家痂茄葭頰傢	稼鉀加架家甲茄駕胛嘉賈假價嫁葭佳傢頰豭戛迦袈莢痂夏挾浹
黴	莓媒眉霉梅楣枚玫煤沒湄	瑁妹每魅袂鎂美寐媚沬昧
悔	燬賄毀會誨虺蟲	蛔賄會彙彗潰詼燴蕙繪穢輝匯茴揮卉回麾徽灰諱惠迴墮恢暉慧誨晦喙
吻	刎穩	雯紊聞文瘟蚊塭汶免問溫紋抆玟
馥	富腹覆賻附副傅復付複赴婦咐父阜賦負駙訃	氟縛匐膚鈇俯府腑夫腐頫蝠紼扶甫幅芾孚弗輻紱福袱浮伏符菔釜敷拂涪撫怫斧孵莆趺輔彿服父麩脯芙伕俘
凰	隍遑皇徨簧惶璜黃湟篁韹煌磺蝗	幌恍慌荒謊肓洸晃
倦	卷狷圈雋眷絹	娟捲身捐圈鐫鵑涓
探	坍癱灘碳嘆貪攤歎炭	碳覃貪罈歎坦談坍袒攤癱嘆毯炭彈曇痰潭譚灘壇檀
鉛	纖牽簽搴千愆謙韆嵌遷籤騫縴仟阡	倩潛鈐欠黔淺箝乾幹遣前歉鉗塹譴虔縴錢
貳	二	爾洱邇而餌兒耳
直	執職植質姪值躑擲殖摭	智徵制脂痔梔致之製蛭址躓質窒雉芝泜胝枝吱峙祉幟肢支祇稚趾祗炙痣識汁咫置輊只至織卮滯紙隻芷止蜘秩摯知指氏緻治志旨誌
送	訟頌誦宋	淞崧悚慫嵩忪鬆聳
趁	襯讖櫬稱疢	沈宸忱琛塵晨沉辰陳諶臣娠瞋
半	姅伴辦扮瓣絆拌	頒搬斑扳舨版板般瘢阪班鈑闆
擷	捷攜協拮桔斜邪截詰節挾傑桀諧鞋孑頡碣脅劫櫛訐羯竭睫偕結潔傑勰	蟹芥階皆駭街懈揭疥燮蠍楔誡藉洩紲血接姊邂榭歇屜解寫洩屑些械嗟卸瀉戒謝褻契偕界結借姐介屆
霸	灞壩耙伯罷爸	笆吧鈸琶疤拔芭捌巴靶扒把跋罷叭八杷
剷	諂鏟闡產	懺攙禪蟾儳嬋巉饞摻讒澶孱潺蟬毚單纏羼
雒	烙珞駱洛酪咯絡犖落	騾羅螺籮蘿玀鑼儸囉裸邏鏍
釙	慄儷濮樸麗礫礪蹼樸唳歷痢靂力慄立癘蒞溧壢菩匍戾曆吏琍笠粒葡例利厲荔欐莆俐酈隸脯蒲蠣璞勵瀝僕莉鬲	禮普埔澧喱醴麗鯉哩犁犛誧貍暴溥籬黎圃噗娌璃浬釐離鋪理浦驪邐李鋰僕狸梨裡撲撲罹瀑譜漓裡蠡曝蜊俚
閻	沿嚴言炎鹽妍顏筵延巖簷癌研	釅雁宴兗演研艷殷硯嚥菸奄咽厭贗沿眼湮彥諺煙偃魘驗堰郾焰儼燄燕焉嫣唁醃淹衍豔鼴饜掩胭晏
弦	嫌銜嫻鹹舷啣閑賢閒絃涎	莧陷限獻蘚祆秈暹鮮纖霰先銑險線仙蜆顯癬腺羨餡僩掀憲現峴姍縣
腳	攪觼蕨矯嚼餃劂掘訣鴃崛狡倔鱖絕剿玨覺較勦鉸獗厥僥絞繳抉孓譎爵攫姣蹶決噱皎角	礁醮澆嚼焦跤蕉嬌教倔椒交叫覺轎郊較窖膠嗟蛟鮫驕校姣蹶詨
見	餞澗鑒劍閒毽諫箭僭踐艦件健建間檻監賤濺薦腱漸鑑鍵	尖儉堅艱減菅緘韉柬湔撿簡殲瞼肩筧間揀繭煎姦剪鹼監檢縑濺奸兼漸囝箋
訪	彷倣舫紡仿	放房坊防妨芳肪枋方
呆	待	待迨代大貸歹黛逮殆戴玳袋岱帶怠
怨	院苑願遠媛	遠湲員猿鳶袁援宛原媛沅轅垣爰元鴛騵淵圓緣園冤源
芻	雛儲鋤除櫥躇跦廚	矗齣出畜黜儲絀杵礎楮怵褚處歜楚觸初
註	鑄住箸杼助薴駐柱蛀注佇祝	主軸築朱諸茱矚銖囑朮築屬燭煮渚竹竺拄藷侏硃誅蛛貯躅逐豬珠株
傑	睫傑節櫛竭潔捷頡擷結桔孑羯桀劫拮碣訐詰截	芥姐揭姊疥階戒結藉接皆借偕界嗟解介街屆誡
阪	板舨闆鈑版	搬般瓣拌斑扮頒辦瘢姅絆班扳半伴
孫	飧蓀	潠榫損筍
錦	饉覲儘僅瑾盡緊謹	金噤浸晉覲勁縉矜津燼禁斤襟今觔巾僅盡儘近筋進
蟋	悉禧行谿羲嬉晰釐吸唏曦希蹊稀淅溪畦奚犧譆熙攜烯西析兮嘻僖蜥晞棲膝犀熹	細繫席昔惜洗隙褶襲矽習鰓翕係夕蓆熄檄璽息汐系媳錫戲潟徙喜歙
邦	梆幫傍	膀旁傍綁鎊磅榜謗棒蚌
象	向橡巷像項鄉嚮相	香餉翔鄉相饗詳降廂鑲響祥瓖箱湘庠想襄享
嚥	豔晏研堰焰諺彥雁沿燕驗饜釅贗厭咽淹艷燄宴唁硯	閻癌儼菸簷衍魘掩湮醃郾咽殷巖炎延研偃妍兗眼奄煙簷胭沿燕鹽鼴醃顏筵巖厭嚴淹言焉演嫣
盂	妤隅娛榆愚魚逾禺輿愉褕竽蝓雩渝覦腴漁臾於諛圩餘餘瑜俞予歟萸於虞	瘉澦域瘀宇馭獄峪昱燠雨預迂語紆與煜齬慾噢芋育俞堉鬱豫羽毓裕禦籲嫗敔喻玉欲圉譽禺禹熨嶼癒寓愈諭圄御谷鬱淤遇庾聿尉予浴
疳	乾竿坩甘柑尷桿幹肝	橄淦幹贛敢榦感稈桿趕
拙	卓灼濯着啄茁濁著斫琢擢酌鐲	桌涿捉棹
睢	綏雖	誶碎穗髓邃歲隨隋隧燧遂祟
桔	捷拮截詰節傑桀孑侷掬頡碣劫櫛訐羯橘跼竭睫擷結潔局菊鞠傑	芥皆颶巨疽倨劇揭疥距屨俱藉誡狙齟莒舉懼瞿嗟蛆車拘借沮居拒介屆炬苣階具街鉅遽聚據接姊咀解踞戒界偕駒結句足姐鋸矩
槍	嗆鎗鏘將搶羌腔	薔嗆戕彊強繈搶牆檣
眶	壙礦況框曠	誑劻匡筐狂框
羸	累鐳擂嫘縲雷	磊累壘擂類儡漯淚蕾耒勒
頫	眺俯釜府腑撫腐斧莆輔甫父脯覜跳	氟縛匐馥覆附膚調鈇迢複夫蝠紼扶佻芾幅紱袱賻傅付拂涪赴彿服賦芙俘訃富條窕阜孚蜩弗輻挑福浮腹伏符菔副復敷怫婦孵趺咐父麩負伕駙
伕	孵趺麩膚鈇敷夫	氟縛匐馥覆附俯複夫頫蝠紼扶甫芾幅紱袱賻傅付拂涪撫斧赴莆彿服脯賦芙俘訃富府腑腐阜孚弗輻福浮腹伏符菔副復釜怫婦輔咐父負駙
消	簫宵霄嘐逍硝梟削蕭驍哮囂銷瀟	曉校嘯小傚學笑酵孝肖效篠
姣	教皎驕嬌僥焦詨角椒交蕉礁較澆餃勦跤狡郊腳繳鮫膠鉸攪絞蛟矯剿	教皎驕窖嬌僥焦詨角交椒醮蕉礁較澆勦餃跤轎狡腳郊鮫繳膠鉸攪校絞蛟叫剿矯覺嚼
音	湮殷陰慇茵因氤姻	淫蔭霪聽胤印尹吟癮鄞簷飲隱垠夤銀蚓縯引齦寅
銘	螟冥酩暝茗鳴名明瞑	暝命
峻	竣菌浚郡駿俊雋濬蕈	龜均窘君鈞軍
諸	誅朱珠茱株豬銖蛛硃侏藷	軸蛀躅鑄渚助拄箸術注主囑薴祝築朮貯柱竺杼屬煮燭駐註矚佇逐竹住
秋	丘龜鰍蚯邱鞦	毬裘梂酋仇囚球泅求
熔	鎔蓉榕戎榮容融絨溶茸嶸	茸冗
繅	艘騷搔	掃嫂
捺	鈉那納訥吶娜	拿哪那
簑	梭娑嗦縮莎唆蓑	鎖所瑣索
滄	蒼倉艙傖	藏
巖	炎延研閻妍癌簷沿簷鹽顏筵巖嚴言炎延研閻妍癌簷沿簷鹽顏筵嚴言巖	豔堰焰儼諺菸雁驗衍魘掩湮醃贗郾咽艷殷硯晏偃研兗眼嚥奄彥煙胭沿燕鼴醃饜釅厭淹燄焉演嫣宴唁豔堰焰儼諺菸雁驗衍魘掩湮醃贗郾咽艷殷硯晏偃研兗眼嚥奄彥煙胭沿燕鼴醃饜釅厭淹燄焉演嫣宴唁
搶	嗆鎗槍將鏘強闖繈羌腔	薔牀窗戕彊牆檣創鏘將撞嗆槍囪瘡幢腔鎗強闖繈羌愴
佛		
筠	紜耘雲勻雲昀芸	韻允員孕熨運隕暈醞慍蘊氳
焰	釅雁宴研艷硯嚥厭咽贗沿彥諺驗堰燄燕唁淹豔饜晏	言兗演研殷鹽菸奄顏咽巖厭閻簷沿眼湮煙偃魘郾延儼筵燕焉嫣嚴炎醃淹衍妍鼴掩癌胭
量	亮輛良糧粱晾諒涼樑	亮輛良晾兩糧魎粱倆諒涼樑
貞	禎榛箴斟真診偵砧針珍楨甄臻	賑鎮疹鴆陣枕振朕診娠震縝
縯	癮聽飲尹隱蚓引	夤胤銀鄞印飲因齦茵淫簷音寅垠湮姻陰吟慇氤蔭殷隱霪
宏	鴻訌紅弘黌閎虹泓洪	鬨烘哄薨汞轟
侍	室恃螫筮奭勢嗜舐豉市士事仕拭識試世釋柿逝是適示飾軾誓弒氏式噬使視	濕詩十施屎師史匙提矢射食碩拾蝕駛塒屍噓時什溼豕獅失始蝨實石使
祕	泌密糸汨蜜祕冪謐覓	靡瀰米謎敉糜弭瞇咪迷麋彌
春		脣醇鶉蠢淳純
氐	砥牴滴低底柢邸抵詆	滴鏑締荻迪底帝的嘀狄蒂砥諦柢弟犒翟邸芽笛抵低地敵第娣牴遞棣滌詆嫡
獰	檸嚀寧擰凝	佞濘擰
酸	痠	算蒜
勤	擒禽芹秦琴噙	嶔寢欽沁侵親撳
旅	呂鋁褸履膂屢婁侶縷	慮閭率氯綠驢濾律櫚
刁	鯛凋叼彫雕碉貂	釣調掉弔吊
嚮	鄉橡巷像象項相向	餉響祥湘詳襄降翔庠鄉鑲瓖廂享饗箱香想相
誥	告	縞糕槁皋高杲稿搞篙攪羔睪膏
磴	瞪嶝凳蹬鄧	燈登等
威	煨逶委偎崴萎	違葦魏畏帷褽偽慰緯尉薇圍唯猥諉桅謂鮪僞幃遺維渭爲巍萎喂尾餵濰惟痿闈未位危委韋胃洧微穌蔚衛味娓偉為
鋅	心薪訢莘昕辛新芯馨欣	信釁尋芯
脆	淬粹悴萃瘁橇翠	衰摧催璀崔
民	岷玟	閩皿湣愍閔澠敏憫泯抿
蛾	哦蚵俄娥峨鵝訛額	厄呃扼惡萼顎詻婀堊阿軛噩餓鱷愕啞鄂俄遏鍔
描	苗瞄	緲杪藐繆廟杳渺妙邈眇秒
囚	毬裘梂酋仇球泅求	丘龜鰍秋蚯邱鞦
紳	參信身申呻莘深娠砷伸	脤甚慎沈滲沁蜃審瀋腎哂嬸神
戮	路露鹿麓僇碌氯鷺陸錄穋祿賂	蘆滷盧魯鹵擄臚鑪櫓鱸顱爐嚕廬虜瀘
否	缶痞匹疋仳	啤媲埤劈陂脾裨匹屁琵僻枇癖疲壞紕霹被芣譬陴披鼙鈹闢批毗丕沘罷皮
裏	李禮理哩鯉李禮理哩鯉	立吏犁釐黎狸梨礫靂麗痢璃隸瀝離粒勵厲力荔歷莉籬漓例俐利慄立吏犁釐黎狸梨礫靂麗痢璃隸瀝離粒勵厲力荔歷莉籬漓例俐利慄
倌	棺關官鰥觀莞矜冠綸	貫館盥慣琯觀莞管罐冠鸛灌
枇	陂疲脾皮沘埤陴鈹罷紕琵毗啤鼙裨	劈披譬仳匹否媲丕霹痞僻壞闢鈹癖屁被紕批闢疋
閤	蓋咯盍荷鎘蛤貉禾曷盒閡隔褐閣膈葛嗑合郃河翮和格紇闔骼核劾革何鬲涸	嚇哥和歌訶各喝戈疙暍荷個赫箇鉻擱割胳郝鶴賀葛呵鴿
姿	髭諮貲淄玆資滋孳錙緇輜茲齜孜吱	籽梓紫字滓仔訾漬恣孳子自
更	耕精荊兢京旌羹經粳菁驚賡涇晶亙鯨睛莖庚	靜埂耕競井淨警哽敬羹粳勁痙賡頸鏡亙阱憬璟竟景庚徑耿逕梗靖境
溼	濕屍噓詩失獅施師蝨	室十恃螫屎筮史提匙奭實勢嗜舐豉矢射市食士事仕拭碩拾識蝕試世釋柿逝是駛適塒侍示時什飾豕軾誓弒始氏式噬石使視
張	璋蟑樟獐章彰漳	瘴脹丈賬帳掌障仗長杖漲幛
惦	靛鈿澱墊店奠電玷佃殿甸	點典滇碘癲顛巔
俱	拒拘懼鋸巨颶居遽疽倨劇苣屨句具鉅聚踞駒狙蛆車據沮瞿距足炬	橘拒拘菊懼鋸巨炬颶居鞠莒遽跼疽齟倨劇苣桔屨局句具鉅聚踞駒狙蛆舉車據沮掬瞿距足侷咀矩
珀	醱破粕迫泊魄樸	剖婆陂波叵鄱潑坡頗
黨	檔擋讜	儅擋噹襠盪當鐺蕩
鵠	凸壺鬍蝴斛罟鼓賈穀狐轂股谷胡滑湖牯蠱囫葫瞽弧瑚糊古鈷詁骨	瓠菰鴣琥許僱惚唬戲呼戶顧滬估楛僱沍呱故護孤互告沽蛄扈虎咕辜乎錮忽鈷姑固骨家
愜	契妾竊切挈怯鍥	伽切茄且
涔	岑	參
酊	叮仃鼎丁頂盯釘	定叮仃丁鼎盯頂錠訂釘
黎	罹麗蠡犁璃貍漓蜊喱狸梨籬犛驪離釐	裏荔琍儷利厲痢例欐莉曆醴礫李勵鯉瀝慄禮隸理浬蒞釙蠣靂俚立粒礪壢唳力邐娌俐戾澧吏麗蠡鬲溧癘鋰笠裡哩歷酈
鎚	陲垂捶槌錘箠椎綞	炊吹
迆	尾椅以蟻已乙矣旖偯迤倚	漪藝屹肄軼刈誼囈迤移縊逸彝溢佾夷沂宜劓醫疫頤噫疑懿鎰毅揖義訑蛇邑億液佚役儀易羿裔姨咦弋蜴壹驛飴弈譯帟翌異益栘臆遺亦艾腋曳咿議詣意伊繹怡貽憶掖浥翳圯胰奕一翼抑衣痍依
諧	挾頡擷偕斜邪攜勰協鞋脅	卸洩歇榭蠍寫屑血楔蟹邂契褻懈謝駭械燮解些瀉紲屜
胰	儀怡飴咦姨痍頤遺移蛇圯夷誼彝一沂栘迤貽訑宜疑	咿詣劓揖羿浥異益議藝軼意刈鎰依縊迆肄逸憶以噫抑乙艾佚矣奕翌衣伊佾誼億漪役蟻尾翳已懿壹一掖醫屹易裔繹旖倚液弋迤帟偯邑腋曳溢椅臆翼亦囈蜴驛毅義譯弈疫
侶	呂鋁褸履膂屢旅婁縷	慮閭率氯綠驢濾律櫚
擲	執職植質姪值直躑殖摭	智徵制脂痔梔致之製蛭址躓質窒雉芝泜胝枝吱峙祉幟肢支祇稚趾祗炙痣識汁咫置輊只至織卮滯紙隻芷止蜘秩摯知指氏緻治志旨誌
矽	翕潟戲夕隙係繫系汐歙細	攜烯嬉蓆膝惜璽洗溪析媳棲息蟋羲錫蹊昔褶曦淅悉熹禧犀行蜥稀希吸習徙晰畦兮鰓熙釐喜谿譆犧唏晞嘻西席奚熄襲僖檄
鉋	鑤暴爆鮑報抱刨豹	雹葆堡包褓褒飽胞寶保苞薄
錳	猛懵蜢艋	夢朦虻萌孟蒙檬濛甍盟矇懵
慍	韻員孕熨運暈醞蘊	紜耘雲允勻筠隕雲昀暈氳芸
圃	普溥譜浦誧埔	撲菩蒲脯濮璞曝噗莆瀑樸匍鋪釙暴葡蹼僕
碟	迭耋跌絰喋牒疊諜蝶	爹
帽	冒瑁茂懋貌耄貿	茅茆卯髦泖毛貓矛錨
蝶	迭耋跌絰喋牒疊碟諜	爹
如	燸濡嚅孺蠕儒茹	汝入女褥辱孺乳茹
捫	們門	燜們懣悶
滋	髭諮貲淄玆資孳錙緇輜茲齜孜吱姿	籽梓紫字滓仔訾漬恣孳子自
磊	累壘儡漯蕾耒	累鐳擂類嫘縲淚羸雷勒
逕	竟鏡徑靖敬痙競淨勁靜境	莖驚頸涇景井粳睛鯨精警更荊菁憬兢經阱璟晶旌京
宙	縐皺胄咒冑籀晝紂	妯啁州軸帚洲肘週周粥舟
燉	鈍囤噸頓盾沌遁盹	蹲躉墩敦惇盹
願	怨院苑願遠媛	遠湲員猿鳶袁援宛原媛沅轅垣爰元鴛騵淵圓緣園冤源
努	弩	駑奴怒
蔡	採菜	採綵睬裁彩纔採財才猜材踩
嘗	腸嫦嚐徜萇裳場長償常	暢鯧敞悵娼氅昌場猖唱倡倀廠
也	冶野	椰葉耶噎業曄射頁謁鄴靨夜咽爺拽琊
伊	咿揖壹一噫醫依衣漪	劓羿浥益藝軼鎰姨痍肄頤憶遺矣佚翌夷一屹栘貽溢臆囈訑疑偯議意刈以移乙蛇役圯億蟻沂繹弋迤腋毅譯儀詣怡咦縊逸抑彝懿倚液帟翼義疫飴異迆胰艾奕衣佾誼尾翳已掖易裔旖邑曳椅亦蜴驛宜弈
舟	啁州洲週粥周	妯縐皺軸帚胄咒宙肘冑籀晝紂
紀	霽髻寄際繼繫稷薺技記忌騎悸覬劑季計祭妓驥濟鯽芰暨洎薊系冀躋既	急唧疾脊跡即寂楫屐居伋績擠吉犄饑譏擊羈機及乩嫉積激己汲藉亟岌吃瘠奇給稽借棘箕級圾嘰戟麂躋蹟籍濟輯畸嵇幾其肌期集戢飢雞極癘璣基磯畿姬勣
毯	袒坦	探碳覃貪罈歎談坍攤癱嘆炭彈曇痰潭譚灘壇檀
立	荔琍儷痢例利厲欐莉曆礫勵瀝慄隸蒞釙蠣靂礪壢粒唳力戾俐吏麗癘鬲溧笠歷酈	裏貍醴李離鯉釐黎罹禮漓理浬梨驪狸蜊俚娌邐澧麗蠡犁璃鋰喱籬犛裡哩
滾	輥鯀袞	棍
竿	柑乾幹尷甘坩疳肝杆桿	敢淦幹橄榦桿感稈趕贛
牠	他她它塌	遝塔漯榻蹋踏獺遢塌躂撻
諮	髭貲淄玆資滋孳錙緇輜茲齜咨孜吱姿	籽梓紫字滓仔訾漬恣孳子自
檀	痰談潭譚覃壇罈彈曇	坍癱灘探碳袒嘆毯貪攤炭歎坦
練	瀲煉楝斂鏈鍊戀殮	憐漣奩簾蓮濂鐮臉聯鰱連廉
厲	荔琍儷痢例利欐莉曆礫勵瀝慄隸蒞釙蠣靂立礪壢粒唳力戾俐吏麗癘鬲溧笠歷酈	裏貍醴李離鯉釐黎罹禮漓理浬梨驪狸蜊俚娌邐澧麗蠡犁璃鋰喱籬犛裡哩
吆	要妖夭邀喲腰麼	藥餚洮淆瑤崤要搖窈樂爻舀鷂姚榣杳僥遙謠耀堯拗曜窯夭咬鑰
店	靛鈿澱墊奠電惦玷佃殿甸	點典滇碘癲顛巔
泱	鴦殃鞅央秧	鍚烊養佯瘍仰揚洋颺怏羊楊徉癢樣漾昜恙暘鞅氧煬陽
致	智制痔製蛭躓窒質雉峙幟稚炙痣識置輊至滯秩摯知緻治志誌	徵植脂梔直摭之址質泜芝值胝躑枝吱祉祇肢擲支趾執祗職汁咫只殖織卮紙隻芷止蜘知姪指氏旨
託	托脫拖	妥駝柝佗沱跎橢陀鴕唾拓馱
豉	拭恃式軾適是柿飾奭氏士使視螫弒市示試仕噬誓筮室勢侍世嗜識逝事釋舐	豕屍匙溼獅蝨使拾詩碩失十蝨噓始塒石蝕實食施時提史師濕屍矢什屎射駛
洽	霞峽黠挾轄呷恰遐匣狎柙斜瑕狹暇俠	夏卡廈下嚇暇蝦瞎
墩	敦蹲惇	燉頓遁盾噸沌囤盹鈍躉
沱	馱跎陀鴕佗駝	唾脫橢拖柝妥託拓託
娉	乒	枰屏瓶坪評憑萍平馮蘋
誰		蛻說稅睡水
撚	輦碾拈攆輾捻涊	念唸黏廿年
仞	衽刃紉妊韌認飪軔任賃	仁荏稔壬人忍兒任
笠	慄儷麗礫礪唳痢歷靂力慄立溧蒞癘壢戾曆琍吏粒例利厲釙荔欐俐酈隸蠣勵瀝鬲莉	禮喱澧醴麗犁哩鯉犛貍籬黎娌璃浬釐離理驪邐李鋰梨狸裡罹裡漓蠡蜊俚
亡	無梧巫毋蜈王鼯吳蕪誣唔	罔巫勿騖王軏寤圬望尢屋嫵誤網惡舞魍物汙堊烏兀誣務旺鎢塢悟霧妄忘五於侮汪枉捂惘鵡晤嗚往戊午武伍污輞憮
弓	躬供宮龔釭紅蚣公攻恭共工肱功	供鞏汞礦共廾拱貢
踩	綵採睬彩	猜採纔材才菜財裁蔡
欐	慄儷麗礫礪唳痢歷靂力慄立癘溧蒞壢戾曆琍吏笠粒例利厲釙荔俐酈隸蠣勵瀝鬲莉	禮喱澧醴麗犁哩鯉犛貍籬黎娌璃浬釐離理驪邐李鋰梨狸裡罹裡漓蠡蜊俚
軏	粵越嶽耀晤閱騖悅塢悟誤務鑰刖嶽籥說寤惡戊物躍勿月樂霧兀鎢藥曜堊玥	武汙鵡巫侮吾亡曰誣無吳午五烏毋伍惡約嗚鼯嫵於唔憮屋舞圬鎢捂污梧蕪蜈
漠	膜末貊莫磨陌默墨驀沫秣脈茉寞沒歿	膜抹蘑摩摸磨模糢謨魔摹麼
籟	睞癩賴瀨	徠來萊
麼	痲要妖吆麻嘛夭蟆邀喲腰	抹沫墨藥脈餚魔洮淆漠沒歿瑪膜末瑤貊蘑崤要默媽糢搖茉嗎窈蟆樂爻摹嘛舀鷂莫摩姚榣陌磨馬杳僥遙謠耀模螞摸罵寞堯嬤拗曜窯驀夭謨咬鑰碼秣
提	塒緹題隄時碩什拾射食蹄十蝕啼堤實石	濕詩悌室踢恃施螫屎筮師史匙奭梯勢嗜舐豉矢市涕剔士替逖事仕拭惕識嚏屜試世釋柿逝是駛適噓屍侍示銻飾豕軾溼獅失誓弒剃始氏式體蝨噬使視
聰	樅從囪匆蔥	從叢淙
巒	鑾灤鸞	亂卵
孛	貝鋇倍背焙輩狽備臂邶憊悖被蓓	杯盃北揹卑背俾碑悲裨
罩	櫂詔趙晁肇兆炤棹照召	找釗晁招着著朝沼爪嘲昭召
禍	獲壑穫或惑貨濩豁霍擭	活夥火豁和
渡	度妒肚蠹杜鍍	讀賭肚睹嘟髑都獨督毒篤黷瀆堵櫝犢牘
螟	冥酩暝茗鳴名明瞑銘	暝命
啣	嫌嫻舷銜閒閑絃鹹涎賢鹹弦	僩纖峴餡顯限莧銑暹秈癬現險霰腺祆姍羨鮮憲仙獻蜆陷掀縣先線蘚
塑	溯嗉訴速縮粟蓿宿素夙肅簌	囌酥蘇俗甦穌
鐮	憐漣奩簾蓮濂聯鰱連廉	瀲煉楝斂鏈臉鍊戀殮練
迢	條佻調蜩	頫眺挑覜窕跳
騙	片遍	扁便偏胼篇翩駢
解	卸芥洩榭姐屑姊楔疥蟹戒邂藉契褻懈借謝駭械界燮介屆誡瀉紲屜	睫傑節櫛芥竭歇姐蠍揭寫潔捷諧血姊頡疥階擷邪戒結桔藉羯鞋孑接皆勰桀借劫偕拮碣攜界嗟挾訐介屆街詰斜誡些協截脅
什	塒甚時碩拾射食十蝕蛇舌實石提	濕攝涉葉捨詩室恃施螫屎筮麝史匙社奭師勢嗜舐豉矢射舍市士事仕拭拾設賒識試世釋柿逝是駛適噓屍侍示奢飾豕軾溼獅失赦誓弒始氏式蝨噬歙使視
孔	倥恐	崆倥硿控空
閉	庇埤幣裨箄襞篦蔽鄙必弊斃比蹕碧詖鉍賁陛避畢壁嗶闢璧臂敝痺愎泌睥婢薜祕弼俾	逼鄙匕筆鼻沘比妣彼
商	殤湯觴傷	晌裳賞上尚
著	釗遮擢濁朝昭卓濯琢晁鐲召酌招拙嘲灼斫啄茁	遮蔗昭肇謫炤者宅浙哲趙摘照螫找桌釗棹朝懾罩沼赭爪詔轍晁召這蜇折摺招兆輒嘲涿鷓捉櫂褶
歡		宦環患豢喚換洹桓緩梡寰瘓煥鍰澴幻皖奐渙還
娟	圈身捐鵑涓鐫	倦雋絹圈卷捲狷眷
甕		嗡翁蓊
貝	鋇背倍臂輩備孛悖憊邶狽焙蓓被	碑背杯北卑裨揹悲盃俾
涓	圈身捐鵑鐫娟	倦雋絹圈卷捲狷眷
彼	鄙筆匕沘比妣	庇埤幣裨箄襞篦蔽鄙必弊斃比蹕逼碧詖鉍賁陛避畢壁嗶闢璧臂敝痺愎泌睥婢薜鼻閉祕弼俾
胥	須墟訏鬚需虛籲戌噓	敘恤畜絮洫蓄婿酗卹許緒頊徐煦勗咻栩續旭序
鞘	殼俏蹺撬竅翹誚峭	樵巧雀憔蹺敲撬悄橇譙愀鍬瞧鵲喬僑橋翹
給	幾脊戟麂己濟擠	霽寄擊忌騎悸藉紀瘠計圾籍畸洎璣磯飢既躋唧脊楫居績稷譏羈覬劑吃季借稽祭蹟驥鯽幾集犄姬際伋吉薺饑機及乩亟奇棘箕妓濟嵇其芰戢雞基薊系冀急髻疾跡繼寂即繫屐技記激嫉汲積岌級嘰輯癘肌期暨極畿勣
鍬	蹺橇敲撬	憔雀譙俏鵲殼愀蹺翹竅鞘悄瞧巧僑峭喬樵誚橋撬
位	魏畏褽偽慰尉謂僞遺渭爲喂餵未胃穌蔚衛味為	違葦帷崴緯薇圍唯煨猥桅諉逶鮪幃維威巍偎萎尾濰惟痿闈委危韋微洧娓偉為
沖	衝充憧舂	衝寵崇蟲蟲重
夔	葵睽魁揆奎逵	匱愧窺盔餽虧喟傀簣潰
仃	叮酊丁盯釘	定酊鼎頂錠訂釘
肆	泗四伺兕嗣俟巳食耜祀駟賜寺似飼姒	嘶絲思斯廝死私司鷥撕
絰	碟跌耋牒迭蝶諜喋疊	爹
灞	耙壩伯爸罷霸	把跋靶笆吧杷芭叭疤巴扒鈸捌罷八拔琶
鎖	索瑣所	莎縮梭嗦娑唆簑蓑
蹣	蠻盤漫般胖鰻蟠饅槃磐踫瞞	蔓屘漫叛判幔滿畔縵鏝慢拚潘曼盼攀
煤	媒玫眉黴梅楣枚莓沒湄	妹瑁每昧魅袂鎂美媚沬寐
芸	紜耘雲勻筠雲昀	韻允員孕熨運隕暈醞慍蘊氳
兵	冰	餅秉摒丙鉼炳稟柄屏並併病
樁	妝裝莊	壯撞狀奘
謝	燮屑解褻懈卸契瀉楔洩蟹駭邂榭械紲屜	寫血挾諧頡擷偕歇蠍邪斜些攜勰協鞋脅
嵯		磋措錯厝蹉挫銼撮搓
陽	楊鍚徉颺揚瘍暘羊洋烊煬昜佯	怏漾煬殃泱養癢氧鞅仰央秧樣鴦恙
均	龜君鈞軍	竣菌浚窘郡駿俊雋濬蕈峻
俄	厄鵝呃扼哦惡萼顎詻堊軛蛾蚵娥峨噩訛餓鱷愕額啞鄂遏鍔	厄鵝呃扼哦惡萼顎詻婀堊阿軛蛾蚵娥峨噩訛餓鱷愕額啞鄂遏鍔
砸	咱偺雜	匝紮
在	載再	宰災栽載仔哉
夠	遘雊媾詬搆構購垢	苟鉤狗溝勾枸句
作	祚昨做座鑿坐砟柞	祚昨左座做鑿坐佐砟柞
精	晶鯨睛莖京更荊經粳菁兢驚旌涇	靜競井淨警敬勁痙頸鏡阱憬璟竟景徑逕靖境
子	籽梓紫滓仔訾	字訾淄仔玆恣錙自輜籽滓資孳茲吱梓貲孜姿髭紫諮漬滋齜緇
諶	陳宸娠晨忱臣塵辰沉沈	讖櫬稱襯疢琛趁瞋
刀	叨	蹈盜悼導道到稻島搗禱倒
璨	孱燦	殘慘餐慚蠶參
嫻	嫌舷銜閒閑絃啣鹹涎賢鹹弦	僩纖峴餡顯限莧銑暹秈癬現險霰腺祆姍羨鮮憲仙獻蜆陷掀縣先線蘚
狠	很	痕恨
拿		鈉那納訥吶捺娜哪
母	牡拇姥姆畝	慕穆模募墓木目沐睦苜幕暮牧
屯	肫囤臀豚飩諄	準吞褪
蟬	讒孱毚單饞蟾潺澶嬋禪巉纏	摻闡儳攙羼剷鏟懺諂產
鰥	棺關官觀莞倌矜冠綸	貫館盥慣琯觀莞管罐冠鸛灌
辨	辯遍變汴卞弁釆辮便	扁鞭蝙編匾邊褊貶砭
照	櫂詔罩趙晁肇兆炤棹召	找釗晁招着著朝沼爪嘲昭召
荒	肓慌	凰恍遑湟幌黃篁晃簧謊韹洸煌蝗隍皇徨璜惶磺
侵	欽嶔親	擒禽寢沁芹勤琴秦噙撳
燾	洮桃濤萄陶檮淘逃啕	滔討濤絛套掏韜饕
強	薔絳戕彊將繈搶醬牆匠檣降	薔羌戕江彊薑蔣講僵檣獎槳疆姜鏘將繮漿搶嗆槍腔鎗繈韁牆
摯	智制痔致製蛭躓窒質雉峙幟稚炙痣識置輊至滯秩知緻治志誌	徵植脂梔直摭之址質泜芝值胝躑枝吱祉祇肢擲支趾執祗職汁咫只殖織卮紙隻芷止蜘知姪指氏旨
蚯	丘龜鰍秋邱鞦	毬裘梂酋仇囚球泅求
翡	菲斐匪誹	費痱菲屝肥沸非腓妃飛吠怫扉廢霏肺芾啡
擰	檸獰嚀寧凝	佞檸獰嚀寧濘凝
瘴	脹丈障賬長仗幛漲帳杖	長獐掌漳漲蟑樟彰章璋張
魚	諛雩予竽愚禺虞蝓盂逾褕圩榆渝萸漁瑜輿歟於腴妤隅愉臾餘覦俞娛	芋與馭御喻育宇雨予禹瘉寓譽禺迂鬱尉齬噢癒圉諭玉澦煜語欲谷庾裕嶼昱愈紆聿峪嫗籲預豫圄域浴羽獄毓遇淤堉慾瘀敔禦熨俞燠
荏	稔忍	刃衽妊紉人仞兒軔任仁壬韌認飪賃
薑	疆漿江姜將韁僵	匠蔣講彊槳絳將獎醬降強
雨	與圄庾齬羽噢嶼圉宇予禹語敔	芋與馭御喻魚育諛雩予竽瘉愚禺虞迂鬱寓尉蝓癒盂逾褕諭玉圩澦瘀榆渝語煜漁欲谷瑜萸輿裕歟於昱愈腴紆聿妤峪嫗隅籲預豫娛域愉浴臾獄毓餘遇淤堉慾覦譽禦熨俞燠
匿	溺暱膩逆泥睨	尼你霓妳倪泥擬旎呢怩妮
肯	齦懇墾啃	
熱		若惹
耆	歧淇其琪旗齊琦麒棋騎祺臍畦鰭祁崎圻奇岐衹祇期祈枝錡	愒萋淒妻欺溪豈綺磧棄杞乞汽啟柒器棲企訖谿稽漆慼亟迄悽泣起契憩戚砌七緝氣
猿	沅轅垣圓爰緣湲袁園援元騵原源媛員	怨院鳶苑宛鴛願淵遠冤媛
罕	喊	韓瀚含涵銲悍鼾憾函蚶焊漢寒旱榦撼酣頷捍和翰汗頜
豭	嘉痂袈茄夾加葭傢佳家迦	架假夏鉀頰稼甲挾駕價浹賈莢戛夾嫁胛
膩	溺暱逆泥匿睨	尼你霓妳倪泥擬旎呢怩妮
諱	匯繪賄慧卉潰會彙晦誨喙彗惠穢燴蕙	蛔賄會蟲詼輝茴揮虺回麾燬徽灰毀迴墮恢暉悔誨
豆	讀逗痘竇鬥脰	都陡抖鬥蚪兜枓
嗡	翁	甕蓊
纜	覽爛欖攬濫懶	蘭覽攔爛斕襤瀾欖嵐藍籣攬濫闌婪籃懶欄
狐	囫糊鵠胡鬍蝴葫壺湖弧斛瑚	戶滬虎沍扈乎瓠忽惚互琥唬戲護楛許呼
癢	養鞅仰氧	楊颺羊泱養央昜漾殃洋鞅樣鴦怏徉揚秧烊煬鍚瘍陽暘恙佯
舶	卜鈸博蔔鉑駁箔荸脖搏檗渤帛薄白柏膊勃泊伯	玻菠薄亳般薜擘蘗簸檗剝跛缽播撥
撬	蹺鍬俏誚翹竅鞘峭橇殼敲	憔雀譙俏鵲殼愀蹺翹竅鞘悄瞧巧鍬僑峭喬樵誚橋橇敲
刎	吻穩	雯玟紋紊蚊抆汶文聞問瘟溫免塭
金	津觔巾禁斤襟今筋矜浸	晉饉噤燼覲進儘僅禁瑾近勁謹盡緊縉錦浸
窗	瘡囪創	撞牀創闖搶愴幢
漂	飄剽驃縹票瞟	飄剽瓢驃縹票嫖瞟
燥	竈造噪皁譟躁	蚤糟鑿澡遭藻棗早
擠	幾給脊戟麂己濟	霽寄擊忌騎悸藉紀瘠計圾籍畸洎璣磯飢既躋唧脊楫居績稷譏羈覬劑吃季借稽祭蹟驥鯽幾集犄姬際伋吉薺饑機及乩亟奇棘箕妓濟嵇其芰戢雞基薊系冀急髻疾跡繼寂即繫屐技記激嫉汲積岌級嘰輯癘肌期暨極畿勣
擻	叟藪嗾	搜餿蒐嗽颼
疢	讖櫬稱襯趁	晨諶塵宸陳娠忱琛臣瞋辰沉沈
鷺	路露鹿戮麓僇碌氯陸錄穋祿賂	蘆滷盧魯鹵擄臚鑪櫓鱸顱爐嚕廬虜瀘
塽	爽	雙孀霜
皺	縐胄咒紂冑籀晝宙	妯啁州軸帚洲肘週周粥舟
獗	鴃掘鱖抉決譎蹶劂腳倔玨角攫爵孓崛觼覺蕨訣厥絕嚼噱	倔蹶嗟
詖	弊璧必敝鉍薜嗶痺箄襞避臂斃庇畢俾愎陛碧賁泌鄙蹕篦蔽埤闢閉弼婢祕比壁睥幣裨	彼鄙筆逼匕比沘鼻妣
駟	賜祀泗肆兕食飼巳伺嗣似耜寺姒俟四	撕司廝絲斯鷥私思嘶死
郡	雋浚峻駿濬俊蕈菌竣	鈞龜窘軍君均
腔	嗆鎗槍鏘將搶羌	薔嗆戕彊強繈搶牆檣
鬃	蹤縱綜宗棕	傯總糉縱綜從
蟒	莽	芒茫盲杗氓忙
癘	儷璣羈肌歷靂力慄立溧雞磯乩積幾琍粒績期機屐利厲跡嵇蹟基俐蠣居莉鬲慄畸姬畿其麗礫礪犄唳痢飢蒞壢幾唧箕戾曆吏笠奇譏激例稽勣釙荔欐躋隸酈嘰勵瀝饑	棘洎澧醴暨疾忌哩集祭脊己騎藉黎芰劑娌幾記璃離瘠楫理覬紀邐計狸極級漓蠡俚妓冀禮戢喱擊寄麗輯鯉犁寂給犛薊貍及嫉籬際幾唧麂繼擠伋急薺吉浬圾季稷釐即髻霽技汲吃亟驪既李鋰悸梨躋籍繫裡罹岌裡濟鯽戟蜊驥
洱	邇餌耳爾	兒而貳二
航	吭行杭桁	行沆
兇	兄凶洶胸匈	雄熊
憲	莧陷霰腺限羨現獻峴蜆線餡僩縣	賢蘚閒祆秈暹涎鮮纖先嫻銑險仙蜆顯癬嫌弦啣閑絃掀銜鹹舷姍
犬	荃蜷銓卷權畎詮全甽泉痊佺拳踡	券荃蜷銓卷權畎詮全圈甽泉痊佺拳踡勸
氨	鞍庵安鵪諳銨	按菴暗岸俺黯案
嘔	甌耦區噢藕歐毆偶鷗	甌耦區噢藕歐毆偶鷗
無	梧巫毋蜈鼯吳亡蕪吾誣唔	巫勿騖寤軏圬屋嫵誤惡舞物汙堊烏兀誣務鎢悟塢霧五於侮捂鵡晤嗚戊午武伍污憮
槭	鏃趨錯促卒蹴蹙簇醋趣	粗
偽	位慰魏胃衛蔚謂未褽遺尉喂渭畏為味穌餵	尾娓維痿緯萎威韋唯惟濰圍桅為崴煨薇逶幃葦危偉洧帷鮪微巍偎闈猥諉違委
玉	芋與馭御喻育瘉寓禺鬱尉癒諭澦語煜欲谷裕昱愈聿峪嫗籲預豫浴域獄毓遇堉慾譽禦熨俞燠	與魚諛宇雨雩竽禹予愚禺虞迂齬蝓噢盂圉逾褕圩瘀榆渝語萸漁瑜庾輿嶼歟於腴紆妤隅圄愉羽臾餘淤覦敔俞娛
腿		蛻推退頹
測	側冊廁策惻	
邃	誶碎穗歲隧燧遂祟	髓隨隋綏睢雖
千	纖牽簽搴鉛愆謙韆嵌遷籤騫縴仟阡	倩潛鈐欠黔淺箝乾幹遣前歉鉗塹譴虔縴錢
煙	湮殷醃淹菸奄厭咽嫣燕胭焉	釅言雁宴兗演研艷硯嚥鹽顏咽巖厭贗簷閻沿眼彥諺偃魘驗堰郾焰延儼筵燄燕嚴炎唁淹衍豔妍鼴饜掩癌晏
輩	鋇背倍臂貝孛備悖憊邶狽焙蓓被	碑背杯北卑裨揹悲盃俾
胳	鴿割歌疙戈擱哥	革格隔個膈合鬲蛤鉻骼閤箇閣咯鎘各郃葛
惟	危維帷微巍韋唯闈圍濰為桅違薇幃	尾娓魏衛胃蔚痿緯萎威未遺渭為崴味穌煨逶餵偽葦位慰偉洧謂鮪偎褽尉喂畏猥諉委
彿	氟縛匐夫蝠紼扶芾幅孚弗輻紱袱福浮伏符菔拂涪怫服芙俘	富馥覆附膚俯鈇複府夫腑腐頫甫阜腹賻副傅復釜敷付撫斧孵赴婦莆趺輔咐父麩脯賦負駙伕訃
煌	凰隍遑皇徨簧璜黃湟篁韹惶磺蝗	幌恍慌荒謊肓洸晃
玟	岷文聞雯紋蚊民	澠紊抆閔刎汶閩文聞憫問吻瘟敏抿愍溫穩泯皿免塭湣
耋	碟跌牒迭蝶絰諜喋疊	爹
溢	詣劓羿浥異益議藝軼意刈鎰縊肄逸憶抑艾佚奕翌衣佾誼億役翳懿一掖屹易裔繹液弋帟邑腋曳臆翼亦囈蜴驛毅義譯弈疫	咿儀揖怡飴咦依姨迆痍胰頤以遺噫移乙矣蛇衣伊夷誼尾漪圯蟻彝已壹一醫沂旖栘倚迤貽椅訑宜疑偯
邁	賣麥脈	買埋霾
項	向橡象巷像鄉嚮相	香餉翔鄉相饗詳降廂鑲響祥瓖箱湘庠想襄享
撕	嘶絲思斯廝私司鷥	思寺似伺兕食耜祀泗嗣巳駟賜飼肆四俟死姒
闋	鵲殼確雀榷闕恪怯卻	瘸缺闕
埂	哽耿梗	亙耕庚更羹粳賡
橄	敢感稈趕杆桿	淦柑乾幹尷榦甘桿疳坩肝竿贛
嗨	咳亥駭氦害	咳還亥駭氦害海孩骸
鵝	哦蛾蚵俄娥峨訛額	厄呃扼惡萼顎詻婀堊阿軛噩餓鱷愕啞鄂俄遏鍔
昔	惜習檄褶錫息媳席襲蓆熄	細悉禧行谿羲繫嬉晰蟋釐洗吸唏曦隙希蹊稀淅溪矽畦奚鰓係翕犧譆熙夕攜烯析西兮嘻僖蜥晞棲璽系汐膝潟戲犀熹徙喜歙
儂	穠濃噥農膿	弄
牢	癆勞嘮	佬酪絡烙撈姥老勞
拔	鈸跋	芭把杷吧琶霸扒壩耙疤捌巴靶爸叭八笆灞伯罷
駝	馱佗跎陀鴕沱	妥託柝脫橢拖唾拓
娼	倀猖倡昌鯧	常場長暢裳腸倡敞萇償唱嚐廠嫦悵氅徜嘗
押	鴨蚜衙涯牙煆鴉呀丫壓芽	啞鴨亞疋蚜芽衙訝涯牙軋煆雅鴉呀丫壓氬
鬍	瑚壺鵠蝴胡糊湖葫囫弧斛狐	瓠互琥虎扈許惚唬乎戲呼戶忽滬楛沍護
沂	咦姨飴疑怡貽誼訑迤蛇栘移彝夷遺圯胰儀宜一痍頤	漪蟻藝屹肄軼刈誼囈迤縊以逸佾已溢劓醫疫噫乙懿鎰毅揖義迆邑億液役佚易羿倚尾弋裔蜴椅壹驛弈旖譯帟翌異益偯臆亦艾腋曳咿議詣意伊繹憶掖浥翳矣奕一翼抑衣依
避	庇埤幣裨箄襞篦蔽鄙必弊斃比蹕碧詖鉍賁陛畢壁嗶闢璧臂敝痺愎泌睥婢薜閉祕弼俾	逼鄙匕筆鼻沘比妣彼
部	埠佈鈽布不怖步簿	卜捕補不埔哺
璧	庇埤幣裨箄襞篦蔽鄙必弊斃比蹕碧詖鉍賁陛避畢壁嗶闢臂敝痺愎泌睥婢薜閉祕弼俾	逼鄙匕筆鼻沘比妣彼
凡	藩煩釩蕃礬樊繁帆墦	犯反返蕃梵泛番汎幡販翻飯繙範氾帆
暇	霞呷狎柙瑕黠遐廈洽下嚇轄狹夏峽挾匣斜俠	霞呷狎柙瑕蝦黠遐廈洽下嚇瞎轄狹夏峽挾匣斜俠
震	賑鎮鴆陣枕振朕娠	疹禎榛枕斟箴真診偵砧貞針珍甄楨縝臻
軒	宣晅萱煖諼喧壎暄	選縣渲漩眩玄炫絢璿鉉懸旋還
儀	怡飴咦姨痍胰頤遺移蛇圯夷誼彝一沂栘迤貽訑宜疑	咿詣劓揖羿浥異益議藝軼意刈鎰依縊迆肄逸憶以噫抑乙艾佚矣奕翌衣伊佾誼億漪役蟻尾翳已懿壹一掖醫屹易裔繹旖倚液弋迤帟偯邑腋曳溢椅臆翼亦囈蜴驛毅義譯弈疫
雅	啞亞疋	鴨亞蚜芽衙訝涯牙軋煆押鴉呀丫壓氬
袋	待迨代大貸黛逮殆戴玳岱帶怠	呆待逮歹
褡	瘩答搭躂	瘩答大打達韃靼怛
伋	棘戢疾擊輯寂集脊及嫉藉唧急吉圾即楫瘠汲吃亟級極籍岌	洎璣羈暨忌肌祭脊己騎芰雞磯乩劑積幾記績期屐機嵇跡覬紀蹟基計妓居冀畸姬畿其寄給犄薊飢癘際幾唧箕麂繼擠薺奇譏激季稷髻霽技勣稽既悸躋繫嘰濟鯽戟驥饑
灤	巒鑾鸞	卵亂
跤	教礁澆姣驕郊鮫嬌焦膠詨交椒蛟蕉	教較餃勦姣轎皎狡窖腳繳僥鉸攪角校絞叫矯剿覺醮嚼
猥	葦尾娓諉偉洧痿緯鮪萎委	魏衛胃蔚維萎威未韋唯遺惟渭濰圍桅為崴味穌煨薇逶餵幃偽慰位危謂帷微巍偎褽尉喂闈畏違委
桅	薇圍唯違濰惟幃維帷闈危巍爲韋微為	葦魏畏褽偽崴慰緯尉猥諉煨謂逶鮪僞遺渭威偎萎喂尾餵痿未位委胃洧穌蔚衛味娓偉為
絕	觼蕨嚼劂掘訣鴃崛倔鱖玨覺獗厥腳抉孓譎爵攫蹶決噱角	蹶嗟倔
禮	裏澧蠡鋰俚理浬李醴娌裡哩邐鯉	荔琍儷利厲痢貍例欐莉曆礫勵離釐黎罹瀝慄隸漓蒞梨犛釙蠣驪狸靂蜊立粒礪壢唳力戾俐吏麗蠡鬲溧璃犁癘笠喱籬哩歷酈
階	皆街偕結接嗟揭	睫傑節櫛芥竭姐潔捷姊頡疥擷戒結桔孑藉羯桀借劫拮碣界解訐介屆詰誡截
仗	瘴脹丈賬帳障長杖漲幛	璋蟑樟獐掌彰章張長漲漳
沿	釅言雁宴研艷硯嚥鹽顏咽巖厭贗簷閻彥諺驗堰焰延筵燄燕嚴炎唁淹豔妍饜癌晏	言釅雁宴兗演研艷殷硯嚥鹽菸奄顏巖厭咽簷閻贗眼湮彥諺煙偃魘驗堰郾焰延筵儼燄燕焉嫣嚴炎唁醃淹衍豔妍鼴饜掩癌胭晏
唐	醣搪膛棠鏜螳瑭堂糖塘	淌湯趟帑倘鏜儻燙躺
策	側冊廁測惻	
筧	繭減囝檢撿柬簡揀剪鹼儉瞼	件檻箋劍健僭見縑艦兼姦韉毽漸殲諫奸艱濺踐監箭間閒肩尖湔薦腱鍵建堅餞鑑鑒菅澗緘賤薦煎
蚶	和鼾酣	憾悍旱頜含函韓漢榦汗頷涵銲翰撼罕捍瀚喊寒焊
捂	嫵舞午五侮武伍鵡憮	無巫毋勿騖寤軏圬屋梧誤惡物汙堊烏吾兀誣務鎢塢悟霧吳鼯於蕪晤嗚戊蜈亡污唔
璟	頸憬景井阱警	竟驚涇靖粳睛精勁靜更徑兢晶旌京莖痙鯨競淨荊鏡菁敬經逕境
貢	供共	拱龔鞏紅廾肱功躬供蚣公礦共釭宮攻恭汞工弓
婦	富父復覆阜駙複傅咐訃腹附賦賻副付負馥赴	孚拂斧夫芙敷莆父袱腐蝠菔氟腑撫符幅輔服鈇俯釜扶甫膚芾輻伏俘匐彿頫伕紼脯縛府浮涪趺福弗怫孵麩紱
勇	壅永恿泳詠臃蛹湧擁俑踊踴甬	壅庸傭邕臃雍擁鄘慵用
華	樺話花猾滑畫劃化嘩豁譁	樺話花猾滑畫劃化嘩豁譁
走		奏啁陬鄒鄹驟揍
絲	嘶思斯廝私司鷥撕	思寺似伺兕食耜祀泗嗣巳駟賜飼肆四俟死姒
現	莧陷霰憲腺限羨線獻峴蜆餡僩縣	賢蘚閒祆秈暹涎鮮纖先嫻銑險仙蜆顯癬嫌弦啣閑絃掀銜鹹舷姍
黯	菴暗按案岸	諳鞍安氨庵銨俺鵪
歙	麝攝捨赦係系矽汐涉葉翕拾潟設夕戲隙繫社射細	攜烯嬉蓆賒膝惜璽洗溪捨舌析捨甚媳棲蛇息蟋羲什錫蹊昔褶奢曦淅悉熹禧犀行蜥稀希吸習徙晰畦兮鰓熙釐喜谿譆犧唏晞嘻西席奚熄襲僖檄
專	耑顓磚	撰篆囀轉傳僎賺
嗷	鼇熬鏖翱遨聱敖	凹澳懊奧媼襖拗傲
臣	沈宸忱塵晨沉辰陳諶娠	襯趁琛讖櫬稱瞋疢
鳳	俸諷奉縫	豐馮諷逢縫峯風鋒楓封蜂烽瘋
向	橡象巷像項鄉嚮相	香餉翔鄉相饗詳降廂鑲響祥瓖箱湘庠想襄享
淞	嵩鬆鬆崧忪	誦宋訟悚頌送慫聳
檻	件劍健僭見艦坎毽漸諫濺侃踐監箭間閒薦腱建鍵崁餞鑑鑒澗砍賤薦	戡箋縑刊兼姦看韉漸勘殲奸囝艱檢柬簡濺堪減筧瞰監間肩尖湔剪鹼瞼繭堅菅緘撿揀儉煎
歟	盂妤隅娛榆愚魚逾禺輿愉褕蝓竽雩渝覦腴漁臾於諛圩餘餘瑜俞予萸於虞	瘉澦域瘀宇馭獄峪昱燠雨預迂語紆與煜齬慾噢芋育俞堉鬱豫羽毓裕禦籲嫗敔喻玉欲圉譽禺禹熨嶼癒寓愈諭圄御谷鬱淤遇庾聿尉予浴
羣	裙	
濫	爛纜	蘭覽攔斕纜襤瀾欖嵐藍籣攬闌婪籃懶欄
紡	彷訪倣舫仿	放房坊防妨芳肪枋方
礎	杵褚儲楚處楮	齣絀出櫥跦觸矗廚黜除鋤歜畜雛處躇怵初芻儲
畝	牡拇姥姆母	慕穆模募墓木目沐睦苜幕暮牧
卡	咳	恰喀哈洽咖
僖	攜曦淅悉熹烯禧犀嬉膝行蜥稀希吸溪畦晰兮析熙釐棲譆谿犧蟋唏晞嘻羲西奚蹊	系汐蓆翕戲隙惜習璽徙洗細鰓係媳矽喜息潟夕繫席錫熄歙襲昔檄褶
豎	數漱墅術恕庶曙樹束倏署述戍疏	鼠黍署輸數薯贖梳菽暑舒叔淑蜀書藷殊疏塾屬橾抒蔬樞熟孰
痘	讀逗竇鬥豆脰	都陡抖鬥蚪兜枓
悚	慫聳	嵩誦鬆宋訟頌送鬆崧淞忪
亢	伉炕抗	糠慷康扛
庶	數漱墅術豎恕曙樹倏束署述戍疏	鼠黍署輸數薯贖梳菽暑舒叔淑蜀書藷殊疏塾屬橾抒蔬樞熟孰
賅	垓該	蓋改丐溉鈣概
翔	庠降詳祥	橡香餉鄉嚮相向象饗廂鑲響像瓖箱湘巷想項襄享
郃	蓋咯盍荷鎘蛤貉禾曷盒閡隔褐閣膈閤葛嗑合河翮和格紇闔骼核劾革何鬲涸	嚇哥和歌訶各喝戈疙暍荷個赫箇鉻擱割胳郝鶴賀葛呵鴿
侯	篌猴喉	逅吼厚候後堠鱟
逅	厚後堠鱟候後	篌吼猴侯喉
花	譁嘩華	樺話華猾滑畫劃化嘩豁譁
羚	齡蛉菱櫺玲翎聆昤鴒泠苓凌陵綾鈴靈零伶	領拎令另嶺
綻	棧站湛暫佔蘸顫戰	斬嶄沾瞻展盞輾霑佔詹譫氈
措	厝錯撮銼挫	搓蹉磋撮嵯
驗	釅雁宴研艷硯嚥厭咽贗沿彥諺堰焰燄燕唁淹豔饜晏	言兗演研殷鹽菸奄顏咽巖厭閻簷沿眼湮煙偃魘郾延儼筵燕焉嫣嚴炎醃淹衍妍鼴掩癌胭
覽	纜欖攬懶	蘭攔爛斕纜襤瀾嵐藍籣濫闌婪籃欄
諷	豐俸縫峯風鋒楓封蜂烽瘋鳳奉	豐馮俸逢縫峯風鋒楓封蜂烽瘋鳳奉
雙	孀霜	塽爽
蠟	剌落臘辣	啦拉喇邋剌
今	津金觔巾禁斤襟筋矜浸	晉饉噤燼覲進儘僅禁瑾近勁謹盡緊縉錦浸
飢	唧跡屐居績犄饑譏羈激機乩積奇稽箕嘰躋蹟畸嵇其癘肌幾期雞璣基磯畿姬勣	急唧霽髻疾脊寄際繼寂即繫楫伋稷擠吉薺技記擊忌騎及悸嫉汲覬己亟藉劑岌紀吃季瘠給借棘計級祭圾戟麂妓驥籍濟鯽輯幾芰戢集暨洎極薊系冀躋既
漕	嘈槽曹	草糙操
玳	迨大貸黛怠逮岱待帶殆代戴袋	逮待歹呆
窺	虧盔	餽愧簣揆潰奎魁葵夔逵匱喟睽傀
櫚	閭驢	鋁綠律呂縷褸膂氯旅婁侶濾屢慮履率
絹	倦卷狷圈雋眷	娟捲身捐圈鐫鵑涓
羹	耕庚更粳賡	亙埂哽更耿梗
厭	釅雁宴研艷殷硯嚥菸奄咽贗沿湮彥諺煙驗堰焰燄燕焉嫣唁醃淹豔饜胭晏	言釅雁宴兗演研艷殷硯嚥鹽菸奄顏巖咽簷閻贗沿眼湮彥諺煙偃魘驗堰郾焰延筵儼燄燕焉嫣嚴炎唁醃淹衍豔妍鼴饜掩癌胭晏
莫	膜末貊磨陌默墨驀沫秣脈茉寞漠沒歿	膜抹蘑摩摸磨模糢謨魔摹麼
孃	娘	釀
可	緙坷喀恪剋嗑溘課克渴客刻髁	科顆軻坷喀剋克殼苛恪嗑蝌磕緙柯稞蚵棵課渴窠咳瞌溘客刻髁
全	荃蜷銓卷權詮犬泉痊佺拳踡	券畎圈甽犬勸
湃	派	排俳牌徘拍啪
僩	現霰峴腺餡羨憲獻限蜆莧陷縣線	纖涎顯嫌銑舷銜暹啣鹹秈癬嫻險祆姍閒閑絃鮮鹹仙弦蜆掀先賢蘚
冶	也野	椰葉耶噎業曄射頁謁鄴靨夜咽爺拽琊
料	了燎瞭廖	聊嘹潦寥撩暸寮了繚遼燎僚療瞭
蹶	鴃掘鱖抉獗決譎劂腳倔玨角攫爵孓崛觼覺蕨訣厥絕嚼噱	獗劂角孓訣掘鴃抉鱖決譎嗟腳倔玨崛爵攫觼覺蕨絕厥噱嚼
歧	旗祈琦琪麒耆錡臍齊祁騎枝祇棋畦奇只崎淇其祺期圻衹岐鰭	器憩啟淒谿豈悽企汽漆杞起慼磧泣溪亟砌欺契稽訖戚啓迄柒緝七綺棄乞棲氣愒萋妻
噪	竈造皁譟躁燥	蚤糟鑿澡遭藻棗早
芒	氓忙茫盲杗	蟒莽
獻	莧陷霰憲腺限羨現線峴蜆餡僩縣	賢蘚閒祆秈暹涎鮮纖先嫻銑險仙蜆顯癬嫌弦啣閑絃掀銜鹹舷姍
蠶	慚殘	慘孱璨參餐燦
第	棣締帝娣蒂的地弟遞諦	氐笛嘀犒敵邸柢砥翟迪狄嫡的牴低抵滌芽荻詆鏑滴底
斷	鍛段緞	端耑短
佗	馱跎陀沱鴕駝	唾脫橢拖柝妥託拓託
費	吠芾屝怫痱廢沸肺	菲啡肥誹霏斐妃腓扉匪翡非飛
扛	缸鋼岡綱崗槓剛釭肛	慷糠港崗槓亢抗伉炕康
甸	靛鈿澱墊店奠電惦玷佃殿	點典滇碘癲顛巔
煥	幻宦喚患奐梡渙豢瘓換	皖環澴洹鍰桓緩梡寰歡還
慇	湮陰姻因茵氤音殷	夤癮聽胤銀印鄞飲齦尹淫簷寅垠吟縯蔭隱霪引蚓
快	筷塊劊會膾檜儈	
他	牠她它塌	遝塔漯榻蹋踏獺遢塌躂撻
便	辯遍變汴卞弁釆胼辨辮駢	扁編遍蝙匾鞭邊褊偏片貶砭篇翩騙
竇	豆讀鬥痘脰逗	陡枓鬥蚪都抖兜
筒	桶統	童桐瞳慟同通僮恫彤銅潼痛峒
璦	曖噯隘艾礙愛	哀藹埃捱唉靄矮皚挨哎
帶	待迨代大貸黛逮殆戴玳袋岱怠	呆待逮歹
取	齲娶曲	趨渠驅娶砠趣劬漆曲衢去蛐區麴屈圈軀璩蛆嶇瞿
縮	訴粟梭唆簑簌速夙肅嗉莎塑娑蓿素溯嗦宿蓑	索囌酥所鎖蘇瑣俗甦穌
茴	蛔迴回	賄會彙蟲彗潰詼燴蕙繪穢輝匯揮卉虺燬麾徽灰毀諱惠墮恢暉慧悔晦誨喙
肇	召棹趙照兆罩炤櫂詔晁	釗召著朝昭招嘲沼找爪晁
碗	皖娩婉蜿宛挽莞晚輓綰	汍剜玩彎惋萬蜿豌灣莞頑腕丸完
暍	嚇郝和喝鶴賀荷赫	蓋訶盍荷貉禾曷盒閡褐閤呵嗑合郃河和翮紇喝闔核劾何涸
權	荃蜷銓卷全詮犬泉痊佺拳踡	券畎圈甽犬勸
暨	洎寄忌祭薊騎芰際劑繼薺記季稷髻霽技紀覬既悸計躋繫濟妓鯽驥冀	棘璣羈疾肌集脊己藉雞磯乩積幾績期屐機楫瘠嵇跡蹟基級極居戢畸姬畿其擊輯寂給犄飢及嫉癘幾唧箕麂擠急伋奇吉譏激圾即汲勣稽吃亟躋籍岌嘰濟戟饑
幸	性倖杏興悻辛姓	醒腥興行省硎刑型猩馨陘惺星形邢
匝	紮	雜咱偺砸
嫦	嚐場常長裳腸萇償嘗徜	場暢倀昌倡猖敞鯧唱娼廠悵氅
卹	敘恤畜洫絮酗婿蓄頊緒勗續旭序	墟胥籲戌許須徐訏鬚煦需虛咻栩噓
擭	禍貨獲豁或壑霍惑穫濩	夥夥活豁和火
哺	卜捕補埔	埠佈鈽布不怖部步簿
爾	邇耳餌洱	兒貳而二
鎂	每美	楣媚沒莓瑁枚媒魅黴昧眉玫袂妹煤沬湄梅黴寐
肱	共攻工宮紅蚣恭躬功弓供釭龔公	礦鞏共汞貢供廾拱
倥	孔恐崆空硿	孔恐崆控空硿
蜀	數薯鼠屬暑黍署藷	漱庶束署戍曙輸數術贖梳菽述舒叔淑恕書殊疏塾橾墅抒豎樹蔬倏樞熟孰
屬	數拄鼠薯暑黍煮蜀矚主貯囑署藷渚	諸漱逐軸朱蛀躅庶茱束鑄署硃戍曙助蛛輸數孰箸誅術贖注梳珠菽豬述舒薴祝叔築恕朮淑書柱竺杼侏藷殊疏塾燭橾墅駐註豎抒樹佇蔬倏株銖竹樞熟住
蟯	嬈饒橈	繞擾
峽	霞呷黠挾轄遐匣洽狎柙斜瑕狹暇俠	夏廈下嚇暇蝦瞎
折	蜇哲轍褶摘摺謫輒懾	浙赭者宅鷓蔗遮這螫著
洪	訌紅弘黌閎虹泓鴻宏	鬨烘哄薨汞轟
咀	莒舉沮齟矩	炬苣颶具桔巨疽鉅劇倨遽屨距俱狙侷掬聚據懼踞瞿橘蛆跼車駒拘局句菊鋸沮足鞠拒居
脅	諧挾頡擷偕斜邪攜勰協鞋	卸洩歇榭蠍寫屑血楔蟹邂契褻懈謝駭械燮解些瀉紲屜
約	曰	曜越粵刖悅玥藥說耀月躍軏樂鑰籥嶽閱
隹	追椎錐	墜綴贅惴
藥	越玥月軏嶽閱要悅樂鷂粵耀拗曜刖說躍鑰籥	約吆餚洮淆腰麼瑤崤要妖搖窈爻舀姚榣杳僥遙謠邀堯窯夭咬喲曰
撈		癆佬酪絡牢烙嘮姥老勞
雩	盂妤隅娛榆愚魚逾禺輿愉褕竽蝓渝覦腴漁臾於諛圩餘餘瑜俞予歟萸於虞	瘉澦域瘀宇馭獄峪昱燠雨預迂語紆與煜齬慾噢芋育俞堉鬱豫羽毓裕禦籲嫗敔喻玉欲圉譽禺禹熨嶼癒寓愈諭圄御谷鬱淤遇庾聿尉予浴
骰		殺篩曬曬
穢	匯繪賄慧卉諱會彙晦誨喙彗惠潰燴蕙	蛔賄會蟲詼輝茴揮虺回麾燬徽灰毀迴墮恢暉悔誨
檸	獰嚀寧擰凝	佞濘擰
普	溥圃譜浦誧埔	撲菩蒲脯濮璞曝噗莆瀑樸匍鋪釙暴葡蹼僕
硯	釅雁宴研艷嚥厭咽贗沿彥諺驗堰焰燄燕唁淹豔饜晏	言兗演研殷鹽菸奄顏咽巖厭閻簷沿眼湮煙偃魘郾延儼筵燕焉嫣嚴炎醃淹衍妍鼴掩癌胭
叼	鯛凋彫雕碉貂刁	釣調掉弔吊
蝓	盂妤隅娛榆愚魚逾禺輿愉褕竽雩渝覦腴漁臾於諛圩餘餘瑜俞予歟萸於虞	瘉澦域瘀宇馭獄峪昱燠雨預迂語紆與煜齬慾噢芋育俞堉鬱豫羽毓裕禦籲嫗敔喻玉欲圉譽禺禹熨嶼癒寓愈諭圄御谷鬱淤遇庾聿尉予浴
齊	齋旗祈琦琪麒耆錡臍祁騎枝祇棋畦奇摘只崎淇其祺期圻衹歧岐鰭	器憩啟淒窄谿豈悽寨汽企債漆杞起慼磧泣溪亟砌欺翟契宅責稽訖戚啓迄柒祭緝七綺棄乞棲氣愒萋妻
圯	咦姨飴疑怡貽誼訑迤蛇栘移彝夷遺沂胰儀宜一痍頤	漪蟻藝屹肄軼刈誼囈迤縊以逸佾已溢劓醫疫噫乙懿鎰毅揖義迆邑億液役佚易羿倚尾弋裔蜴椅壹驛弈旖譯帟翌異益偯臆亦艾腋曳咿議詣意伊繹憶掖浥翳矣奕一翼抑衣依
嶔	侵親欽	擒禽噙沁撳琴勤秦寢芹
係	翕潟戲夕隙繫矽系汐歙細	攜烯嬉蓆膝惜璽洗溪析媳棲息蟋羲錫蹊昔褶曦淅悉熹禧犀行蜥稀希吸習徙晰畦兮鰓熙釐喜谿譆犧唏晞嘻西席奚熄襲僖檄
操	糙	嘈漕曹草槽糙
臨	鄰林淋遴痳燐轔琳磷鱗霖麟璘	吝凜藺賃躪懍
餮	帖	貼鐵帖
嗾	叟卒藪擻足族	詛搜租祖餿蒐俎嗽組阻颼
悴	淬粹萃瘁橇翠脆	衰摧催璀崔
僅	晉饉噤燼覲進儘禁瑾近勁謹盡緊縉錦浸	金噤謹錦浸晉饉覲瑾勁縉矜津燼禁斤襟緊今觔巾盡儘近筋進
鵬	蓬膨彭朋澎棚篷硼	捧澎抨碰烹砰
臥	齷斡渥握沃	窩我倭萵渦
攪	矯餃稿狡剿較鉸勦腳僥搞縞絞繳槁姣杲皎角	礁醮澆嚼焦告跤蕉嬌教皋誥交椒叫覺轎郊較窖膠羔膏篙蛟鮫睪驕校高姣糕詨
趨	卒槭驅砠蹴趣曲簇蛐區鏃促錯屈圈軀蛆蹙醋嶇瞿	趣劬取漆曲麴齲瞿粗渠娶衢璩去
羊	楊鍚徉颺揚瘍暘陽洋烊煬昜佯	怏漾煬殃泱養癢氧鞅仰央秧樣鴦恙
育	芋與馭御喻瘉寓禺鬱尉癒諭玉澦語煜欲谷裕昱愈聿峪嫗籲預豫浴域獄毓遇堉慾譽禦熨俞燠	與魚諛宇雨雩竽禹予愚禺虞迂齬蝓噢盂圉逾褕圩瘀榆渝語萸漁瑜庾輿嶼歟於腴紆妤隅圄愉羽臾餘淤覦敔俞娛
褂	掛卦	瓜蝸括刮寡聒呱颳
獐	漳蟑樟彰章璋張	脹丈障賬長仗掌幛漲帳杖瘴
甘	柑乾幹尷坩疳肝竿杆桿	敢淦幹橄榦桿感稈趕贛
裙	羣	
榷	闋鵲殼確雀闕恪怯卻	瘸缺闕
鴃	掘鱖抉獗決譎蹶劂腳倔玨角攫爵孓崛觼覺蕨訣厥絕嚼噱	倔蹶嗟
企	器憩妻緝棄訖磧迄泣氣愒砌亟汽契	旗啟淒祈谿豈悽琦琪麒耆漆杞起錡臍慼齊祁騎溪欺枝祇棋畦奇稽戚啓柒崎淇七隻綺其祺期圻乞棲衹歧岐萋鰭妻
簌	蓿塑肅宿縮速粟嗉訴溯素夙	俗蘇囌酥甦穌
潔	睫傑節櫛竭捷頡擷結桔孑羯桀劫拮碣訐詰截	芥姐揭姊疥階戒結藉接皆借偕界嗟解介街屆誡
蛭	雉秩幟稚窒志痣智緻滯致置痔至摯峙製輊躓治知識制質炙誌	姪止植織梔咫泜氏芷脂胝值汁址吱肢執摭祇祉躑枝蜘直支擲知徵隻質紙趾只之指祗職芝旨卮殖
認	刃任軔賃飪韌紉仞妊衽	壬忍荏稔人任兒仁
砝	乏法筏伐閥罰	發琺法伐髮
峙	雉秩幟蛭稚窒志痣智緻滯致置痔至摯製輊躓治知識制質炙誌	姪止植織梔咫泜氏芷脂胝值汁址吱肢執摭祇祉躑枝蜘直支擲知徵隻質紙趾只之指祗職芝旨卮殖
鋼	缸岡綱崗槓剛扛釭肛	崗槓港
窿	聾隆籠龍矓瓏朧嚨	隴攏壟
禁	金噤浸晉覲勁縉矜津燼斤襟今觔巾僅盡儘近筋進	金噤謹錦浸晉饉覲瑾勁縉矜津燼斤襟緊今觔巾僅盡儘近筋進
賦	富父復覆阜駙複傅咐訃腹附賻副婦付負馥赴	孚拂斧夫芙敷莆父袱腐蝠菔氟腑撫符幅輔服鈇俯釜扶甫膚芾輻伏俘匐彿頫伕紼脯縛府浮涪趺福弗怫孵麩紱
瘸		闋雀缺恪鵲闕榷卻怯確殼
鑷	鎳聶臬蘗涅躡囁齧孽	捏
冊	側廁測策惻	
勉	沔靦冕偭湎娩緬免	眠綿麵棉面
兼	縑肩間韉濺奸尖煎姦漸湔堅緘艱菅監殲箋	餞澗鑒劍儉閒毽減諫箭僭踐柬艦件健建撿簡瞼揀筧間檻繭見剪鹼檢監賤濺薦腱囝漸鑑鍵
匠	絳彊將強醬降	獎僵江薑槳疆蔣講姜將繮漿韁
槽	嘈漕曹	草操糙
孕	醞韻慍暈蘊運員熨	勻允耘氳隕筠昀紜暈芸雲
泠	齡蛉菱櫺玲翎聆昤鴒苓凌陵綾鈴靈羚零伶	領拎令另嶺
疾	急唧脊即寂楫伋吉擊及嫉汲亟岌藉吃瘠借棘圾級籍輯戢集極	唧霽髻寄脊跡際繼冀繫屐居績稷擠犄薺饑譏技記忌羈騎機乩激積覬己悸劑紀季奇給稽既箕計嘰祭戟麂妓蹟躋驥濟鯽畸嵇幾其肌芰期飢癘雞暨洎璣基薊系磯畿姬勣
復	富父覆阜駙複傅咐訃腹附賦賻副婦付負馥赴	孚拂斧夫芙敷莆父袱腐蝠菔氟腑撫符幅輔服鈇俯釜扶甫膚芾輻伏俘匐彿頫伕紼脯縛府浮涪趺福弗怫孵麩紱
填	闐田恬畋甜	腆忝添靦天舔
禺	瘉澦妤域娛馭獄逾昱峪燠褕蝓竽雩渝覦預漁語於與煜慾芋育餘餘俞歟堉鬱豫毓虞裕盂禦隅籲嫗榆喻愚魚玉欲譽熨輿癒寓愈愉諭御谷鬱腴遇臾諛圩聿尉瑜予萸於浴	瘉澦妤域娛瘀宇馭獄逾峪昱燠褕蝓竽雨雩渝覦預漁迂於語紆與煜齬慾噢芋育餘餘俞歟堉鬱豫羽虞毓裕盂禦隅籲嫗榆敔喻愚魚玉欲圉譽禹熨嶼輿癒寓愈愉諭圄御谷鬱淤腴臾遇諛庾圩聿尉瑜予萸於浴
罟	轂凸股谷鵠滑蠱牯瞽賈鼓穀古詁鈷骨	菰孤鴣告沽蛄僱咕辜錮顧鈷估僱姑呱固故骨家
網	罔往魍枉惘輞	旺尢妄忘王汪亡望
過		幗鍋蟈郭裹摑堝果國猓槨
巍	薇圍唯違濰桅惟幃維帷闈危爲韋微為	葦魏畏褽偽崴慰緯尉猥諉煨謂逶鮪僞遺渭威偎萎喂尾餵痿未位委胃洧穌蔚衛味娓偉為
汲	棘戢疾擊輯寂集脊及嫉藉唧急伋吉圾即楫瘠吃亟級極籍岌	洎璣羈暨忌肌祭脊己騎芰雞磯乩劑積幾記績期屐機嵇跡覬紀蹟基計妓居冀畸姬畿其寄給犄薊飢癘際幾唧箕麂繼擠薺奇譏激季稷髻霽技勣稽既悸躋繫嘰濟鯽戟驥饑
狗	苟枸	鉤遘夠雊媾句詬搆構購勾枸溝垢
繳	攪狡鉸腳僥絞剿姣餃矯較勦皎角	礁醮澆嚼焦跤蕉嬌教交叫椒覺轎郊較窖膠蛟鮫驕校姣詨
淵	鴛鳶冤宛	院願遠湲員猿袁援原媛沅轅垣爰元騵圓怨緣苑園源
嗯	恩	
蝗	凰隍遑皇徨簧惶璜黃湟篁韹煌磺	幌恍慌荒謊肓洸晃
蚓	隱引尹癮縯聽飲	淫蔭霪殷印胤吟因鄞簷飲湮隱垠夤銀陰慇氤姻齦音茵寅
檢	瞼揀筧柬繭儉囝剪減撿鹼簡	餞澗尖劍鑒閒堅毽艱菅諫箭緘僭踐韉艦件健湔建殲肩間檻見煎姦監賤縑濺薦腱奸兼漸鑑鍵箋
領	嶺	令零菱泠靈另鴒齡聆綾拎蛉櫺羚玲鈴苓陵昤伶凌翎
帳	瘴脹丈賬障仗長杖漲幛	璋蟑樟獐掌彰章張長漲漳
踊	泳蛹擁詠勇永	庸用傭
足	卒拒懼鋸巨颶遽倨劇苣屨句具鉅聚踞據嗾瞿族距炬俱	組俎橘拘菊鋸居鞠莒跼疽齟桔局駒詛狙蛆舉車祖沮租掬阻侷俱咀矩
授	獸瘦狩壽售受綬	守收手首熟
緻	雉秩幟蛭稚窒志痣智滯致置痔至摯峙製輊躓治知識制質炙誌	姪止植織梔咫泜氏芷脂胝值汁址吱肢執摭祇祉躑枝蜘直支擲知徵隻質紙趾只之指祗職芝旨卮殖
妞		鈕拗扭紐忸牛
歷	荔琍儷痢例利厲欐莉曆礫勵瀝慄隸蒞釙蠣靂立礪壢粒唳力戾俐吏麗癘鬲溧笠酈	裏貍醴李離鯉釐黎罹禮漓理浬梨驪狸蜊俚娌邐澧麗蠡犁璃鋰喱籬犛裡哩
禳	瓤攘	嚷讓攘壤
劓	屹藝肄軼刈誼囈縊逸佾溢疫懿鎰毅義邑億液佚役易羿弋裔蜴驛弈帟譯翌異益臆亦艾腋曳詣議意繹憶掖浥翳奕一抑翼衣	漪尾咦姨椅壹蟻飴旖誼偯迤栘移以彝夷已遺沂宜咿醫頤伊噫疑乙怡貽揖訑迆蛇矣圯胰儀一衣痍倚依
植	執職質姪值直躑擲殖摭	智徵制脂痔梔致之製蛭址躓質窒雉芝泜胝枝吱峙祉幟肢支祇稚趾祗炙痣識汁咫置輊只至織卮滯紙隻芷止蜘秩摯知指氏緻治志旨誌
卅	薩颯	灑撒
雌	疵祠詞瓷茨辭慈差磁	疵祠詞瓷伺次刺茨廁辭賜慈此差磁
羲	攜曦淅悉熹烯禧犀嬉膝行蜥稀希吸溪畦晰兮析熙釐棲譆谿犧蟋唏晞嘻西奚蹊僖	系汐蓆翕戲隙惜習璽徙洗細鰓係媳矽喜息潟夕繫席錫熄歙襲昔檄褶
舫	訪倣仿彷紡	放防妨芳坊肪枋房方
搾	乍柵炸搾詐砟吒蚱咋乍搾柵炸詐砟吒蚱咋	紮查閘眨炸喳札扎渣紮查閘眨炸喳札扎渣
濱	檳豳瀕繽賓儐彬	儐鬢臏殯
逶	威崴煨萎偎委	尾娓魏衛胃蔚維痿緯萎未韋唯遺惟渭濰圍桅為味穌薇餵幃偽葦慰位危偉洧謂帷鮪微巍褽尉喂闈畏猥諉違委
漓	罹麗蠡犁璃貍蜊喱狸梨籬犛驪離釐黎	裏荔琍儷利厲痢例欐莉曆醴礫李勵鯉瀝慄禮隸理浬蒞釙蠣靂俚立粒礪壢唳力邐娌俐戾澧吏麗蠡鬲溧癘鋰笠裡哩歷酈
鄴	拽曄頁靨射咽夜葉謁業	也噎琊椰野爺冶耶
悍	瀚旱憾銲撼焊捍頷翰漢汗頜	韓鼾寒罕函含蚶榦酣涵和喊汗
句	拒懼鋸巨颶遽倨劇枸苣屨具鉅聚踞勾鉤據瞿距足炬俱溝	苟橘拘夠菊鋸構購居鞠垢莒遘跼疽齟枸桔局狗媾駒搆狙蛆舉車沮雊掬詬侷俱咀矩
蚱	乍搾柵炸搾詐砟吒咋	紮查閘眨炸喳札扎渣
倒	蹈盜悼導道到稻島搗禱	蹈盜悼導道到稻島搗禱叨刀
癬	鮮銑險蘚蜆顯	莧陷限賢獻閒祆秈暹涎鮮纖霰先嫻線仙蜆嫌弦啣閑腺羨絃餡僩掀銜鹹舷憲現峴姍縣
揀	瞼筧柬簡繭儉囝剪減撿鹼檢	餞澗尖劍鑒閒堅毽艱菅諫箭緘僭踐韉艦件健湔建殲肩間檻見煎姦監賤縑濺薦腱奸兼漸鑑鍵箋
帝	棣締第娣蒂的地弟遞諦	氐笛嘀犒敵邸柢砥翟迪狄嫡的牴低抵滌芽荻詆鏑滴底
胯	跨	垮誇
轂	凸股谷鵠滑蠱牯瞽罟賈鼓穀古詁鈷骨	菰孤鴣告沽蛄僱咕辜錮顧鈷估僱姑呱固故骨家
嗅	袖秀溴岫繡臭宿鏽	咻脩休朽宿羞修
久	赳酒玖糾灸九韭	舊究糾救咎臼舅疚廄就揪柩鳩啾
啞	厄呃雅扼亞惡萼顎詻堊軛遏噩餓鱷愕鄂俄疋鍔	涯鵝哦亞訝牙婀押鴉呀丫阿鴨蚜蛾蚵娥峨軋煆訛壓芽額俄衙氬
宵	簫霄嘐逍硝消梟削蕭驍哮囂銷瀟	曉校嘯小傚學笑酵孝肖效篠
曜	粵越要嶽閱耀悅鷂躍樂月鑰刖軏嶽藥拗籥說玥	要淆喲夭崤咬謠杳瑤僥窈曰堯搖邀洮約吆舀榣腰餚姚麼遙餚窯妖爻
銜	嫌嫻鹹舷啣弦閑賢閒絃涎	莧陷限獻蘚祆秈暹鮮纖霰先銑險線仙蜆顯癬腺羨餡僩掀憲現峴姍縣
祺	歧淇其琪旗齊琦耆麒棋騎臍畦鰭祁崎圻奇岐衹祇期祈枝錡	愒萋淒妻欺溪豈綺磧棄杞乞汽啟柒器棲企訖谿稽漆慼亟迄悽泣起契憩戚砌七緝氣
能		濘
萇	嚐場常長裳腸嫦償嘗徜	場暢倀昌倡猖敞鯧唱娼廠悵氅
洎	暨寄忌祭薊騎芰際劑繼薺記季稷髻霽技紀覬既悸計躋繫濟妓鯽驥冀	棘璣羈疾肌集脊己藉雞磯乩積幾績期屐機楫瘠嵇跡蹟基級極居戢畸姬畿其擊輯寂給犄飢及嫉癘幾唧箕麂擠急伋奇吉譏激圾即汲勣稽吃亟躋籍岌嘰濟戟饑
慚	蠶殘	慘孱璨參餐燦
溝	勾枸句鉤	苟遘夠雊媾狗詬搆構購枸垢
螳	醣瑭糖搪堂塘膛棠唐鏜	燙湯躺趟帑倘淌儻鏜
眾	仲湩中重種	踵盅忠鍾衷塚終忪中腫鐘塚種
彗	諱惠晦喙蕙燴慧繪穢彙賄會卉匯誨潰	麾恢詼蟲茴暉毀墮灰揮燬賄虺輝悔回會徽迴蛔誨
搏	卜鈸博蔔鉑駁箔荸脖檗渤帛薄白柏膊勃泊伯舶	玻菠薄亳般薜擘蘗簸檗剝跛缽播撥
婪	斕藍闌欄襤籃攔籣瀾嵐蘭	攬欖爛懶濫覽纜
覬	洎暨寄忌祭薊騎芰際劑繼薺記季稷髻霽技紀既悸計躋繫濟妓鯽驥冀	棘璣羈疾肌集脊己藉雞磯乩積幾績期屐機楫瘠嵇跡蹟基級極居戢畸姬畿其擊輯寂給犄飢及嫉癘幾唧箕麂擠急伋奇吉譏激圾即汲勣稽吃亟躋籍岌嘰濟戟饑
倫	侖掄綸淪論崙輪	掄論
耍		刷
吃	急唧喫疾脊即寂癡楫伋吉擊及嫉汲亟岌藉魑瘠借棘圾級蚩籍輯笞戢集極嗤	霽寄褫踟叱忌騎悸己紀計栘侈啻畸洎璣恥磯飢既躋唧脊赤居績斥弛稷譏羈覬劑季稽祭敕麂蹟驥鯽尺幾齒犄姬飭際匙薺持饑馳機乩翅奇箕妓濟嵇其芰雞墀基薊系冀髻跡遲繼繫屐擠技記呎激池積給嘰戟癘肌期暨熾畿勣
管	琯館莞	盥綸關貫鸛慣倌罐灌冠莞官鰥矜觀棺
榜	膀綁	梆邦旁傍鎊磅謗棒幫蚌
販	犯汎梵泛飯範氾	藩煩反釩蕃礬返樊番繁幡翻凡繙墦帆
敕	赤熾翅斥啻飭叱	褫尺恥蚩癡呎踟侈匙癡吃栘齒弛持馳嗤池魑遲墀笞喫
賞	晌上	湯觴傷裳殤上商尚
炳	丙柄秉鉼屏稟餅	病兵併並摒並冰
皚	捱	哀噯璦藹哎愛曖艾埃隘唉靄矮挨礙
綸	棺關論觀莞淪矜倌倫輪官侖鰥崙冠掄	盥館琯論觀莞管鸛灌貫慣冠罐掄
嘻	攜曦淅悉熹烯禧犀嬉膝行蜥稀希吸溪畦晰兮析熙釐棲譆谿犧蟋唏晞羲西奚蹊僖	系汐蓆翕戲隙惜習璽徙洗細鰓係媳矽喜息潟夕繫席錫熄歙襲昔檄褶
繆	眸妙牟廟謀	緲描渺瞄杪某苗邈秒杳藐眇
村	皴	吋寸存忖
緣	沅轅垣圓爰湲袁園援元騵原源媛員猿	怨院鳶苑宛鴛願淵遠冤媛
庠	翔祥詳降	餉響湘像襄嚮鄉鑲瓖橡巷廂象享饗箱香想項向相
骸	還孩	咳亥嗨駭氦害海
猾	樺華滑劃嘩豁譁	樺話花華畫劃化嘩
裟	殺砂杉鯊莎紗煞沙	傻霎廈煞
惰	度踱舵咄跺剁墮馱	奪朵躲鐸多
幅	孚拂夫芙袱蝠菔氟符服扶芾輻伏俘匐彿紼縛浮涪福弗怫紱	富斧夫敷莆父復腐覆阜腑撫駙複輔傅鈇俯釜甫膚咐訃附腹賦賻副頫婦伕脯府付趺孵麩負馥赴
貿	冒瑁茂懋貌耄帽	茅茆卯髦泖毛貓矛錨
雉	秩幟蛭稚窒志痣智緻滯致置痔至摯峙製輊躓治知識制質炙誌	姪止植織梔咫泜氏芷脂胝值汁址吱肢執摭祇祉躑枝蜘直支擲知徵隻質紙趾只之指祗職芝旨卮殖
簫	宵霄嘐逍硝消梟削蕭驍哮囂銷瀟	曉校嘯小傚學笑酵孝肖效篠
皿	閩湣愍閔澠敏憫泯抿	民岷玟
暑	數薯鼠屬黍蜀署藷	漱庶束署戍曙輸數術贖梳菽述舒叔淑恕書殊疏塾橾墅抒豎樹蔬倏樞熟孰
賭	睹篤肚堵	讀度妒蠹督毒牘鍍嘟瀆犢渡髑都黷肚獨杜櫝
骷	窟枯哭	苦庫楛褲酷
道	蹈盜悼導到稻倒	導島搗禱叨刀倒
鈍	燉頓遁盾噸沌囤盹	敦蹲惇盹躉墩
早	蚤澡藻棗	竈造噪皁譟躁糟鑿遭燥
庖	炮咆刨袍匏	泡皰炮拋砲跑
雞	唧跡畿屐居績犄饑譏羈激機乩積奇稽箕嘰躋蹟畸嵇其癘肌幾期璣基磯飢姬勣	急唧霽髻疾脊寄際繼寂即繫楫伋稷擠吉薺技記擊忌騎及悸嫉汲覬己亟藉劑岌紀吃季瘠給借棘計級祭圾戟麂妓驥籍濟鯽輯幾芰戢集暨洎極薊系冀躋既
弒	拭恃式軾適是柿飾奭氏士使視螫市示試豉仕噬誓筮室勢侍世嗜識逝事釋舐	豕屍匙溼獅蝨使拾詩碩失十蝨噓始塒石蝕實食施時提史師濕屍矢什屎射駛
逐	燭軸術築朮躅竺竹	諸朱蛀茱鑄硃渚助拄箸誅注主囑珠豬薴祝貯柱杼侏藷屬煮駐註矚佇株銖蛛住
旨	趾紙芷徵址止咫指只祉祇	智制脂植痔梔直致摭之製蛭躓質窒雉芝泜值胝躑枝吱峙祇幟肢支擲稚執祗職炙痣識汁置輊只至殖織卮滯隻蜘秩摯知姪氏緻治志誌
侖	掄綸淪論崙倫輪	掄論
慷	糠康	糠亢抗伉炕扛康
捎	梢稍燒	少哨韶紹杓芍邵勺召
臘	剌蠟辣落	啦拉喇邋剌
夜	葉業曄射頁靨鄴咽謁拽	椰耶噎冶野也爺琊
淪	侖掄綸論崙倫輪	掄論
飄	漂	剽漂瓢驃縹票嫖瞟
港	崗	缸鋼岡綱崗槓剛扛釭肛
蹺	鍬俏峭誚翹竅鞘撬橇殼敲	憔雀譙俏鵲殼愀翹竅鞘悄瞧巧鍬僑峭喬樵誚橋撬橇敲
謗	旁傍鎊磅棒蚌	梆邦膀傍綁榜幫
性	倖興杏幸悻姓	醒腥興行省硎刑型猩馨陘惺星形邢
絃	嫌嫻舷銜閒閑啣鹹涎賢鹹弦	僩纖峴餡顯限莧銑暹秈癬現險霰腺祆姍羨鮮憲仙獻蜆陷掀縣先線蘚
輯	急唧疾脊即寂楫伋吉擊及嫉汲亟岌藉吃瘠借棘圾級籍戢集極	唧霽髻寄脊跡際繼冀繫屐居績稷擠犄薺饑譏技記忌羈騎機乩激積覬己悸劑紀季奇給稽既箕計嘰祭戟麂妓蹟躋驥濟鯽畸嵇幾其肌芰期飢癘雞暨洎璣基薊系磯畿姬勣
澧	禮醴浬理哩鯉邐李鋰裡裡蠡俚娌	儷哩歷靂力慄立溧黎琍粒璃離利厲狸俐蠣漓蠡莉鬲慄喱麗犁礫礪唳痢犛貍籬蒞癘壢戾曆吏笠釐例釙荔驪欐梨罹隸酈勵瀝蜊
餅	秉鉼丙稟屏柄炳	摒冰兵並併病
曬	殺曬	篩骰
舅	舊究救咎臼廄就柩疚	赳酒玖糾灸九韭揪久鳩啾
祟	遂碎誶歲穗隧燧邃	綏髓隨隋雖睢
鐫	圈身捐鵑涓娟	倦雋絹圈卷捲狷眷
樞	輸舒橾抒梳書蔬殊疏	鼠漱黍庶束署戍曙數薯術贖菽述暑叔淑恕蜀藷疏塾屬墅豎樹倏熟孰
筮	拭恃式軾適是柿飾奭氏士使視螫弒市示試豉仕噬誓室勢侍世嗜識逝事釋舐	豕屍匙溼獅蝨使拾詩碩失十蝨噓始塒石蝕實食施時提史師濕屍矢什屎射駛
康	慷糠	慷亢抗伉炕扛
鯛	刁凋叼彫碉貂雕	掉釣吊調弔
結	睫傑節櫛竭揭潔捷頡擷階桔孑接羯皆桀劫偕拮碣嗟訐街詰截	睫傑節櫛芥竭姐揭潔捷姊頡疥階擷戒桔孑藉接羯皆桀借劫偕拮碣界嗟解訐介街屆詰誡截
跛	簸	卜鈸博蔔鉑駁箔荸脖玻菠搏蘗檗播渤帛薄亳般白柏缽撥膊薜勃泊簸伯舶剝擘
淮	懷徊踝槐	壞
驪	喱璃釐離麗犁犛貍籬狸梨黎罹漓蠡蜊	儷澧醴哩歷靂力慄立溧娌琍粒理利厲邐俐蠣蠡俚莉鬲慄禮麗鯉礫礪唳痢蒞癘壢戾曆吏笠浬例釙荔欐李鋰裡隸酈裡勵瀝
倖	性杏興幸悻姓	邢醒興馨形行刑惺星省陘型腥猩硎
白	卜鈸博蔔鉑駁箔荸脖搏檗渤帛薄柏膊勃泊伯舶	襬拜敗佰玻菠蘗檗跛播薄亳般缽百撥擺薜簸剝擘
摘	齋蜇哲轍齊褶摺謫折輒懾	赭浙債者宅鷓蔗遮責着這窄祭螫寨著翟
毆	甌區歐嘔鷗	耦噢藕嘔偶
疚	舊究救咎臼舅廄就柩	赳酒玖糾灸九韭揪久鳩啾
叨	刀	蹈盜悼導道到稻島搗禱倒
噗	僕撲撲鋪	普埔葡鋪濮樸浦釙蹼樸誧莆暴溥譜瀑脯蒲圃菩璞曝僕匍
芽	迪蚜狄嘀笛衙荻的犒敵嫡涯牙鏑押滌翟	氐娣邸雅柢亞第訝地押砥鴉呀丫遞鴨棣締帝的牴低軋煆抵弟壓啞蒂詆疋滴底氬諦
謬		
納	鈉那訥吶捺娜	拿哪那
綁	榜膀	梆邦旁傍鎊磅謗棒幫蚌
箝	乾虔潛前鈐黔錢鉗	簽欠阡嵌仟塹縴遣歉倩愆鉛騫千謙淺遷牽搴韆籤譴
堠	厚後鱟逅候後	篌吼猴侯喉
臭	袖秀溴岫繡嗅宿鏽	惆咻裯鯈稠脩朽躊仇疇修儔籌愁休醜抽酬綢宿羞
譜	普溥圃浦誧埔	撲菩蒲脯濮璞曝噗莆瀑樸匍鋪釙暴葡蹼僕
革	格隔膈合鬲蛤閤閣咯鎘骼郃葛	個戈胳割鉻鴿箇歌疙各葛擱哥
拘	車疽沮鋸駒狙居俱蛆	橘拒菊懼鋸巨炬颶鞠莒遽跼齟倨劇苣桔屨局句具鉅聚踞舉據沮掬瞿距足侷俱咀矩
渾	混魂輥餛琿	混魂輥餛葷昏琿婚
霾	埋	邁脈麥賣買
瓤	禳攘	嚷攘讓壤
孺	燸入儒茹嚅濡蠕如褥辱	燸茹儒嚅汝濡乳如蠕褥女入辱
繞		蟯擾饒橈嬈
跑		咆砲拋庖泡刨炮袍皰匏
吟	淫齦垠夤銀鄞簷寅霪	蔭聽殷印胤尹因癮飲湮隱陰慇氤姻蚓縯引音茵
躪	吝賃藺	鄰凜林淋遴痳燐轔琳磷鱗霖懍臨麟璘
亥	氦害嗨駭	孩咳骸海嗨還
搔	繅艘騷	嫂掃
瘓	幻宦煥喚患奐梡渙豢換	皖環澴洹鍰桓緩梡寰歡還
甬	擁泳踴永湧勇蛹臃俑詠湧壅恿	擁鄘傭臃邕雍慵用庸壅傭
纂	鑽	賺鑽
那	鈉納訥吶捺娜哪	鈉納訥吶拿捺娜哪
砧	禎診貞真針楨斟臻珍偵榛甄箴	震陣娠鴆診枕縝鎮朕賑振疹
飼	泗四伺兕嗣俟巳食耜祀駟賜寺似肆姒	嘶絲思斯廝死私司鷥撕
惺	興星馨腥猩	邢醒性興幸形行刑倖杏悻姓省陘型硎
寒	韓函含榦涵汗	瀚喊罕銲悍鼾憾蚶焊漢旱撼酣頷捍和翰汗頜
域	芋與馭御喻育瘉寓禺鬱尉癒諭玉澦語煜欲谷裕昱愈聿峪嫗籲預豫浴獄毓遇堉慾譽禦熨俞燠	與魚諛宇雨雩竽禹予愚禺虞迂齬蝓噢盂圉逾褕圩瘀榆渝語萸漁瑜庾輿嶼歟於腴紆妤隅圄愉羽臾餘淤覦敔俞娛
潺	饞讒禪澶蟬孱蟾毚嬋單巉纏	懺剷摻諂攙儳鏟闡產羼
芬	棻分吩紛氛	分汾焚奮糞粉忿墳憤份
祠	疵詞瓷茨雌辭慈磁	疵刺伺次雌廁賜此差
言	沿嚴炎鹽簷妍顏筵延巖閻癌研	釅雁宴兗演研艷殷硯嚥菸奄咽厭贗沿眼湮彥諺煙偃魘驗堰郾焰儼燄燕焉嫣唁醃淹衍豔鼴饜掩胭晏
鑾	巒灤鸞	卵亂
大	待迨代貸黛逮殆戴玳袋岱帶怠	待歹靼躂逮搭打達呆韃瘩褡答怛
絨	鎔蓉榕戎榮容熔融溶茸嶸	茸冗
叟	藪擻嗾	搜餿蒐嗽颼
兄	洶兇匈胸	雄熊
梅	媒玫眉黴楣枚莓煤沒湄	妹瑁每昧魅袂鎂美媚沬寐
醫	咿揖壹一噫依衣伊漪	劓羿浥益藝軼鎰姨痍肄頤憶遺矣佚翌夷一屹栘貽溢臆囈訑疑偯議意刈以移乙蛇役圯億蟻沂繹弋迤腋毅譯儀詣怡咦縊逸抑彝懿倚液帟翼義疫飴異迆胰艾奕衣佾誼尾翳已掖易裔旖邑曳椅亦蜴驛宜弈
遝	漯榻蹋踏獺遢塌躂撻	他塔牠她它塌
壓	鴨煆押鴉呀丫	啞疋亞蚜芽衙訝涯牙軋雅押氬
籲	芋與訏馭喻御育墟瘉寓禺尉鬱需癒胥諭郁玉澦虛語煜欲谷裕昱愈聿峪嫗鬚噓預豫域須獄戌毓遇熨堉慾譽禦浴俞燠	咻與魚勗諛卹宇雨竽雩余婿禹序予愚禺虞迂許洫齬蝓噢盂圉逾褕圩瘀煦渝語萸漁徐瑜恤庾輿緒歟嶼酗於畜絮腴頊紆妤隅圄栩覦愉羽臾續餘蓄淤敘旭榆敔俞娛
濯	鐲著擢酌濁卓拙斫灼琢啄茁	棹涿捉桌
所	索瑣鎖	莎縮梭嗦娑唆簑蓑
完	汍玩丸頑	萬玩蜿宛碗灣莞輓婉晚娩腕剜綰皖彎惋挽豌
剁	墮馱咄度踱跺惰舵	鐸奪躲多朵
罔	惘往網魍枉輞	望汪亡王旺妄尢忘
釩	藩蕃樊墦凡煩礬繁帆	氾繙犯範泛梵番販反汎蕃飯翻範返幡帆
瑕	狎暇俠轄霞斜柙挾峽匣洽狹黠遐呷	下暇蝦嚇夏廈瞎
旌	莖驚涇粳睛鯨精更荊菁兢經晶京	竟頸景靖井痙競淨勁警靜鏡徑憬敬阱璟逕境
堪	戡刊勘看	砍檻崁看侃坎瞰勘
頹		蛻推退腿
希	悉禧行谿羲嬉晰釐蟋吸唏曦蹊稀淅溪畦奚犧譆熙攜烯西析兮嘻僖蜥晞棲膝犀熹	細繫席昔惜洗隙褶襲矽習鰓翕係夕蓆熄檄璽息汐系媳錫戲潟徙喜歙
眉	媒玫黴梅楣枚莓煤沒湄	妹瑁每昧魅袂鎂美媚沬寐
隸	荔琍儷痢例利厲欐莉曆礫勵瀝慄蒞釙蠣靂立礪壢粒唳力戾俐吏麗癘鬲溧笠歷酈	裏貍醴李離鯉釐黎罹禮漓理浬梨驪狸蜊俚娌邐澧麗蠡犁璃鋰喱籬犛裡哩
棚	蓬膨彭朋澎鵬篷硼	捧澎抨碰烹砰
砰	澎抨烹	蓬膨彭捧朋澎棚鵬篷碰硼
鷂	樂要鑰耀藥拗曜	要淆喲夭崤咬謠杳瑤僥窈堯搖邀洮吆舀榣腰餚姚麼遙餚窯妖爻
鑪	蘆爐盧廬臚鱸瀘顱	路滷露魯擄鹵櫓鹿麓戮僇碌氯嚕鷺陸錄穋祿虜賂
蚣	躬供宮龔釭紅公攻恭共工肱功弓	供鞏汞礦共廾拱貢
愾	咳愒慨	愷開剴楷揩凱慨豈
擅	汕善繕單扇訕膳疝禪煽贍鱔	芟閃扇陝羶衫跚縿山煽珊潸姍刪舢杉
酌	卓灼濯着啄茁濁斫拙琢擢著鐲	桌涿捉棹
它	他牠她塌	遝塔漯榻蹋踏獺遢塌躂撻
幗	國摑	鍋蟈槨過猓堝郭果裹
講	獎槳蔣	醬絳僵江薑彊疆姜將強繮漿韁匠降
動	凍胴恫洞棟	東董咚冬懂鼕
佃	靛鈿澱墊店奠電惦玷殿甸	點典滇碘癲顛巔
醒	省	行杏型姓馨形邢腥硎性倖悻惺星興幸猩陘刑
懊	拗傲澳奧	鏖凹熬鼇翱遨媼襖敖嗷聱
谷	芋鼓與馭御喻牯鵠穀滑育瘉古寓禺鬱骨尉罟股賈癒諭鈷玉澦蠱煜語欲凸裕轂詁昱愈聿峪嫗籲預豫浴域獄毓遇瞽堉慾譽禦熨俞燠	咕顧錮與鴣魚諛宇雨告竽雩家禹予僱愚禺虞迂骨估齬蝓噢盂圉逾褕蛄鈷圩瘀菰呱榆渝語故漁瑜萸姑庾輿孤嶼歟於腴紆辜妤隅固圄愉沽羽臾餘淤覦敔俞娛
帛	荸搏蔔駁伯博檗脖勃白鈸膊泊舶鉑柏渤箔薄	玻撥亳般簸薜播檗菠蘗跛缽剝擘薄
忱	沈宸塵晨沉辰陳諶臣娠	襯趁琛讖櫬稱瞋疢
變	辯遍汴卞弁釆辨辮便	扁鞭蝙編匾邊褊貶砭
羨	現僩霰峴腺餡憲獻限蜆莧陷縣線	纖涎顯嫌銑舷銜暹啣鹹秈癬嫻險祆姍閒閑絃鮮鹹仙弦蜆掀先賢蘚
披	批劈丕匹壞霹紕被鈹	啤媲埤陂脾裨匹屁琵僻枇癖疲仳紕譬陴鼙鈹闢否毗痞沘疋罷皮
嗟	階揭皆偕結街接	捷芥拮獗蹶桔劂節桀疥誡藉頡訣劫鱖櫛訐羯倔竭攫覺借蕨傑厥介屆噱截詰傑角孓孑碣姊掘鴃抉決譎解腳戒玨睫爵界崛擷觼結潔姐絕嚼
鼙	陂疲脾皮沘埤枇陴鈹罷紕琵毗啤裨	劈披譬仳匹否媲丕霹痞僻壞闢鈹癖屁被紕批闢疋
腸	嘗嫦嚐徜萇裳場長償常	暢鯧敞悵娼氅昌場猖唱倡倀廠
蟈	鍋堝郭	國槨過猓摑幗果裹
乒	娉	平馮枰憑蘋瓶萍屏評坪
喳	差渣扎叉插查	察渣眨茶查搾柵扎吒紮岔砟詐蚱搽閘炸乍差咋剎札詫
褒	胞包苞	抱葆鉋刨雹報飽薄鑤堡褓保豹爆寶鮑暴
葛	革格隔膈合鬲蛤閤閣咯鎘骼郃	革割閣咯骼各郃隔疙戈閤哥膈胳蛤箇鎘鴿個鬲鉻歌格擱
卜	渤膊荸脖博捕薄白泊勃搏補柏舶伯駁埔哺	埠佈鈽玻撥菠播般布不簸剝跛怖部步簿
軸	妯燭術築朮躅竺逐竹	諸州朱蛀粥茱籀鑄硃渚助拄帚胄箸誅洲注週囑冑珠主豬皺晝舟薴祝宙貯柱杼侏藷紂屬縐煮啁駐註咒矚肘佇株銖蛛周住
杏	性倖興幸悻姓	醒腥興行省硎刑型猩馨陘惺星形邢
謙	纖牽簽搴鉛愆千韆嵌遷籤騫縴仟阡	倩潛鈐欠黔淺箝乾幹遣前歉鉗塹譴虔縴錢
吊	掉釣調弔	叼凋鯛彫雕碉貂刁
古	罟股鼓賈凸鵠牯穀滑轂詁鈷骨瞽蠱谷	咕顧錮鴣告家僱骨估蛄鈷菰故呱姑孤辜固沽
減	瞼揀筧柬簡繭儉囝剪撿鹼檢	餞澗尖劍鑒閒堅毽艱菅諫箭緘僭踐韉艦件健湔建殲肩間檻見煎姦監賤縑濺薦腱奸兼漸鑑鍵箋
瀟	梟逍囂哮消削硝銷霄驍簫嘐蕭宵	效笑小嘯校肖傚酵孝學篠曉
勸	券	荃蜷銓卷權畎詮全犬甽圈泉佺痊拳踡
龔	共攻工宮紅蚣恭肱躬功釭弓供公	礦鞏共汞貢供廾拱
煨	威崴逶萎偎委	尾娓魏衛胃蔚維痿緯萎未韋唯遺惟渭濰圍桅為味穌薇餵幃偽葦慰位危偉洧謂帷鮪微巍褽尉喂闈畏猥諉違委
齲	娶曲取	趨嶇去娶劬趣麴瞿璩漆蛆屈圈砠曲區渠蛐軀衢驅
婚	葷昏	混渾魂輥餛琿
廠	氅敞場	嫦徜場悵償常嘗暢嚐鯧娼昌猖唱裳腸萇長倡倀
汪	尢	旺罔網往魍妄忘王亡枉惘望輞
綵	採睬彩採踩	蔡採裁纔財才猜材菜
孓	鴃掘鱖抉決獗譎蹶劂腳倔玨角攫爵崛觼覺蕨訣厥絕嚼噱	倔蹶嗟
遢	遝漯榻蹋踏獺塌躂撻	他塔牠她它塌
鳴	螟冥酩暝茗名明瞑銘	暝命
儲	杵除鋤褚芻楚廚雛櫥跦處楮躇礎	齣杵絀出櫥跦楮觸矗楚廚黜除鋤歜畜雛處躇礎怵初褚芻
寅	垠夤吟銀鄞齦淫簷霪	癮聽胤印飲因尹茵音湮姻陰縯慇氤蔭殷隱引蚓
姥	佬牡拇姆老母畝	絡慕烙撈募木墓勞牢穆目苜牧模嘮沐幕暮癆酪睦
唆	莎縮梭嗦娑簑蓑	索瑣所鎖
聳	悚慫	誦崧淞訟嵩宋頌忪鬆送
漳	獐蟑樟彰章璋張	脹丈障賬長仗掌幛漲帳杖瘴
朦	虻萌蒙檬濛甍盟矇懵	夢孟蜢錳艋猛懵
凹		拗鏖傲熬鼇澳奧媼遨敖翱襖嗷聱懊
侑	幼鼬誘宥右柚祐有莠又囿佑釉	遊幽黝猶猷遊攸油悠由牖鈾有郵友疣莠酉尤優魷憂
筆	鄙匕沘比妣彼	庇埤幣裨箄襞篦蔽鄙必弊斃比蹕逼碧詖鉍賁陛避畢壁嗶闢璧臂敝痺愎泌睥婢薜鼻閉祕弼俾
爍	數蟀率碩妁鑠勺朔帥	說
肋	垃勒樂叻	了
戒	解芥介借屆疥誡界藉	睫傑節櫛竭姐揭潔捷姊頡擷階結桔孑接羯皆桀劫偕拮碣嗟解訐街詰截
戈	鴿胳割歌疙擱哥	革格隔個膈合鬲蛤鉻骼閤箇閣咯鎘各郃葛
湮	因奄茵菸煙音胭燕醃陰姻醃厭慇氤咽淹焉殷嫣	夤豔銀堰儼雁簷硯延妍鄞眼齦彥沿燕鹽筵厭巖縯言燄演宴閻聽癌飲焰尹諺寅驗衍掩魘贗郾咽艷巖引炎晏偃研癮胤印兗嚥淫簷垠鼴顏饜吟釅嚴淹蔭隱唁霪蚓
姑	咕估鴣孤沽蛄鈷家辜菰呱	顧錮鼓牯鵠穀滑告古僱骨罟股賈估鈷故蠱谷凸轂詁固瞽
暱	泥睨膩溺匿逆	妮尼泥霓呢你擬倪怩妳旎
搞	攪槁縞杲稿	睪皋高誥羔告糕膏篙
簞	丹擔耽單	誕淡蛋石憚彈撢但啖膽啗疸氮旦擔澹
陛	弊璧必敝鉍薜嗶痺箄襞避臂斃庇畢愎俾碧賁泌鄙蹕篦蔽詖埤闢閉弼婢祕比壁睥幣裨	彼鄙筆逼匕比沘鼻妣
引	隱尹癮縯聽蚓飲	淫蔭霪殷印胤吟因鄞簷飲湮隱垠夤銀陰慇氤姻齦音茵寅
嵐	斕藍闌欄襤籃攔籣瀾蘭婪	攬欖爛懶濫覽纜
傻		莎殺廈煞沙鯊砂霎紗裟杉
倀	猖倡昌鯧娼	常場長暢裳腸倡敞萇償唱嚐廠嫦悵氅徜嘗
柞	作座鑿做祚坐	昨作左砟佐
戕	牆彊檣薔強	鎗槍嗆繈將鏘搶腔羌強
玆	淄錙緇貲諮茲姿孳孜資輜滋諮齜髭吱	仔訾字恣紫滓籽漬子孳梓自
卦	掛褂	瓜蝸括刮寡聒呱颳
遴	痳霖麟鱗林鄰燐淋磷轔臨琳璘	吝懍躪藺凜賃
搴	簽阡嵌仟縴愆鉛千騫謙牽遷韆籤	乾欠前塹縴遣黔歉倩箝虔潛淺鈐譴錢鉗
瀑	暴曝鋪	莆誧撲蒲璞普樸釙葡僕菩濮圃鋪溥噗脯匍譜浦埔蹼
碣	捷劫拮櫛桔截詰節羯訐傑竭桀睫擷孑結潔頡傑	姊階芥皆解街嗟戒揭疥界偕藉誡結姐借介接屆
蓀	飧孫	損榫筍潠
得	的德	的德
鎗	槍嗆將鏘搶腔羌	牆嗆彊戕繈檣搶薔強
訌	泓弘黌閎洪宏紅虹鴻	薨烘哄鬨汞轟
榻	遝漯蹋踏獺遢塌躂撻	他塔牠她它塌
壕	蠔蚵嗥鶴號毫貉濠豪嚎	顥鎬涸號郝浩昊蒿好耗鄗皓
霽	洎暨寄忌祭薊騎芰際劑繼薺記季稷髻技紀覬既悸計躋繫濟妓鯽驥冀	棘璣羈疾肌集脊己藉雞磯乩積幾績期屐機楫瘠嵇跡蹟基級極居戢畸姬畿其擊輯寂給犄飢及嫉癘幾唧箕麂擠急伋奇吉譏激圾即汲勣稽吃亟躋籍岌嘰濟戟饑
身	娟參信捐呻圈鐫娠涓鵑莘深申紳砷伸	慎倦沁哂絹脤甚沈滲卷蜃狷圈瀋雋捲審腎嬸眷神
輥	鯀混渾滾袞	葷餛琿混昏棍渾魂婚
遠	怨院苑願媛	院願湲員猿鳶袁援宛原媛沅轅垣爰元鴛騵淵圓怨緣苑園冤源
撐	瞠稱	呈懲誠承騁丞橙乘秤逞城成程稱盛澄
嬌	蛟礁鮫教蕉驕澆姣膠交焦椒詨郊跤	攪醮矯嚼餃狡教剿叫覺轎較鉸勦腳僥窖絞繳校姣皎角
暝	瞑名螟酩明命茗冥鳴銘	瞑名螟酩明命茗冥鳴銘
淅	攜曦悉熹烯禧犀嬉膝行蜥稀希吸溪晰畦兮析熙釐棲譆谿犧蟋唏晞嘻羲西奚蹊僖	系汐蓆翕戲隙惜習璽徙洗細鰓係媳矽喜息潟夕繫席錫熄歙襲昔檄褶
倆	魎兩	亮輛良糧粱量晾諒涼樑
縷	呂鋁褸履膂屢旅婁侶	慮閭率氯綠驢濾律櫚
燬	賄虺蟲悔會毀誨	諱詼茴晦蕙燴灰墮揮彙彗賄回迴卉誨潰麾恢惠暉喙慧繪穢輝會徽蛔匯
蹋	踏遢漯獺塌躂撻遝榻	它牠塔她塌他
訃	富腹馥覆賻附副傅復付複赴婦咐父阜賦負駙	氟縛匐膚鈇俯府腑夫腐頫蝠紼扶甫幅芾孚弗輻紱福袱浮伏符菔釜敷拂涪撫怫斧孵莆趺輔彿服父麩脯芙伕俘
鄱	婆	醱破迫粕陂叵魄樸頗剖波泊坡珀潑
琊	椰爺耶	也噎曄冶鄴葉謁業拽頁野靨射夜咽耶
頁	葉業曄射靨夜咽鄴謁拽	椰耶噎冶野也爺琊
榆	魚諛雩予竽愚禺虞蝓盂逾褕圩渝萸漁瑜輿歟於腴妤隅愉臾餘覦俞娛	芋與馭御喻育宇雨予禹瘉寓譽禺迂鬱尉齬噢癒圉諭玉澦煜語欲谷庾裕嶼昱愈紆聿峪嫗籲預豫圄域浴羽獄毓遇淤堉慾瘀敔禦熨俞燠
褐	劾曷荷禾郃和嗑河閤閡涸闔盒盍翮核合紇貉何蓋	訶賀鶴赫暍郝嚇荷和呵喝
太	泰汰態	跆颱薹苔臺擡檯胎
罈	曇覃譚潭痰談彈檀壇	毯炭袒歎碳嘆貪坍探攤灘坦癱
馱	度惰踱舵駝咄跺佗跎陀鴕剁墮沱	妥託奪柝朵躲脫鐸橢拖多唾拓
驚	晶鯨睛莖京更精荊經粳菁兢旌涇	靜競井淨警敬勁痙頸鏡阱憬璟竟景徑逕靖境
苣	炬颶懼具巨踞瞿鉅倨劇遽屨距俱聚據句鋸足拒	莒咀舉桔疽橘蛆跼車駒俱拘狙侷掬菊局鋸沮鞠居齟矩
土	吐	荼凸屠禿菟餘吐塗徒兔突途圖酴
勾	溝鉤枸句	苟遘夠雊媾狗詬搆構購枸垢
烯	攜曦淅悉熹禧犀嬉膝行蜥稀希吸溪晰畦兮析熙釐棲譆谿犧蟋唏晞嘻羲西奚蹊僖	系汐蓆翕戲隙惜習璽徙洗細鰓係媳矽喜息潟夕繫席錫熄歙襲昔檄褶
監	餞澗尖劍鑒閒堅毽艱菅諫箭緘僭踐韉艦件健湔建殲肩間檻見煎姦賤縑濺薦腱奸兼漸鑑鍵箋	餞澗鑒劍儉尖閒堅毽艱減菅諫箭緘僭踐韉柬艦件健湔建撿簡殲瞼肩筧揀間檻繭見煎姦剪鹼檢賤縑濺薦腱奸囝漸兼鑑鍵箋
鯖	青傾輕氫頃卿蜻清	傾磬慶罄檠晴請頃親擎情
愉	魚諛雩予竽愚禺虞蝓盂逾褕圩榆渝萸漁瑜輿歟於腴妤隅臾餘覦俞娛	芋與馭御喻育宇雨予禹瘉寓譽禺迂鬱尉齬噢癒圉諭玉澦煜語欲谷庾裕嶼昱愈紆聿峪嫗籲預豫圄域浴羽獄毓遇淤堉慾瘀敔禦熨俞燠
冷		愣楞蔆稜
涪	氟縛匐夫蝠紼扶芾幅孚弗輻紱袱福浮伏符菔拂怫彿服芙俘	富馥覆附膚俯鈇複府夫腑腐頫甫阜腹賻副傅復釜敷付撫斧孵赴婦莆趺輔咐父麩脯賦負駙伕訃
崙	侖論淪倫掄輪綸	論掄
恍	洸幌晃謊	凰遑湟肓黃篁晃慌簧韹煌蝗隍皇徨荒璜惶磺
曄	拽頁靨射咽夜鄴葉謁業	也噎琊椰野爺冶耶
脈	墨漠沒歿膜末貊默麥茉莫磨陌沫寞驀賣邁秣	膜抹蘑摩磨摸模糢買霾謨魔摹麼埋
駁	卜鈸博蔔鉑箔荸脖搏檗渤帛薄白柏膊勃泊伯舶	玻菠薄亳般薜擘蘗簸檗剝跛缽播撥
癡	嗤蚩魑癡笞吃喫嗤蚩癡魑笞吃喫	赤熾翅褫啻尺恥呎踟侈匙敕叱栘齒弛持馳斥池飭遲墀赤熾翅褫啻尺恥呎踟侈匙敕叱栘齒弛持馳斥池飭遲墀
怯	闋雀竊鍥妾愜恪闕鵲挈卻榷確切殼契	且伽缺闕瘸茄切
喊	罕	韓瀚含涵銲悍鼾憾函蚶焊漢寒旱榦撼酣頷捍和翰汗頜
皰	泡炮砲	炮咆拋庖刨袍匏跑
迂	瘀淤紆	與諛虞鬱尉癒逾玉語漁谷輿於愈聿妤隅羽獄堉榆譽覦熨宇雩竽愚寓蝓萸昱峪預豫域愉臾遇慾禦俞娛芋馭御喻魚育雨予禹瘉齬噢圉褕諭澦渝瑜庾裕嶼腴嫗籲餘圄敔禺盂圩煜欲歟毓浴燠
妨	房坊防肪	放坊彷訪枋倣芳舫紡仿方
逃	檮桃燾啕淘洮陶萄濤	韜絛討套饕掏濤滔
贖	叔淑菽熟塾孰	鼠漱黍庶束署戍曙輸數薯術梳述暑舒蜀恕書藷殊疏屬橾墅抒豎樹蔬倏樞
莞	館彎灣琯觀矜蜿挽宛官皖鰥綰豌剜婉冠綸棺關碗倌管輓晚娩	惋館彎灣琯丸完觀矜腕蜿挽鸛宛官皖鰥汍綰剜豌罐婉冠綸盥棺關碗倌頑管萬灌貫慣玩輓晚娩
此		疵祠詞瓷伺次茨雌廁辭賜慈刺差磁
臟	藏葬奘	贓臧髒臢
緒	序恤旭酗續卹蓄畜絮敘婿頊勗洫	鬚咻噓訏栩須戌胥墟籲煦虛需徐許
嘖	則擇澤賊責笮窄咋	仄側怎
儻	躺帑倘淌	燙瑭糖搪塘膛唐鏜螳湯醣趟堂棠
昊	皓浩鎬顥鄗好號涸耗	毫濠壕蠔嚎貉嗥蒿郝蚵豪鶴好號
烊	鍚佯揚瘍洋颺羊楊徉昜暘陽煬	泱養仰鴦怏殃央秧癢樣漾恙氧鞅煬
蚪	抖陡鬥枓	讀逗痘竇都鬥兜豆脰
淬	橇萃翠悴瘁粹脆	催璀崔摧衰
曼	鏝縵漫蔓幔慢	饅鰻屘蹣漫蠻瞞滿
銼	厝錯撮措挫	搓蹉磋撮嵯
忠	終鐘盅忪衷鍾中	湩種仲重衆腫眾中塚踵
粥	啁舟州洲週周	妯縐皺軸帚胄咒宙肘冑籀晝紂
泓	訌弘黌閎洪宏紅虹鴻	薨烘哄鬨汞轟
舂	衝沖充憧	衝寵崇蟲蟲重
覲	盡饉燼晉緊噤僅勁禁儘縉浸謹瑾進錦近	燼矜勁筋襟觔縉謹瑾進巾盡饉金晉緊津噤僅禁儘浸斤近錦今
繡	袖溴秀岫臭嗅宿鏽	咻脩休朽宿羞修
到	蹈盜悼導道稻倒	導島搗禱叨刀倒
竅	蹺俏峭誚翹鞘撬殼	樵憔喬雀巧譙蹺鍬鵲僑橋翹悄撬橇瞧敲愀
贓	臢臧髒	藏葬臟奘
壑	禍貨獲豁或霍惑擭穫濩	夥夥活豁和火
縛	孚拂夫芙袱蝠菔氟符幅服扶芾輻伏俘匐彿紼浮涪福弗怫紱	富斧夫敷莆父復腐覆阜腑撫駙複輔傅鈇俯釜甫膚咐訃附腹賦賻副頫婦伕脯府付趺孵麩負馥赴
堝	鍋蟈郭	國槨過猓摑幗果裹
蕾	壘耒漯儡磊累	擂雷淚嫘縲羸勒鐳累類
亨	哼	桁恆衡橫
俎	詛祖組阻	卒租足族嗾
憩	汽器愒企訖迄亟泣契妻砌緝磧氣棄	歧其淇旗琪齊萋琦耆麒棋淒騎妻祺欺臍溪豈綺畦鰭祁崎杞圻乞奇岐啟期柒祇衹祈棲谿稽枝漆慼悽起戚七錡
嘯	校傚笑酵孝肖效	梟銷瀟霄小削蕭哮簫曉嘐硝囂學宵逍消驍篠
劈	批披丕匹壞霹紕被鈹	啤媲埤陂脾裨匹屁琵僻枇癖疲仳紕譬陴鼙鈹闢否毗痞沘疋罷皮
尖	縑肩間韉濺奸煎兼姦漸湔堅緘艱菅監殲箋	餞澗鑒劍儉閒毽減諫箭僭踐柬艦件健建撿簡瞼揀筧間檻繭見剪鹼檢監賤濺薦腱囝漸鑑鍵
謁	葉業曄射頁靨夜咽鄴拽	椰耶噎冶野也爺琊
袱	孚拂夫芙蝠菔氟符幅服扶芾輻伏俘匐彿紼縛浮涪福弗怫紱	富斧夫敷莆父復腐覆阜腑撫駙複輔傅鈇俯釜甫膚咐訃附腹賦賻副頫婦伕脯府付趺孵麩負馥赴
霄	梟逍囂哮消削硝銷驍簫嘐蕭瀟宵	效笑小嘯校肖傚酵孝學篠曉
飧	蓀孫	損榫筍潠
殯	儐臏鬢	繽彬瀕豳儐濱檳賓
滌	迪狄嘀笛犒荻的嫡敵鏑芽翟	氐娣邸柢第地砥遞棣締帝的牴低抵弟蒂詆滴底諦
駢	胼便	遍片騙扁篇偏翩
扔		仍
既	霽髻寄際繼繫稷薺技記忌騎悸覬劑紀季計祭妓驥濟鯽芰暨洎薊系冀躋	急唧疾脊跡即寂楫屐居伋績擠吉犄饑譏擊羈機及乩嫉積激己汲藉亟岌吃瘠奇給稽借棘箕級圾嘰戟麂躋蹟籍濟輯畸嵇幾其肌期集戢飢雞極癘璣基磯畿姬勣
絡	落洛酪烙咯駱犖珞雒勞	佬騾鏍撈囉姥勞玀牢螺羅嘮蘿籮老癆裸鑼儸邏
湟	韹隍磺蝗皇徨凰篁簧黃璜煌遑惶	幌肓謊洸荒慌晃恍
狎	暇俠轄霞斜柙挾峽匣洽狹黠遐呷瑕	下暇蝦嚇夏廈瞎
家	咕加鴣茄嘉估蛄鈷菰呱葭豭傢佳姑迦袈孤痂辜沽夾	顧鼓稼鉀錮牯鵠穀滑架告甲古僱駕胛骨罟股賈估假鈷價故嫁蠱頰谷戛凸轂詁莢固夏挾夾浹瞽
署	鼠漱黍庶束戍曙數薯術述暑蜀恕藷疏屬墅豎樹倏	鼠漱黍庶束戍曙輸數薯術贖梳菽述暑舒叔淑恕蜀書藷殊疏塾屬橾墅抒豎樹蔬倏樞熟孰
臢	贓臧髒	藏臟葬奘
壙	礦況框曠眶	劻匡筐框誑狂
卓	灼濯着啄茁濁著斫拙琢擢酌鐲	桌涿捉棹
唯	薇圍違濰桅惟幃維帷闈危巍爲韋微為	葦魏畏褽偽崴慰緯尉猥諉煨謂逶鮪僞遺渭威偎萎喂尾餵痿未位委胃洧穌蔚衛味娓偉為
穋	路露鹿戮麓僇碌氯鷺陸錄祿賂	蘆滷盧魯鹵擄臚鑪櫓鱸顱爐嚕廬虜瀘
哽	耿埂梗	更粳亙羹庚耕賡
匪	斐菲誹翡	菲吠肥啡飛霏芾妃腓扉費屝怫痱廢非沸肺
移	儀怡飴咦姨痍胰頤遺蛇圯夷誼彝一沂栘迤貽訑宜疑	咿詣劓揖羿浥異益議藝軼意刈鎰依縊迆肄逸憶以噫抑乙艾佚矣奕翌衣伊佾誼億漪役蟻尾翳已懿壹一掖醫屹易裔繹旖倚液弋迤帟偯邑腋曳溢椅臆翼亦囈蜴驛毅義譯弈疫
晃	洸幌恍謊	凰恍遑湟幌肓黃篁慌簧謊韹洸煌蝗隍皇徨荒璜惶磺
呵	喝訶	褐劾曷荷禾郃何賀鶴郝嗑嚇河閤閡涸赫闔暍盒盍翮核合紇貉和蓋喝
勘	戡刊看瞰堪	戡刊砍檻崁看侃坎瞰堪
遞	棣締第帝娣蒂的地弟諦	氐笛嘀犒敵邸柢砥翟迪狄嫡的牴低抵滌芽荻詆鏑滴底
睞	癩籟賴瀨	徠來萊
函	韓寒含榦涵汗	瀚喊罕銲悍鼾憾蚶焊漢旱撼酣頷捍和翰汗頜
稽	唧啟跡豈畿屐居績犄杞起譏饑羈激機乩積奇啓箕嘰躋蹟畸綺其癘肌幾期嵇雞乞璣基磯飢姬勣	霽憩寄錡臍擊悸忌騎溪己藉祇紀瘠訖計圾籍淇祺洎躋既器唧祈脊楫稷琪麒慼齊泣覬枝劑吃季借戚祭麂驥崎鯽七隻幾集棄愒歧欺萋淒谿悽際伋企耆薺吉漆磧祁及砌亟奇棘迄妓濟其芰戢圻氣岐薊系冀鰭急旗髻疾繼繫寂即琦擠汽技記嫉汲岌契棋畦給級柒戟輯緝期暨極棲衹妻
烈	冽列裂捩劣鬣獵洌	咧
銅	童桐瞳同僮潼彤峒	統慟桶筒恫痛通
尬		價軋嘎噶
幻	宦煥喚患奐梡渙豢瘓換	皖環澴洹鍰桓緩梡寰歡還
塔		它踏牠遢漯她蹋獺塌躂撻他遝榻
棄	器憩妻緝訖汽迄泣磧氣愒砌亟企契	旗啟淒祈谿豈悽琦琪麒耆漆杞起錡臍慼齊祁騎溪欺枝祇棋畦奇稽戚啓柒崎淇七隻綺其祺期圻乞棲衹歧岐萋鰭妻
闌	斕藍欄襤籃攔籣瀾嵐蘭婪	攬欖爛懶濫覽纜
享	響餉饗想	橡香翔鄉嚮相向象詳降廂鑲祥像瓖箱湘巷庠項襄
蚤	澡藻棗早	竈造噪皁譟躁糟鑿遭燥
痳	霖麟鱗林鄰燐淋磷轔遴臨琳璘	吝懍躪藺凜賃
梟	逍囂哮消削硝銷霄驍簫嘐蕭瀟宵	效笑小嘯校肖傚酵孝學篠曉
電	靛鈿澱墊店奠惦玷佃殿甸	點典滇碘癲顛巔
鱟	厚後堠逅候後	篌吼猴侯喉
悽	七漆萋戚淒棲谿柒慼欺溪妻	器憩旗啟祈豈琦琪汽耆麒企錡起杞臍齊磧泣祁騎砌亟枝祇契棋畦奇稽訖啓迄只崎淇緝綺祺其期棄圻乞衹氣愒歧岐鰭妻
掌	漲長	瘴蟑獐彰漲漳脹賬仗幛璋樟章障杖丈帳張長
楞	愣蔆稜	愣蔆稜冷
釵	拆差	柴儕豺
頡	捷攜協拮桔斜邪截詰節挾傑桀諧鞋孑碣脅劫櫛訐羯竭睫偕擷結潔傑勰	蟹芥階皆駭街懈揭疥燮蠍楔誡藉洩紲血接姊邂榭歇屜解寫洩屑些械嗟卸瀉戒謝褻契偕界結借姐介屆
瞄	描苗	緲杪藐繆廟杳渺妙邈眇秒
躁	竈造噪皁譟燥	蚤糟鑿澡遭藻棗早
鐘	盅忠鍾中衷終忪	踵眾仲湩腫中塚重塚種
機	唧跡畿屐居績犄饑譏羈激乩積奇稽箕嘰躋蹟畸嵇其癘肌幾期雞璣基磯飢姬勣	急唧霽髻疾脊寄際繼寂即繫楫伋稷擠吉薺技記擊忌騎及悸嫉汲覬己亟藉劑岌紀吃季瘠給借棘計級祭圾戟麂妓驥籍濟鯽輯幾芰戢集暨洎極薊系冀躋既
翅	啻飭熾敕赤斥叱	喫褫遲癡弛踟匙持呎馳池魑吃栘蚩侈尺笞墀齒恥嗤
顱	鑪盧瀘鱸廬蘆爐臚	虜路僇嚕擄露錄鷺穋氯陸櫓滷賂戮麓魯鹵碌鹿祿
埋	霾	麥脈買賣邁
緙	髁嗑可課喀克刻溘恪客剋	軻坷稞棵渴磕可咳殼窠柯科刻顆苛蚵瞌蝌
羅	鑼玀騾鏍儸邏螺囉蘿籮	裸落洛酪絡烙咯駱犖囉珞雒
鹼	瞼揀筧柬簡繭儉囝剪減撿檢	餞澗尖劍鑒閒堅毽艱菅諫箭緘僭踐韉艦件健湔建殲肩間檻見煎姦監賤縑濺薦腱奸兼漸鑑鍵箋
掀	鮮纖先仙祆秈暹姍	莧陷限賢獻閒蘚涎鮮霰嫻銑險線蜆顯癬嫌弦啣閑腺羨絃餡僩銜鹹舷憲現峴縣
耒	磊累壘儡漯蕾	累鐳擂類嫘縲淚羸雷勒
胡	囫糊狐鵠鬍蝴葫壺湖弧斛瑚	戶滬虎沍扈乎瓠忽惚互琥唬戲護楛許呼
丕	劈壞披鈹被紕匹批霹	陂譬疲仳否沘僻癖琵啤闢鼙脾匹媲皮痞埤闢枇陴鈹屁紕罷毗疋裨
妾	契竊切挈愜怯鍥	伽切茄且
酒	赳玖糾灸九韭久	舊究糾救咎臼舅疚廄就揪柩鳩啾
烙	落洛酪絡咯駱犖珞雒勞	佬騾鏍撈囉姥勞玀牢螺羅嘮蘿籮老癆裸鑼儸邏
序	恤旭緒酗續卹蓄畜絮敘婿頊勗洫	鬚咻噓訏栩須戌胥墟籲煦虛需徐許
巡	徇循尋潯旬洵璿詢荀馴	迅徇潠勛汛醺燻勳巽遜訊殉薰馴蕈訓
兕	賜祀泗肆食飼巳伺嗣似耜寺駟姒俟四	撕司廝絲斯鷥私思嘶死
孳	恣淄漬錙緇貲諮茲字姿孜資輜滋諮齜玆自髭吱	訾紫籽淄漬錙梓諮茲字子姿孜資諮齜玆吱仔恣滓緇貲輜滋髭自
濰	危維帷微巍韋唯惟闈圍為桅違薇幃	尾娓魏衛胃蔚痿緯萎威未遺渭為崴味穌煨逶餵偽葦位慰偉洧謂鮪偎褽尉喂畏猥諉委
磨	墨脈魔漠沒歿膜末貊蘑默糢茉摹莫摩陌沫模寞驀謨秣	抹墨脈魔漠沒麼歿膜末貊蘑默糢茉摹莫摩摸陌沫模寞驀謨秣
臼	舊究救咎舅廄就柩疚	赳酒玖糾灸九韭揪久鳩啾
瑩	嬴盈楹熒塋瀛縈螢迎贏營蠅	穎瑛嚶瓔櫻應纓嬰映鸚鶯膺鷹罌郢英景硬影
雛	除鋤芻儲廚櫥跦躇	怵齣杵褚絀觸初出矗儲歜楚畜黜處楮礎
峭	蹺俏誚翹竅鞘撬殼	樵憔喬雀巧譙蹺鍬鵲僑橋翹悄撬橇瞧敲愀
湊	輳	操糙臭
叭	笆吧疤捌芭巴扒八	吧鈸灞琶拔霸靶壩耙把伯跋罷爸杷
緬	沔靦勉冕偭湎娩免	眠綿麵棉面
蹦	迸	甭繃崩
瀾	蘭攔斕襤嵐藍籣闌婪籃欄	覽爛纜欖攬濫懶
椅	蟻迆已以乙矣旖倚尾迤偯	劓羿浥益藝軼鎰姨痍肄頤憶遺佚翌伊夷一屹栘貽溢臆囈訑疑咿揖議意刈依噫移蛇役圯億沂繹弋迤腋毅譯儀詣怡咦縊逸抑漪彝懿壹醫液帟翼義疫飴異胰艾奕衣佾誼翳掖易裔邑曳亦蜴驛宜弈
噹	儅鐺襠當	黨擋讜當蕩盪檔
陘	邢行刑型硎形	醒性興幸馨倖惺杏星悻姓省腥猩
浴	芋與馭御喻育瘉寓禺鬱尉癒諭玉澦語煜欲谷裕昱愈聿峪嫗籲預豫域獄毓遇堉慾譽禦熨俞燠	與魚諛宇雨雩竽禹予愚禺虞迂齬蝓噢盂圉逾褕圩瘀榆渝語萸漁瑜庾輿嶼歟於腴紆妤隅圄愉羽臾餘淤覦敔俞娛
佯	烊鍚揚瘍洋颺羊楊徉昜暘陽煬	泱養仰鴦怏殃央秧癢樣漾恙氧鞅煬
矯	攪狡鉸腳僥絞剿姣餃繳較勦皎角	礁醮澆嚼焦跤蕉嬌教交叫椒覺轎郊較窖膠蛟鮫驕校姣詨
甲	夏鉀賈假胛	稼加架家茄駕嘉賈假價嫁葭頰傢豭佳戛迦袈莢痂挾夾浹
荷	褐劾曷禾郃何賀鶴郝嗑嚇河閤閡涸赫闔暍盒盍翮核合紇貉和蓋喝	褐劾訶曷禾郃何賀鶴郝嗑嚇河閤呵閡涸赫闔暍盒盍翮核合紇貉和蓋喝
尉	芋與馭魏喻為御畏育褽偽瘉慰寓禺鬱謂癒僞遺渭諭爲玉澦語煜喂欲谷餵裕未昱位愈聿胃峪嫗穌籲預豫蔚域浴衛獄味毓遇堉慾譽禦熨俞燠	葦與諛虞緯逶幃逾維語萎漁輿惟闈於妤洧隅羽淤榆覦瘀宇雩竽崴愚唯煨蝓威萸痿委紆韋愉臾俞娛魚雨予禹迂薇圍猥諉桅齬噢圉褕渝瑜庾嶼腴微餘圄敔違帷禺鮪盂巍偎圩尾濰歟危娓偉為
泰	太汰態	跆颱薹苔臺擡檯胎
列	冽裂捩劣鬣獵烈洌	咧
釦	佝叩扣寇	口
門	捫們	懣悶們燜
閩	皿湣愍閔澠敏憫泯抿	民岷玟
茗	瞑名螟酩明冥鳴銘暝	命暝
髑	瀆櫝讀犢黷牘毒獨	杜蠹堵睹篤賭度鍍嘟渡肚都督妒
朋	蓬膨彭澎棚鵬篷硼	捧澎抨碰烹砰
抖	蚪陡鬥枓	讀逗痘竇都鬥兜豆脰
蕪	無梧巫毋蜈鼯吳亡吾誣唔	巫勿騖寤軏圬屋嫵誤惡舞物汙堊烏兀誣務鎢悟塢霧五於侮捂鵡晤嗚戊午武伍污憮
鮑	鉋鑤暴爆報抱刨豹	雹葆堡包褓褒飽胞寶保苞薄
啗	誕氮蛋淡石旦擔憚彈但澹啖	簞丹擔耽撢單膽疸
堡	葆飽褓保寶	抱鉋刨雹包報胞薄鑤豹爆褒苞鮑暴
掬	跼桔侷菊局鞠橘	苣炬颶具巨疽鉅倨劇遽屨距俱狙聚據齟咀莒舉懼踞瞿蛆車駒拘句鋸沮足拒居矩
躋	洎璣羈暨忌肌祭騎芰乩磯雞劑積幾記期績機屐跡嵇覬紀蹟基計居妓冀畸姬畿其寄犄薊飢癘際幾唧箕繼薺奇激譏季稷髻霽技稽勣既悸繫嘰濟鯽驥饑	洎棘璣羈疾暨忌肌祭集脊己騎藉芰雞磯乩劑積幾記績期機屐楫瘠跡嵇覬紀蹟基計級極居妓冀畸戢姬畿其擊寄輯寂給犄薊飢及嫉癘際幾唧箕麂繼擠急伋薺奇吉譏激季圾即稷髻霽技汲稽勣吃亟既悸籍繫岌嘰濟鯽戟驥饑
案	按菴暗岸黯	鞍庵安鵪俺諳銨氨
揍	驟奏	啁陬鄒走鄹
郎	螂狼廊琅瑯榔	浪朗
瘋	豐諷峯鋒楓封蜂烽風	俸諷逢縫馮鳳奉
垢	遘夠雊媾詬搆構購	苟鉤狗溝勾枸句
漾	怏養樣煬恙	楊颺羊泱養央昜殃洋鞅鴦徉揚氧仰秧烊煬鍚瘍陽暘癢佯
觴	湯傷商殤	賞晌上裳尚
齪	啜輟綽	戳
蚌	旁傍鎊磅謗棒	梆邦膀傍綁榜幫
來	徠萊	睞瀨癩籟賴
收		獸綬守瘦狩手授壽售首受熟
藪	叟擻嗾	搜餿蒐嗽颼
委	猥諉葦萎煨逶痿鮪威娓偎崴洧尾偉緯	違葦魏畏褽帷偽慰崴緯尉薇圍唯煨猥桅謂諉逶鮪僞幃遺維渭威巍偎爲萎喂尾餵濰惟痿闈未位危韋胃洧微穌蔚衛味娓偉為
柿	室恃螫筮奭勢嗜舐豉市士事仕拭識試世釋逝是適侍示飾軾誓弒氏式噬使視	濕詩十施屎師史匙提矢射食碩拾蝕駛塒屍噓時什溼豕獅失始蝨實石使
檄	錫惜席習熄媳蓆襲褶息昔	攜烯嬉膝璽洗溪細析係棲蟋羲夕蹊歙曦淅悉熹禧犀系汐行翕蜥稀戲隙希吸徙晰畦兮鰓熙釐矽喜谿譆犧唏晞嘻西潟繫奚僖
龜	鰍秋鮭珪鞦軍丘皈閨圭瑰邱鈞歸規君傀均蚯	裘詭菌窘梂貴球濬蕈鬼軌鱖浚癸櫃毬晷竣桂囚仇酋郡俊泅雋跪駿求峻
氫	輕蜻清頃青卿鯖傾	請親擎檠頃情晴磬傾慶罄
崢	睜掙徵錚正箏癥猙爭蒸怔徵丁諍	政掙拯證証鄭正症幀整
恙	養樣漾怏煬	鍚烊養泱佯瘍仰揚鴦洋颺楊羊殃央徉秧癢昜暘鞅氧煬陽
錨	茅髦毛矛	冒茆瑁卯泖茂懋貌耄貿貓帽
喘	舛	船傳釧川穿串
蔭	胤印飲隱	夤聽銀飲尹茵寅姻湮慇殷引癮鄞因齦淫音簷垠陰吟縯氤隱蚓霪
掃	嫂	艘嫂繅騷搔
賠	裴陪培	珮轡配胚沛壞佩呸
洩	蟹邂榭屜解洩屑駭卸械瀉懈謝褻契燮楔紲蟹邂榭屜解屑駭卸械瀉懈謝褻契燮楔洩紲	攜協歇寫邪斜些挾諧蠍偕鞋擷頡血脅勰攜協歇寫邪斜些挾諧蠍偕鞋擷頡血脅勰
焦	蛟礁鮫教嬌驕蕉澆姣膠交椒詨郊跤	攪醮矯嚼餃狡教剿叫覺轎較鉸勦腳僥窖絞繳校姣皎角
深	參信身申呻莘娠紳砷伸	脤甚慎沈滲沁蜃審瀋腎哂嬸神
持	馳墀池遲栘弛踟匙	飭喫褫赤癡斥叱呎翅魑吃敕蚩侈啻尺笞熾齒恥嗤
滓	籽梓紫仔訾子	字淄恣玆子錙自輜資孳茲吱貲孜姿髭諮漬滋緇齜
剿	攪狡超鈔鉸腳僥絞矯姣餃繳抄較勦皎角	礁醮澆嚼焦吵跤蕉嬌教椒交叫覺朝轎郊較嘲潮窖膠巢晁蛟鮫驕校炒姣詨
簇	卒醋趣鏃促趨錯槭蹙蹴	粗
弔	掉釣吊調	刁凋叼彫碉鯛貂雕
丹	單擔簞耽	啗擔蛋氮啖但誕疸澹淡旦憚彈膽石撢
慵	擁鄘傭臃邕雍庸壅	擁踴泳傭永湧勇傭甬蛹臃用俑詠湧壅恿
癮	隱引尹飲聽蚓縯	淫蔭霪殷印胤吟因鄞簷飲湮隱垠夤銀陰慇氤姻齦音茵寅
觀	盥棺綸關貫鸛慣倌罐灌冠莞官鰥矜	盥綸關貫管鸛慣倌罐琯灌冠莞官鰥矜棺館
涇	莖驚粳睛鯨精更荊菁兢經晶旌京	竟頸景靖井痙競淨勁警靜鏡徑憬敬阱璟逕境
棣	娣締遞諦帝弟的地蒂第	滴低鏑荻迪底的嘀狄敵氐牴砥柢犒翟滌芽邸笛抵詆嫡
穴	削血雪學	血雪靴削噱薛學
臉		漣簾鏈鍊奩煉斂聯鰱廉蓮濂鐮殮連憐瀲楝戀練
鉤	溝勾枸句	苟遘夠雊媾狗詬搆構購枸垢
祚	作座鑿做柞坐	昨作左砟佐
袖	秀溴岫繡臭嗅宿鏽	咻脩休朽宿羞修
蛻	退睡說稅	誰推水腿頹
付	富父復覆阜駙複傅咐訃腹附賦賻副婦負馥赴	孚拂斧夫芙敷莆父袱腐蝠菔氟腑撫符幅輔服鈇俯釜扶甫膚芾輻伏俘匐彿頫伕紼脯縛府浮涪趺福弗怫孵麩紱
裡	禮澧醴浬理哩鯉邐李鋰裡蠡俚娌禮澧醴浬理哩鯉邐李鋰裡蠡俚娌	儷哩歷靂力慄立溧黎琍粒璃離利厲狸俐蠣漓蠡莉鬲慄喱麗犁礫礪唳痢犛貍籬蒞癘壢戾曆吏笠釐例釙荔驪欐梨罹隸酈勵瀝蜊儷哩歷靂力慄立溧黎琍粒璃離利厲狸俐蠣漓蠡莉鬲慄喱麗犁礫礪唳痢犛貍籬蒞癘壢戾曆吏笠釐例釙荔驪欐梨罹隸酈勵瀝蜊
境	鏡靜敬競徑淨勁痙逕竟靖	井精荊兢警旌京經粳菁驚頸涇晶鯨睛莖阱憬璟景更
媲	僻闢譬癖屁闢	劈披陂仳疲否沘壞琵批啤鼙脾匹丕霹皮痞埤枇陴鈹被罷紕毗疋裨
嗽		餿嗾搜藪蒐颼叟擻
患	幻宦煥喚奐梡渙豢瘓換	皖環澴洹鍰桓緩梡寰歡還
瓚	鏨贊暫讚	咱簪偺
楚	杵褚儲處楮礎	齣絀出櫥跦觸矗廚黜除鋤歜畜雛處躇怵初芻儲
年	黏	撚輦廿攆涊念輾捻碾拈唸
哈	喀咖	蛤喀卡咳
開	揩	凱咳愷慨愾豈愒剴楷
奠	靛鈿澱墊店電惦玷佃殿甸	點典滇碘癲顛巔
設	社攝捨涉葉舍拾射歙麝赦	捨甚什賒蛇舌奢
陵	綾零蛉櫺昤菱鴒泠靈羚玲鈴苓伶齡聆凌翎	拎令另嶺領
屍	濕屍噓詩失獅溼施師蝨	室十恃螫屎筮史提匙奭實勢嗜舐豉矢射市食士事仕拭碩拾識蝕試世釋柿逝是駛適塒侍示時什飾豕軾誓弒始氏式噬石使視
煩	藩釩蕃礬樊繁凡帆墦	犯反返蕃梵泛番汎幡販翻飯繙範氾帆
愁	籌惆躊裯仇疇稠鯈酬綢儔	醜抽溴臭
泊	卜鈸迫博破蔔鉑駁箔荸脖樸搏檗渤帛薄白柏魄粕醱膊勃伯舶珀	叵陂玻菠剖蘗檗跛播鄱亳薄潑般擘缽波薜婆坡簸剝頗撥
萃	橇翠悴瘁粹脆淬	催璀崔摧衰
娓	葦尾猥諉偉洧痿緯鮪萎委	魏衛胃蔚維萎威未韋唯遺惟渭濰圍桅為崴味穌煨薇逶餵幃偽慰位危謂帷微巍偎褽尉喂闈畏違委
稟	餅秉鉼丙屏柄炳	摒冰兵並併病
朔	數碩勺鑠蟀爍帥率妁	說
