冽	例側琍準凍咧荊紜洌列硎涮芸裂雲測凝倒惻次耘捌蜊前烈俐冶冷喇冰
菊	鞠麴芯掬荀苟芍米苞葉燕憐葡蔔屎蔚蕊迷咪萊粱茱苯茉苗芣昔薦芋釆
猙	箏淨掙崢錚睜靜猾諍狙爭猜狷狽狩猛猖猥獰猓狄犯
檣	穡牆薔嗇桔檯櫝梅迴杜茴橈檮蛔桂徊稟檜橾檢榕槍佃樹梱回
坦	場怛查銲塌袒湯悍晝旺垣垠書昊焊桿塒擔旱暘靼但壇旦捍堤膽疸
誤	詣詔詩請詭謀詼諂談諉諍誥認譟詻語誼設諱吳詮試諄蜈詰誡詆詫諒誌娛
塌	櫂瀚羿煽擢褶翁翌翠翟習蹋蓊嗡遢曜濯翼摺翰榻
搖	探罈陶瑤揮缺掙援淘萄缸榣遙缶謠缽掏罌採啕授
奎	娃哇掛佳桂畦閨堯卦掛褂圭痣蛙鞋鮭崖封捱涯
癲	巔顛瞋蘋籲闐貳鎮滇慎填嶺瀕擷縝噸傾鬚贛澦
櫓	嚕漁魯魚鯧鯊鱉鱟鰻鯽鰓欄鰭鯉鮪鮭鯨鯖鯛桅栘鮫橡鮑魷楝鱷鰍薊李
務	矜矛霧茅橘譎騖湧飭孜脅矣勝踴敝救教啟敏敕敖赦敉敦敢散敞敬故畋
寢	寐寤莊蔣浸侵鏘戕狀妝壯夜候葭霞蝦將沒疫芟又暇殿煆瑕遐殼豭假殺
燜	爛悶澗憫嫻僩捫們門潤櫚瀾攔欄簡擱熄斕藺閑間閒蘭問閃籣閂
鑤	曝爆瀑暴鏝鍚錫銲鎰錕錯鉛銀共錨鍍賜烘洪拱哄供普異基恭
粕	柏棉米迫鉑泊拍怕伯粒粗料敉籽珀帕穆白舶粳糖糠粉腺煌線糢糟糝糧
興	筒銅胴桐洞恫峒同脰臼石只且磊膈答幅壹租砠狙
婷	停孃亭搞槁壕嚎濠鎬娟犒稿縞嵩蒿豪高篙惇淳哼蠔亳膏
轡	絹緝縲輯絲累庫繽繩縯縮禪縝輜綻綰綜緒嫘嗦結喲細紹絃
天	闋夫暖篌湲睽侯助大癸葵援媛喉鍰爰一揆昊煖嚴堠犬
始	怡擡治胎迨冶苔臺笞殆貽跆飴颱或怠域媧結銘如吆哉名
覦	硯規現峴覓靦覬覲覜蜆視筧莧觀覺見窺攪俞褕逾榆渝愉喻偷能瘉愈
昆	庇屁枇批毗沘妣仳比紕能皁崑混棍焜錕花疵尼它指牝脂叱琨化
俠	佑愜儉攸矢傘侑伽雉儈倫頰傷傖從陝仇侮莢偷狹佈峽挾俟夾浹佺伶
檯	薹桔臺橈檮櫝杜檣槁拮桂肚樹啁黠橋嬉嘻僖遠結榷碉周吉
濕	涅汨湯渴瀑漫混澗瀾浪艮宴潤漕湄溉潦潛潟踏滾漠漯漁暍渣湣涼淡娼
陣	轟連庫軍載輦車範軋陀褲輩軒軏陳陴軟軌軸阡院渾揮運暉漣鏈囀弔葷
淺	寸餞摻盞殆櫥梭錢踐腑線殘俯茲慘滲械榔賤村糝鬆私箋
割	豁刮剖創副判刑刊害剴剩剷劃釗劍削剌剋剎到制刺劑別刪刨利列劃刖
狩	獰守特猙博傳持恃待峙狷時侍猜猛猖猥傅猾溥搏獐膊撙磚樽褥遵獷狼
磷	礁碳磋粥咪礫遴燐轔磴嶙磧舜碗碾磕粼矽鄰桀硝砂礦鱗碟礎璘憐磚磊麟磁
洶	胸沌沁匈洵泌洩泡池屯兇肫汕鈍淘芻囤洧洸洩洎盹浹泥況泱泯汶沃渚
娶	最蕞撮取汝耳支陬叢妓趣茸芰安恥耿弭洱枝肢吱岐技
礫	礁吆碳藥磋灤譏爍磴碾碗機樂砥鑠磕嘰硫礦碣碟磚硿碌璣磊磯砭石磁
蕈	潭撢罈覃譚瘴黃草薑樟漳簧早橫璋障獐幛蕾葬會章瞟璜蟑膘膾磺燴標
僭	潛簪既蠶倡概慨溉暨儈偎借佞僧儉偷倫佺仁佰
齷	齟齬齡齦齣齜渥握喔齲齪屋齒至齧輊蛭絰致姪倒到耋窒室
樊	攀爻稀礬希痍疲餚痳駁椅晞烯崤唏袂決抉快尖艾筷痂療爽塽缺
蠢	蠶蠹蠱春蟲蝨蠡泰奉舂蚤秦奏蝕搔強晁閩蟲騷螻繈蜴蛭蛆蚶蚯蚓蚣虹
勦	剿巢勁脅勃肋叻幼繅男勒勘動勳勵觔劾劻助劬劫功淄錙另
季	悸李秀籽禾委孚香字番移孝孛禿存孕學子和秈利私秋好囝秣仔稞
導	道尊寺守肘專臬辱首對鎳射村吋忖付冠自尉討封紂耐
龍	膀滂鎊矓攏敵獻龐壟隴嚨離龔傍聾襲蘢榜旁瓏籠朧寵
錐	鐫進椎淮推惟堆唯隹崔銼離雜雉雊稚碓睢雄帷準
畢	嗶蹕卅幸辛圉苦芰芾南毋梓莘悻華著萋宰倖睪楛薴葫鋅蕙
燕	嚥蕉蕪蒸薰煎蕭菊忠蓆庶蘸英荻鞦蕊蕙慕蔗蔥痰惹葉葬席患芯藪菲荊
揳	契楔
敘	政救啟敵玫致數敗教敬敞散敖斂敏塗畋故效牧徐放除敦敕孜途敢敝敉攻餘斜枚敔
侷	跼局倨伊距巨倀仞伺伽僻叵炬拒矩鉅倔偃苣促侶倘何估佔佃作佝仿夥
底	氐或邸柢舐泜昏砥胝婚祇祗牴低抵紙衹詆些氏
鱉	幣魚鱟氅鯈嚕蔽敞弊撇櫓斃漁廠瞥憋彆敝魯鯊燃
出	絀窟咄攬掘崛倔櫬茁山黜拙親襯欖屈笨微覽祟撬橇
予	預豫妤序抒杼野舒澦多侈歿栘夕矛了爹移墅夥
鞦	鍬揪愀啾革鰍靴鞘鞣鞠鞋靶勒鞍靼鞭韃韆鞅秋韉審
瑚	湖糊蝴葫胡琯斑班玥玨琛王鬍瑕琺琳做玳鈷瑭球蛄珠珊玷枯沽姑咕估
鶴	鴣鷓鵠鵲鵝島鵑鳩鴒鳶鶉鳥鴉鴦鷂鴨鴆鶯鴿鷗鷹鳴鸛鵪
沛	肺汁滇芾浦沬沽悖脖潸渤湖潮荸淒渚嗦嚏甫孛
撇	廠蔽撒敞敝撤捎擻擋澈挨彆弊敵散撐徹嫩嗷傲遨橄瞰做邀攸銷梢逍悄
僥	嬈撓澆曉橈燒蹺鐃繞蟯饒驍堯珪佳僖儔侍仕圭
吋	忖付村肘討咐寸守寺封射尉對呆紂辱專尊耐侍峙保恃持時潯噪府痔符
乃	孕仍奶扔秀氖莠透戶乍作妒咋肩怎昨柔柞炸笮誘
汁	沛沽沬沱淒渚淙渲滓溶潸濘濱瀉瀋湖潮水汗汛沫洱滇演十
況	祝兗兄侃競克兌悅脫銳澠沉嗅泯洗稅浥涓溴剋閱
寞	摸漠模膜糢蟆謨卉冪莫墓慕摹暮賁幕寬募厝昔
遵	樽撙蹲遭尊褥邁糟槽漕嘈傳特時狩持恃峙侍蔚團
窠	空穹窗窄突穿簾究果裸棵窒巢竊裹竇稞猓窪窕窮窈窟窩窘窖窯課踝髁
箏	猙錚淨掙崢睜爭靜諍筋籐筒算篡纂榮等菜受筧奧臬菔竹自血凸脹朋向
氏	氐邸柢舐妁泜昏砥衣胝婚祇民祗她忘牴低抵紙衹詆底
衷	迎遠旅袋依衽裁裒昂袁衰遣抑昏衣婁迪袈袞畜仰裳哀亮逮衹裹褒氏襄蓑
類	頗煩顆顯頌願顥頻頷頭頹頤頰穎頡頜領碩頑頓頊頒預須項頂頃
埤	啤婢俾脾裨陴睥碑痺箄牌卑鼙顰塊千垢坼圻埠箠
扣	捐拐揖抿捉損手拓拈拘擡拮口如找撲扎釦撰操捌品
彙	髁雷果互繅裹蕾窠電巢稞棵裸猓擂錄沍鐳肯青碌祿夥將課踝剝顆
慢	鏝慷饅甲怛曙耆惜旬縵漫悍懷惕憬幔憫惺鰻恨曼愒蔓
應	膺鷹志截雄恙隹雖惟仕焦集崔售罹痣錐憔椎進推淮堆唯準
歿	歹殃殉死列殊殆殘殖殤殮殯殲例洌咧予夙屍多
常	掌棠當賞黨尚嘗裳嫦堂吊蒂肖啼帥噹席希砸削炯膛擋瞞檔襠鏜鐺
鋁	呂鉛稅兌兗櫚閱鎚莒阜釦悅沿侶銳營鎢袞脫宮閭嗚
蜂	蜓路珞蟲飯蝦蟋絳蓬蜻峯舨蟆篷蟠蛇蝌烽降蚱蚌蛞蝙縫蛾鋒蜊蝗逢蜈蛛峰
膈	鎘隔鬲脰同胴幅硼融銅桐洞恫峒筒盒臉砠碉壹
妃	厄呃扼改範杞凹記配忌己妮紀已卷危氾卮犯姬
般	芟殺穀亢骰殿殼沒股殷磐瘢槃役投搬設毀殳毆盤段毅疫
魄	魏塊蒐槐皋皈愧皁魁瑰皓帛魘的魂白傀幾皇餽醜泉皎鬼
緊	腎堅賢豎絲紊繫紫絮繁累紮索素系羅喲縲濰蘊辮
岱	貸袋黛代弋玳屯伐飩式嶽庖疝忍惠筏念岑今肫囤拭沌匈伏涔仙惴鈍愷
療	嘹疒撩暸餚痍希潦爻顯瘦瘓瘸痂僚病痰剎疼癢寮繚燎遼瞭疸
皖	梡院莞寇完暄玩白皋皇皁皓棕淙皚魄的泉冠帛元
酪	酷酩路鉻略咯胳烙格洛恪醺賂詻酸絡骼酥醜酉
璜	橫磺簧弄黌瑛琪玨璞黃瑾斑班璿琛珪理珊王璣璟璋璃璀璩環璦瑤瑞琿
苔	茗笞蔗臺胎迨治擡怡始蓆怠或莽茂冶菩萵哉名殆貽跆
琅	浪娘狼食班養球瑭玨良珀玥瑰斑瑯王理珠珊玷玩玟玫玖璞琉飧瑁琺玳
麟	磷粥麋麝麒鏖遴燐轔嶙舜粼塵鱗麂鑣璘憐麓麗毗鹿
砲	咆胞炮袍泡抱鉋跑苞庖磊鮑皰匏飽包雹碟砧劬刨石
襬	擺罷熊態能蜆比毗庇鐸鐲觸躅髑燭曙獨澤濁擇鉀胛柙押呷紕枇沘批妣
儕	躋擠濟臍僕齊薺佔位住依仿劑霽偵偯倍伉齋禽企
席	滿瞞蓆蹣庶度蒂戒弁希廣英巾常怖佈瑛鈽厲冪幫癘吊布懣庸砸啼棉飾
扮	汾吩份粉紛芬拐氛分岔忿招盆枴刀貧寡揚初叨盼砌撳券召剪棻
僵	侖彊薑儉會膾檜仁燴佞疆儈偎拿倫儡偷盒命殭合偭佺韁俞
淆	餚洧餚崤汰浹汍有學爻侑滯宥囿鱟淌渚淦消浦洶洎洫鬱沮泱滴沁沈沛
輪	侖掄輳輾軏輜淪輸輛輔轔轎轟倫轅軛輕轄輻轉軋輊輯車綸軟轍軾論崙軒
禽	擒噙漓僕璃魑企儕位住佔傍停偵偯倍依伉仿每乞崩人傚僮億朔倣信儲
饉	餅僅蝕餿餽餚餓瑾餌餉餃飼飽飯飩飲飪飢謹饅餵館餞餡餘餒飴飾飭
賬	賑貝貼賄貪賅悵賊敗脹賀貨則財貧賭責貯賒販賺賤貽萇帳張倀負
怕	遑迫鉑湟錦愧篁必帕陌腺棉白柏粕煌葩嗥拍泊泉伯舶惶 珀
壩	霸灞糯燸嚅懦濡儒鐳蠕孺擂擾優革蕾鞘需雷鞍靼塭掄淪倫垣圬鞋鞅靶
鐵	穗磚傳針蕙鏗轉銨截團惠栽哉鈷專鎔錠戴載裁
韃	撻躂韆革鞋達鞦鞭靴鞘靶勒韉鞍靼鞠鞅韁鞣緙霸鞏
匈	兇洶胸屯酗囤沌肫鈍旬句甸勾勺兇心愷勻劬快岱恢盹峽芻崤惴
冒	眉苜目相帽瑁省看盲眷明督算瞥瞽篡渺懼瞿廂萌箱纂貝自盹眇盯眼媚
嘍	摟樓褸鏤屢簍縷螻髏呻婁屨砷呷申坤伸嘯哽神
褻	藝熱勢丸襄裹裒衰囈執汍甕壅爹逵孰姨娃卦外
靂	瀝壢歷雲震雩靈霎黴零霽霓雯雪霖霏雨霤霍霄霾露霹霰霪霞霜霑霆
垠	恨根退銀堰艮痕狠限眼很跟艱齦坦腿褪偃良宴書
賻	膊溥搏博傅縛賊賤貽鋪贓貯脯貝購賠賜贈賒賂貶贖賭賄補財浦捕埔哺
絮	絲累系紮紊素索喲紫縲糸濰緊繁繫細嫘恕羅蘊絨結絢絆絃絀組紲絹綑
甩	用扎傭毛拙甭目甬牝尾指摧憊月手山批俑湧耗娓毫桶恿通痛毯備撬氅
拷	烤銬考技捷按搾丈拉拄抹拒拈抖抉抆杖撲仗擠挖控擰攏豐
杆	幹稈軒
崔	奮準隹懼焦帷僱碓蕉唯雄催雉售睢淮瞧堆稚惟椎雛璀錐集推瞿摧進
街	銜衍衝衢術衡衙衛桁行徵徒待微徘御徵往彿徐
眈	耽
懺	殲讖籤纖韭愴恰三憔憮愾愕惰愉悔慷慵蝕傭惟辰
撢	潭罈蕈譚覃樟璋漳標膘幛漂嫖獐瞟障蟑鏢驃早瘴
拆	訴坼扳捶揪晰斥提託撲括哲扒下抓插播浙排柝斤抵析逝掀拍折搗近撕
簾	箴謙歉麼戒獷廉簫嫌弁鐮濂箕賺縑笞笠兼乏鬼箋
日	曰昌旦明杲旬汨昔杳晶巴白早百艮門旱旺昊昇昧昨昱冒晏倡娼唱暗
跦	侏踵跌趴銖踝硃株跺足跟距跚踞趺珠蹕躋踩蹂茱
燦	烙粲粥咪焙迷炕璨籽謎假遐餐燐粱炫瞇葭米愾粒煆粕料敉熾掬糕粗暇燃
染	孝朵閑夷九汍子哮李梨痍姨咦胰教旭仇柔架柒杲桀疚採樑牀宋孚究呆
尼	屁它比妮呢怩庇昆匕叱化仳妣批沘枇毗皁紕能
餵	餒餞餘飴館餡餾饅饒饑飾飭偎餽餌餅蝕飼飪飩飲飢
劫	劻劾邊勳男另動勒勤幼勵勸助劬勢伽肋叻功去勘迦咖力拗勛觔勉黝勃歷協脅
肉	內腐瘸吶鈉丙傭豪兩佾胥炳柄俎俘納病倆祭敝帷敞散榷敵憊離
氤	氳氣氧氟氖氨氮氦氯氬氛茵氫胭姻咽愾邱汽嗯
澎	膨彭彬樹趁珍疹穆諺診廚鼓形須彫衫杉鬚彥派法影彰彩浩彤箄喜鼙
芍	芯葡灼杓妁釣苟荀的約勾勺苞菊豹酌蔔葉蕊怡勻
濠	壕嚎蠔涼淳豪漓淬液沾澶鎬槁搞婷停沆稿犒涓篙蒿嵩高亭
份	汾吩扮俗盼刀氛棻粉岔砌紛傷貧枴盆忿剪仞叨召拐分初寡芬
迤	拖施他迆途迄也逾池弛她地夜訑牠進佝跑馳卒褒
譎	橘謂請諂誦諍訊識證譏譫謠謐諼誼談諉認誡誥誌詫試詩詰詼詣詭詔設
綞	錘捶唾睡陲箠絲紙縲緞細紲組紗紆編線繙糸緘緬緙綽綠維緒縑縝縯絢
獨	呷猜鉀獰猾猙狩躅狎柙蟲胛猥蠶玀蛋觸猖押獷狸鐲狗髑狄蜀狷歜濁猓燭匣
青	倩請猜靜精毒擂債蜻磧情菁積睛責清嘖晴素鯖漬靖
餛	錕焜棍混琨饅崑餞餡餒飴館餘餵餾飾媲饒饑飭饞餓餅餌餉餽飽飪飯飩
株	朱狩板宋茱跦硃槐誅珠千林材柝未才柏侏析殊銖蛛柞
點	黜默黠黯黔黷黝玷沾拈佔貼站砧帖黑店黏嘿佔墨
葫	苦湖瑚糊鬍蝴胡楛居古鈷枯沽姑固咕估芾菅牯
枋	肪妨坊仿防房芳彷紡旁舫訪榜倣淤遊方菸瘀遊
仁	佞三二竺僵合祭但侖些俞拿會低沅佺倥伍佰丘元雲示全餘命盒
森	痳林淋霖琳彬棟梱材村橾孱楝木焚婪杳傑杲採李杏牀宋呆棵杜沐困樸
東	凍柙木鍊棟潘煉柬蕃田番墦播棵揀稞楝梱陳審
配	酒釅醮酥酸醞酊酵醴醒醉醺醇酴醣酩酗酉醋酪釀酷醃醜酣酬酌
及	洛扳烙閣咯板阪各伋鈑殼吸皈返恪又汲叛冬岌降反級圾格幾極疼咚皮客
嘿	哩黛黑墨喱鋰裡埋娌浬俚裡黠啖理狸童喟燻貍默壎黜點鯉
簷	膽簷澹擔瞻蟾譫贍詹答筒小簽籥逼逗言箴第磊筵石上穢銅
鍥	楔喫契鈇夭鈽錶燠錡澳懊噢鋒襖鉻駁鉛換鈑拍沃扳妖託扒金齧笑奏忝
謠	請調諾謀講謁許談諉瑤諍謂搖諭諳誼榣遙謊訖計詛謐訕詰謨諼諒諜諦
跚	踩跦跤姍踐蹈跼柵趴跆跑蹊跋蹕趾踫踞踏蹦跌踱蹉蹣距趺踝足跟躋蹼
抉	快決袂抹缺訣鴃耒披揀筷找抆扣撲扎手抄技扶扭把抖扳拉拌拄拒拓拔
車	轟軋軌軒軏軟軸軔軛軻軼較軾輊輔輒輥輻輯輾
四	泗田金囚回因匹困異黃囝囤固囿穴思胃淦鉛鈿
雪	霞霽霜零靈掃雩雨霾霎霪露霆霰霄霤雲霹霓霑雯尋霏黴霖震霍
濺	賤鋇員惻側狽贊貴貫貨責潰漬賊貽貝貲賃廁費賀買貸貢
纔	攙巉儳讒饞毚縲絲紕綺絃纏纜織繙繒繃縐線緝綾綴綿絹絕給絳絡絨結
釘	頂坷酊針空汽錡釦汀打釙河呵柯薴歹欽丁叮可貯鉗仃訂鐳鈣釭盯佇鈕
衆	從叢縱樅
詹	言訾這檐減喊逗蘑洞蟾洽簷閤逼銅譫桐擔瞻礬胴澹筒贍磊答譽膽石
敔	啟故敬斂敘敕敉敢枚玫攻寤吾敝敖敞散政畋致牧敵數改孜收衙
刑	刊釗利剌制割劊劍荊劂剛刈型列削剖硎到劑開副判刪刖剎剩劃剝刺剴形
視	莧攪靦祆窺硯覲祀覺禍蜆覬觀筧祝見規覜覓祚祖現峴祕
州	洲劃酬川庚列班順劓允唐康庸圳剌釧鄉辨塘搪傭補慷慵鄘強褲戈充盞
坼	拆柝訴斥圻垢塊下埤塢壎埠堤墦垃坷坪坩坊坍均壞址城圩後戌卡斤土
後	役復彼待行綾徑徐凌得從陵徨徬傻稜稷很彿彷徵
茱	株侏銖珠硃朱殊蛛跦誅董蒐未千芹萸宋萎蕃狩懂
咪	迷米屎呼磷哨吵粥粱啖氣籽敉料粒粗粕掬憐燐璘遴乎京粟糜
痊	荃佺栓拴銓瘉全癒斑詮班疙王玨疹瘡篁筐逛框
菔	前籐葭菜葷蒙芟菠萌落蓬苜盈煎又腱股服葫蔽蔆藐莧爭菱萵剪箏箭腋
洗	銑先浩派洎況泊沃湩沉淫溴活洫沂汎湟沘壬浬泌法注衽淮沙汪沌妊汕
玀	囉邏儸鑼籮蘿羅還澴環獨寰遝狎篾鰥楞愣爵甍夢
瑾	僅謹饉玨鄞勤瑛弄璞琪班覲珊璜斑瑭瑰理玷珀玫玥玩玟玖王
賡	庚賁簣賞實賽貧匱圓潰遺隕損債寶資廁貝賤價漬槓慣嘖賸績蹟側臢鑽
椰	爺梆耶榔陬槨聶綁挪娜哪邦嘟橢擲洱弭楫茸瑯輒琊螂趣邶躑攝懾囁鑷
莎	沙萍菠茫範落蕩藩藻渺蒞蒲蔆娑薄鈔炒杪抄妙吵
嘐	僇膠穋謬繆寥廖擢濯曜櫂躍摺褶耀嗡翟習羿榻煽遢塌翰蹋瀚翠蓊翼翌
僧	漕會遭俗增僭繒儈曾偺鈿層借憎份醋嘈贈鹿倡槽
臧	藏贓宦臣臥臨臟馮凍準冶次冰凋腎堅卸冽冷勻緊豎賢凜凝啣凌羽鑒
蜩	蟲碉週惆啁凋螟綢稠蛆蝸蟲調蜆蛙蛔蛀蛄蜻蝴
狙	俎猾猙狎砠姐且疽狠猶狸狄狗狷詛猓犯祖沮租阻狽狂粗宜咀
殮	檢臉撿險鹼瞼殤驗簽殲殆歹殯殘蛤殖殉死列
竄	鼠窗患窟窮簾窄窘穿空窩裒竊舂搾窒窈竅舀窪究窖穹鼯突窠窯竇鼴潟串鼬
坡	陂破板皰彼玻菠疲皮皺跛被詖圾披鈹皴波簸格頗 
豌	碗腕惋婉蜿豉頭宛磴愷壹皚澄嶝燈澧橙瞪禮蹬體剜
潟	燄瀉滔臼舀淡寫裒舂漁艘焰潘澳添啗浩泊沃竄
求	救裘梂球毬支戎技岐妓吱枝肢芰甫朮取匍圃歧怵述浦捕庫埔哺脯娶莆
周	惆調裯雕告稠碉吉黠鯛週同結售桔圯拮蜩啁膨肚凋綢
純	縐約紲絲絢紀絀細縲糸紗紋紐納紙絆組紆紂糾維繡繩
鉀	鐸鐲胛柙押呷鈿甲匣狎賣鋰閘曼鏤獨澤濁擇燭曙鏝申薯
瑛	英弄璜瑾玨央滿璞映泱怏斑班瑁琛璃珪瞞琪鞅秧珊殃玟玫玥王盎席
博	捕莆狩誧哺輔傅將搏補甫傳薄賻圃鋪溥簿膊脯縛肘匍礴浦埔
賄	敗貝貼販賭財賬賺賊貽賤則賅賑賂貯賠購贈鋇貶賒賜賻贖員
重	動湩董腫鍾種懂慟踵衝裡千俚狸浬娌埋哩黑裡仟鋰範
稔	捻唸黍稚念鈐穗吟移秒穫伶祕私利禾季岑稜鈴稱稈程稀槍嵇稿稼稽稷
宰	薛僻辣滓癖鋅瓣梓辯辭辜辦避莘辨闢薜辛辮 
苗	菌萬廿槽漕貓遭芯昔茴田瞄曹艾描麴嘈茵尊錨童
艷	豔豐色豈鄧磴豌皚嶝愷逗脰痘豆頭碰碘凱豉吧禮磺瞪燈澧橙磋澄磁短
瓣	瓤薛僻辣宰滓癖呱弧霹辯孤辭瓠辦莘避辨闢狐瓢薜辛辮 
簡	籣澗間門捫們藺蘭燜嫻僩閑閒悶問冕閃閂櫚瀾攔爛潤欄憫猖晚
魑	漓璃魁鬼魎魅魍禽擒噙槐愧塊傀蒐機嘰魏魄魂瑰外幾
搽	搭擭描措摸茶條搓撙撲拱拼休搆塔褡濩拚拖撒攤葆荼
駑	篤闖驚駕騖媽嗎罵碼瑪馮螞怒弩努帑馬馱馭駐駟駛駒駁駢馳
焊	桿捍悍銲稈趕煬旱煜幹焜幹爆岸袒怛坦緹但桿肝汗奸竿旦
儔	檮鑄僱侯催壽仕禱佳躊僥疇濤籌侍隻僖燾堠雙伶
午	什杵缶仗估傘十人佗佇卒佬使倥率許缺啕悴掏淘淬缽萃萄搖瘁摔榣遙
錠	鎔稼隄棕針鎮臏提嬪檳靛濱渲綻梡鐵嫁傢喧貯儐定銨是暄淙緹銬碇佇堤
刻	氦孩利劾骸剌制劍賅劂垓刮削剖亥劇劑閡駭判該刪核咳剎剩劃刺剁刑
形	刑彬型箄彰彤邢薇彪彥開彫澎杉膨疹彭衫妍珍影彩
聊	鉚柳泖茆卯卿留聶劉聒溜遛榴聰貿瘤籀御啣唧迎抑仰耿恥耶取耳
嚶	櫻瓔纓嬰罌員鸚嘖損鋇圓韻噴隕賞噸貝賽賀贈償臢賸噯賠嘎滾賂鑽貽
楹	檻盈遍偏褊編蝙篇隘艋猛錳濫尷艦襤鑑柵盤籃
銷	捎哨趙俏屑鞘悄稍鐺硝睄鏜梢峭肖鈔尚宵逍消誚鎖帩
刮	刨別利釗刊割制剋刈恬甜亂舐括剖創聒舔副活刖剩劃舌刎剁
噫	憶億臆諳暗意樟漳璋境幛獐障鏡黯瘴音噶蟑竭焙培涪陪倍章
鶸	弱鴻鵬溺篛鶯鳥鷓鵡鵲鵑鵝鴿鴒鴣鴨鴃鳴鳩鷹鴛鳶
耙	杷把耒肥吧耕耗巴笆疤芭邑耜爬靶耦爸耘耨琶
胚	呸丕胱肝肛不脤胴且歪同杯朋豚壞脰膘爰冠芣否示
啊	婀阿呵崎倚椅畸錡寄荷犄琦可部郡柯郃坷河鄙邵何綺騎苛奇
訓	誹訕計訃訛誑謎謝譴訐討訌訊託訏訑記訥許訢訣訂註詁詛詐詳詢誚課
徉	律很徊徇往彿徒徠徜彷彼徵徙循待徐從行徵得役徨衍御微銜
編	終絡遍褊偏繙縊絹絳扁糸線蝙綿總縲綵紡騙紙綏綸祚綞絲篇
嫡	嘀摘滴適鏑謫姣商六妨滾婷嫌姆姍姐如孃交女冥脊姦
繭	蠻蟲蘿茲煎繡紳紼紜萋索蚤苜芷羅藪蘊蝨前藥剪芸糸蟲縷縲繈蟆螺絨
鼇	熬贅聱澠蠅繩遨嗷傲敖知癡佑智邀放疾矣君矢尺檄激踟敷蜘埃倣畋咫
綑	縲細絲綵糸紆紂繙綱綢絢維練絆絀紳組紲紋純紐納紗紀約繡糾絹綏結
緹	綻提堤隄縵縲絲織繒絃糸締緯線緩綜綺綿綵綸縉縞錠絹綏縮縴繚結絨
豫	橡像予預象杼抒妤序野舒澦墅多歿夥移栘侈爹
腋	液掖夜臃股迄腹胳腱健腿淬悴骯臆服臍遐又舷碎逾逢膀航粹侵踴蹂
靠	斐悲輩裴告啡翡非痱菲扉屝誹腓排徘匪俳罪壬造浩
慧	彗豐叼虐刁掃浸侵伺邦雪婦帚歸梆蚌長鋒綁悵烽峯
澹	擔簷膽瞻蟾譫贍簷詹洽減洞小澄漁逼渙逗沒澧潯湧涼涪浴沿涵汐汛漲
秩	迭佚跌軼失種祕秋秈和私稚禾秧租秤秣科稍稅稞秒程稻穆穢香番委黍
犖	熒榮塋鶯勞營瑩縈螢牽眸嶸犛癆牛撈嘮牢牟牲牡件
工	汞功攻巧貢扛江槓肛釭項佐紅缸虹築訌槓蚩鴻
鴻	鶸江鵬鶯鵡鳥鴨鳴釭肛槓扛鴿鴣鵑鵝鵠鵪鵲鴆鴉鴃鶴鳩鷓訌虹缸紅鴕
恐	鞏築築工惡汞釭槓肛扛江恣愆攻佐功貢忠悲氨寧蚩丁恥紅缸虹惰阿巧
勗	鋤助暖筋疽宜勞脅湧勝沮姐咀功窈且力粗組蛆砠祖租勤俎拋拗狙阻肋
篇	侖妒遍盞褊作楹藍偏籃扁笮炸編蝙肩匾盆檻濫盛咋騙昨盧襤瘟鑑盡蓋柞
影	衫彤杉顥彰彭彩彫彪形彥憬晾景璟箄掠涼吵京
娜	哪梆媽嘟弔婀躑擲瑯椰那爺榔槨琊綁螂挪廊邶
鏨	暫塹斬嶄漸慚斤寅芹近析昕沂折圻聽匠斧演晰斯逝淅浙祈斫欣所
淒	悽棲萋汁妻沬沽沛渚演滇沖汝沱潸澴湖漸潮淦淵浪浦津洱活派洩沫沸
谿	雞裕浴峪俗豁容溪奚谷蹊鎔幼熔榕鉛溶紛欲卻以腳拗蓉
禾	私秈委和秋香番禿利季科秒秣租祕稍黍稚稞秉秀秤秦秩秧倭稈程菌萎
創	剖刮割劃倉副釗剎削剌劍劊劑刺到制判利刪刨別刖刑列刊刈
珠	琍朱玥王球茱跦珞班硃誅玨瑰斑侏殊株銖蛛珀
鈷	枯沽姑咕估針錮古苦居固鋸牯骷蛄胡湖葫詁銨瑚糊做罟
俳	啡排腓徘誹匪屝菲痱扉罪霏靡非佻儘悲斐跳裴輩靠
護	諾譙議謀講擭諂詼談獲謂誤誥詳濩諭諳詻誰穫謊設詮詰謨誡譜譁諜誌
問	閭闆門悶閑間閒閃閂闡閉閔閏開閎閘聞閨閩閱闌閥閣閤捫們櫚
素	嗉絲累系索紊紮紫絮糸喲縲濰緊繁繫細毒青羅蘊紗紋純紐納絆絃絀組
沬	妹味昧汁未魅沽沛宋沐淒渚朱滇演沱潸瀋湖潮守
瞳	潼撞憧幢鐘僮童瞄眩賠瞇瞧臆瞞競睦睬暗黯焙喱涪接培倍睢睏目瞿
訕	計訃記詣訐討訌訊託訏訑訪訣訥許訢訂註詠評詞詁詛詐訴訶詳誠話誅
疼	洛終扳疒烙閣咯板阪鈑鼕皈返恪略叛冬瘦胳療病逢鉻癢咚格客
媧	嫦剮猾滑迥萵骼姐骨嬌窩亂咼禍過朋繃鍋蝸炯堝渦始撾姍
品	噪區嘔咯唔咖譟癌澡燥嚷闆奩口嫗嶇樞操橾躁
韌	韜仞軔紉刃違偉衛圍葦幃韓韋闈緯諱招拿券槐叨枴砌挈吾
度	葦藩盞庶席範鍍緯摭蒲蔗茫蒞戒廉渡戈蕩拚莎弁萍韋械藻蓆踱遮庠廣偉
鍘	則測側
毋	車貫單固軋軍庫連憚彈嬋簞田十個涸慣箇實錮禪闡
啦	拉接撞啪立煜噫垃泣位撲培涪倍焙笠菩昱音妾
稅	脫悅銳蛻閱說兌祕秈和稍稚稞秣租秩秋科私程秒禾禿
囉	儸邏鑼玀蘿籮羅環還澴寰遝鰥楞愣爵篾甍蔑夢
覆	御履粟復屐腰薇賈要慄複價蹤屨徐癥樅從腹遷愎溧縱桁馥屜
手	扎撲扣找夫牛豐用半年羊耒聿羋打扒託抄抖技扶抉扭把抆拉拌拄抹拒
質	躓貿買貢賈費貴責贊賢資貲賃賀貸貫貨員贗狽
歪	政徵扯肯甭企懲址整遣胚狀証證祉不盃嫣焉呸否芷怔止丕武症正
鄰	令郎磷齡邵郃鬱邦耶遴拎燐轔鄙郝鄴祁玲鄞郊那鄱郾都鄘鄧鱗鈴郡部領璘憐郢冷郭嶺伶鄭
材	痳板彬豺棟森槐淋財林柝才柏析村楝梵株閉柞
柒	池也沁柴洵泌洩悚沐沌快迆忖弛她地他杲採樑牀宋呆森林淋
屝	匪扉菲痱罪霏靡啡排俳腓徘誹非悲匱斐裴輩靠
殳	股役投沒般設
耽	聊取聶聆耶沈聰聘弭聒聯椰鴆忱職耳洱枕恥耿眈茸
緝	絹縲楫結揖絲絨紹繩糸綵輯綏絡給絃紛細紀緯編線綻綰綜綺綬縛縞縮
濃	漂漕湛撙農醴遭甚儂禮膿樽遵澧嘈糟穠噥體污槽
畿	茲聯慈畜幽溼滋細幾孳參磁嫘綑縲饑姒樂累玄廊戴藥晉奚嘰漯緇機螺
惚	忽惕吻易囫物勿錫刎憾蜴賜踢匆悸惶恪懊愧怕
龐	膀滂鎊矓攏壟隴徬嚨龔傍聾襲蘢龍磅榜旁螃瓏籠朧寵
涼	漣晾京沾漓注泣澶佔驚流掠淳鯨淑汶濠沆憬液滾璟濟淬汴景涪就諒偯
曖	噯璦愛暖暝暉明朋受授棚暈盟崩綬硼胴舜萌骨冒
嬴	羸贏瀛肓娟氓妄硼胡迅崩恕盲妥忘杗芒亭亡噯調諍謠蹊網溪碉綏啁惘
矣	疾俟挨埃唉矢枚畋敏蜘癡廠改知玫牧收致故敉敖敝救啟敕敞敢散敬敵
當	黨膛擋掌檔常嘗儅棠鐺鏜襠儻堂裳肖賞尚噹炯
臻	榛至秦致到樁湊揍輳姪屋室渥棒握喔捧俸痿舂窒奏
嗆	傖愴搶滄槍鎗蒼瘡艙倉吟唸哈喻噙吃飧創咻咐食
訖	診詮誨論諭訛譙許訥誰訟詰詼詣詭誌誡吃談諂謂謠記訕訊訂訃計
菟	冤逸冕晚挽娩兔輓免勉茗竟臭蒸毚溴嗅境鏡儳攙巉
容	鎔谿熔溶俗鈉豁欲谷裕腳穴卻錐峪蓉榕壑賓慾浴
裴	斐悲輩翡裝靠製裟裘裁裂褽袋袈襞襲依非痱菲扉屝衣腓排啡匪俳
聱	熬贅鼇聶敖聲聞茸爺遨嗷傲聳聾趣攝懾囁躡洱弭鑷
諜	謀碟訑謐誌誡詢謂諳諾談諉諍認謨詫試詩詰詼譜譟喋訟課詳訣託討訕
翎	翅翔栩翩翱翮翹翻扇翳羽翡領鴒昤嗡翁蓊塌遢榻翰翌習翕羿翟廖
娘	良養宴墾浪痕狠飧餐饗食饕垠狼銀姦退根餮恨癢琅懇始艮姒
調	詞請訶訥雕稠碉誧詢話諍謂誥週詳詐誰訃謠詁計謫詛課啁凋註訕誚詰諼詬綢周誌
藹	靄謁噶罰獄辯謨誡碣譁譜識譙護謊諾謂諳諜課誰諛諉談誌誣認誚詳試
婿	胥楚疋蛋旋娟礎漩媼踩妳娛佾蹈跚妞好奴媛婷嚏蹊娩妤奶內
燴	儈檜膾繪會給劊覃潭撢儉僵綸偷倫佺偭蕈檢臉燈撿罈褕銓榆幹逾渝愉
離	籬敵帷進雜錐睢椎淮推惟堆唯雞雕獻誰雉雊稚碓雄準隹瞿崔
櫺	孀樞靈橾雨霖霞霜漏軀嶇嫗嘔露霽瘺霑霍霎霄奩雲雯雪
篁	煌遑湟惶凰蝗隍徨韹皇筐珀旺皆斑班痊荃箔潤鉑逛柏迫玨泊拍怕伯
掛	褂捱鮭涯卦撓娃閨奎哇掛圭佳鞋窪畦桂蛙崖拮堯街封
地	她弛池他迆也牠志訑馳均拖迤痣忖快悚柒恙圩施土圭
茲	吆淺藥似麼茹箋爍以窈孳機樂鑠玄棧關奚幽嘰畜絃蘊拗幾滋璣慈姒磁
瑭	塘班搪糖醣琅球玨唐瑯瑰玷玥斑王瑾璞理珠珊珀玩玟玫玖琯琉瑚琺玳
蝕	蟲餽餌餅飼餓飪飩飲飢饉飴餞蝨餃餉飽餚飯餿飾餒餘餵
黏	黍貼點店涼漆沾佔帖乩拈戰稚霑玷砧藷粘圖站儲膝惦
駛	馱馬駐駟駒駢馳馭馴駁騁駭騙駝駱騎驥駙駿騷騵驃騾驍驕驗驛驟驢驅
鄂	顎愕鍔萼鄙郵郾鄗部郭郢鄞郡郃郎鬱鄭耶邸邱鄴邵祁邢邪邦那酈
昨	妒昇淚遍作窄褊偏僱戶笮砟蚱詐炸肩捩乍邀唳咋祚怎篇柞
摜	貫慣貫
撾	過撻撲搞攏鍋攘渦媧堝掠萵拈擅擁摔禍掖抗窩
錚	淨掙崢睜猙靜箏諍爭鍰鋼銅鍋脊鎰鋇鏑鋤潸鎊鎳鏗鈽鉛睬鐳鐫深探採
倏	攸脩絛條修鯈候袱仲做傲爪敕伏收俟悠傚倣佻嫩滌伽偽疣篠
瞋	滇慎填鎮巔縝闐癲真睫睹顛盯瞎睡睥睢眼盼盹眇睬目
颺	颱暘陽颳鍚暢腸煬楊揚場颶颼瘍楓瘋嵐風颯諷
靦	莧面硯覲覺蜆覬觀筧見規覜緬覓現峴偭湎覦視
爽	塽爻痍餚囪淆崤痂鈸拔樊希攀大烯晞紱稀窗唏跋募傯駁努學療
擋	捎嫦黨膛螳掌檔撐償讜儅幅棠瞠撇當鐺鏜襠儻堂尚噹福
槓	貢潰遺槓匱簣漬嘖債磧積貴績蹟損價隕瓚項釭肛江扛
澗	潤瀾簡間嫻燜僩捫們汨門憫櫚涅攔爛欄漕濕擱湯斕晚悶閑閒問冕藺閃
坳	幼窈拗
脩	攸條倏修絛鯈侑候仲悠做傲爪敕收傚倣滌嫩佻俟篠
田	四囚因回困胃思甸佃苗鈿由甲毋曲裡東果囝囤固囿男畎畏畋畔畦異
理	裏環弄玥王珪班珊玫玖浬玨瑰狸埋童珀暑斑俚玷娌玟鋰裡哩著
禪	蟬憚彈嬋簞闡單祀福禳祝禧禍戰祐禮禱儼祗祥祕祠祖神祚祆社祁襄器
劇	釗割制剋劊劍劂刻居遽削剖創剔剁剷劑刷副璩據刺剎剩噱剃剝剌刎剴
抓	瓜爬扳拆捶揪託捷括扒抑攤爪插播徐孤從掀狐搜庚拍折搗
禱	檮祠禧祈祆鑄祕社禮祀祁禍禪壽結祐祉祗躊疇祥濤儔籌祚祖燾福祿禳
壹	愷脰噎嶝澄皚橙澧燈瞪磴胴禮體筒豉桐銅峒恫洞證蹬醴
損	貝捐隕槓慣臢員潰績債瓚磧韻遺積賡貧賸簣嘖賁匱蹟鑽賞圓賽漬讚實
渴	褐濕混曷竭謁歇揭湯噶漫羯暍瀑碣涅汨愒遏葛喝
赳	赴越走起趙趟超趕趣趁趨陡叫糾徒收垓狀戕妯垃卦妝壯址進跟堤壕壤
鑼	邏囉儸玀籮蘿羅還環澴寰遝鰥楞愣篾爵甍蔑夢
尋	待詩靈掃褥恃痔刁持潯帚符奪將廚耨峙咐等討吋附冠謝蔚侍雪磚府時樹
奸	汗桿肝乾旱竿妍軒罕訐鼾橄姪敢悍捍桿焊銲刊瞰岸
錶	婊表鈇素嗉鍥鏟畏青銀鉗鈿鈣鈞釦釭針釙釘拓打耨鍔煨晴喂清情偎倩
基	共恭塞益巷異烘哄拱洪供斯巽鬨寒寨搴暴並港
館	饅餞飭餾飴餃餚餉菅倌饑餌官餵管饒琯蝕餓餡飼綰餿餅飾餽飽餒餘餛棺
鎔	熔榕溶蓉容錠銨欲卻谷裕浴峪俗針腳鎗豁鉛鑰鈷穴
湣	泯抿岷眠氓民婚潛昏嗜涓浥漕澗泜洵娼唱涅潠澡愍旬
澆	法橈涯嬈珪繞撓蹺翹瀆圭曉窪僥饒涅燒堯濤蟯驍溘鐃
渠	巨苣鉅炬拒樑架柒染爭杲採牀宋呆森局凸凹淋淨矩洱泥林沐氾
鼎	目睛睫眼眶眠眩瞞盯瞿纂睦睞睹睬睜睥睢瞄睽睡睏瞎瞇瞋眸眺盹瞰瞧
哭	器吠獸臭突咒單戾囂犬畎伏莽嚴獻獎狀猷默區襄巖唳袱嗅獄儼
柵	盥益蜢盟盎珊相扁楠盂棚皿盜檻錳跚盃監盛盍孟冊盔盅猛姍
殃	例泱殆咧央歿洌列鞅殘殤殲怏殯映歹秧殊殖殮英死殉
券	倦炤豢謄切刀半蜷紹沼岔叛昭卷忿圈迢判叨分捲初挈拳譽眷招
柯	河坷呵何阿苛奇蚵軻椅訶可倚崎畸錡寄荷犄琦婀啊
掖	液腋夜摔抗掠搞擅擁攘撲投迄提擭抆健挺撻撾
力	荔加邊另男動茄幼勵助伽肋叻勰迦劣劫筋痂咖勇歷協脅
申	呷樓岫柙屢甲胛簍暢胄呻坤摟押婁砷迪妯嘍柚褸鏤油由紳伸匣抽神宙
毚	儳攙巉纔讒饞諧楷揩階偕陛琵崑皆錕焜棍混篦鹿罷餛媲琨
檮	濤疇儔鑄禱躊籌壽桔燾檯櫝橈杜桅檣桂蟯棧械栘耘鬆弱坎樹堠塗堡崁
冉	苒再坍玥媾搆溝構稱遘月土珊堝壺膺髯講購攜
彤	杉衫彩彥形彫彪彭彰影丹箄坍肪彬疹珍趁遞諺射顏榭膨旁產
棠	掌當常黨尚嘗裳賞堂肖噹檔炯膛擋襠鏜鐺呆敞梢敝淌嫦哨倘削保瞠儻
櫬	襯親欖攬相纜覽湘霜箱廂椒棚雜楨柿枕樸櫻楣梳想
窈	簾窮窟窄窘藥姒似幼空麼竊窒茲鑠窕玄窪究奚穴劫穹畜突拗窠黝筋勗脅
俯	餞令含腐似踐腑符念傅條咐棧傳傖附俊械侍俟府付休伐伶今
琛	深探玥琿瑤璦珊玨瑁璃瓔現斑瑚班王瑛瑜琉珪璀璜璿瓚頊瑣珠璞琳再
堰	偃鼴垠艮腿褪郾根退銀恨痕眼狠限墀跟很艱良
縞	槁鎬搞絃縴稿犒篙蒿嵩縲締織絹絲紋綵綏結終綽絞紡縫糸
學	鱟覺黌孚孛季孝存攪李字孕浮俘餚孱荸脖悖籽好囝仔
挾	俎俸扣扳愜抆撲找捷扎捧拔扒攤扶抓頰陝莢抉狹捉峽夾推浹俠奉挫
允	充兒唐康庸劃庚統州禿亮羌兕傭塘搪慷慵中戈山兜列洲班蚤強鄉肆瑭
搪	塘瑭糖醣唐找擡捕拔撼拚扣搔摭挨拭捷捉括拽抿拂拈抽押拓拇抱拘扯
齜	齟齦齣齪齲齡齬齷疵髭此齧雌齒毗枇沘批妣仳
汗	奸桿肝乾旱竿汙汀汪軒罕訐鼾橄江汁河洹敢捍悍焊桿銲刊瞰岸
徵	待御徠很徜徹律復衝彼薇徇懲術徘彷狀衢證衡癥歪循徉徊徒彿微焉銜往街衍黴症正
酵	醇酉酷酩酪醉醋醃醮醺酥酗酊酸醒醞醴釀釅酴酣醣醜配酌
寓	偶遇隅耦禺愚藕癘邁萬寰厲禹甲巾蜀宵宥宙宜簾宏守吊布實躉鉀幟柙
怛	悍坦但袒旬惺查疸旦惕愒慢靼憬恨耆晝捍桿焊惶湯暘銲旺昊旱
玩	玥王球遠班玫珊琪玖璞梡理瑾玨珠莞瑰斑元瑭瑣冠頊玷頑琉玟琢寇園現琅完珀
桃	眺佻跳洮潰逃遺遣窕挑排俳姚簣北兆覜匱頫晁啡腓邶
顎	鄂頤頡碩頑頊煩項頂囂題顆顛願頰頸頻頷頭頜頫顧顥顫頓頒頌顯須頃
哮	教孝咦味酵嘟軌咕吱染執喃諸嚀夷子丈九享字
價	隕槓慣績腰潰臢債賈慄躓瓚階遺磧韻積賡賸簣嘖遷損匱蹟鑽圓介溧漬實
捆	梱睏困綑摑押果棵拇裸採撙描揉操手森泗泅猓抽抹林找抉稞佃鈿扣撲
踡	倦捲跪蜷圈足卷踐踏踩踴蹉蹦蹟跎跆蹶蹺距趺
葭	遐煆暇假霞瑕蝦豭芟夜菔寢蓬疫又般浸候侵股沒投
供	異僎巽寨暴拱鬨港搴僕併濮哄共寒烘恭塞基洪佯
璀	摧催瑞懼玨崔琉斑班璃瑁珪攜睢王瞿瑤暹僱瑜瞧琛琥玲珍璞理玥玫玩
西	哂迺曬湮煙酉酒鈿酊配酌酗酣酥曾醋醜醫兵酩鉀酷酴鋰醣醮醺
魎	倆輛兩魅魁鬼魑帷師魍魄瑰槐愧塊傀佩雨篩蒐幾
愒	暍揭渴喝遏褐碣竭羯葛謁曷惕怛惺悍慢憬旬噶歇
戀	言跡蠻礫懸鑾灤巒譏認鸞灣奕變攣孿絃絮彎絲亦喲弈誌
犄	琦椅畸崎倚錡綺騎寄奇荷婀啊可柯河坷呵何苛
略	咯烙格胳洛恪鉻珞絡賂路酪骼客詻貉駱閣咚各
詔	詰誥詻語諮認譟詞記詫詼詣訟誌誡誤諒談諉諂諍諾謂詁詐話詬訕託計
細	縲綑絲糸絆絀紳組紲紗絢紋純紐納紂紀約紆糾維練繡繙
蜢	艋錳蝙猛蟲蠱蚓蟾蛹蟲孟蜿蜻蜈蝶蝸蝓螟蛉蟑蟒蟆蟋螳蚣蟠蠔蛐蚶蛆
攏	膀滂鎊矓龐壟隴徬嚨龔傍聾襲蘢龍磅榜旁螃瓏籠朧寵
咄	絀窟出掘叱崛吧倔茁黜拙乩圯咆包屈巳吐笨微祟品口嗤癌
攬	攪攝拒出掃看扼掘崛倔櫬摒盹目拙親襯欖屈損握覽捲纜擺攫撬眷招
縊	鎰溢編隘縲繕縑絲綵綸綏絹緙糸益縞締緩繃綿綬繚繒結絨繽絃續紛細
撲	卜異拼拱擭璞撰搓搭樸攤措補搴僕搽供濮摸哄描撒共噗烘恭基洪蹼 撕
緲	渺紗絲縲組綵綏綱眇綬纓綢糸紕絆絀細純納紀緩絹績纜網纂
煞	熬鄒疾疢矢癸矣皺畋欠欽灰灸久炊疚坎痰恢芻炎吹知枚然燃
橙	醴睽嶝禮磴葵證壹揆蹬鄧皚澄澧愷凳瞪燈體登 
六	交兗冥袞滾商與咬姣校嘀嫡摘滴鉸適鏑卜金狡郊效皎暝嶼舉
抑	聊唧節御卯卹迎茆印昂卿啣腳捌仰鉚抵鯽泖叩柳姬
態	熊擺襬能罷昆庇屁毗枇批妣沘仳比筧莧覓息見蜆視峴紕
蹂	踩跺揉踴跪足踐踏蹈鞣蹬跎跆躁踝跦趴踱踢蹉蹦蹣蹲躊躪跟距跚跌趺
梓	鋅闢辭莘宰辜辛辨辦辣滓樟瓣辮辯枓樸僻避薛薜癖
溺	篛弱鶸洌侯泓瀰沍汐詭桅脆濤歹夙漲河汍汎汀跪沒汽多危
嶼	與舉歟譽峨峴臼六睨匕鼠舀皎狡叱化樁潟稻滾滔焰啗陷峯臾身交山舊
叮	訶或咧酊呃哂汽哽汀打呀呵啊薴歹丁可啄仃訂籲呸啞盯釘喱佇唔
壁	劈薛襞僻宰癖蘗鋅檗霹梓譬辜莘避闢璧臂薜辛擘
訐	訏訂評訌計訶誣討訊訕託訑記訝訣訥許訢訃註詞証詁詛詐訴詳話誅詢
枕	沈忱耽相鴆柿柚棣目巾秧楨棉楣湘束廂箱林札樓帽睬槓懵欖桃櫬睏櫃
謨	諾謊譁護譜誡講諳謀詼詳識諜謂議談誌詰詣訟謹謙諶詢訣訕計訃
愛	受噯曖璦朋舜崩棚胴硼鵬骨授肫綬胸胞覓月滑靜
遍	淚褊楹媼偏僱籃扁嗑塭溫房編蝙匾肩檻捩邀錳慍唳濫盛騙襤溢鑑溘猛篇
襖	制褊澳裨褫央自喚沃衽向血妖噢爨厭懊瘓煥奐夭奧衫衹躍渙筋燠換
餉	飪飢餽餓飯餿餅餌飽飼飩飲餚飴餒餃蝕饉飾餞餡
洲	酬州淺治滲渡蚤洌泓浚強搔劃浪浦泳濂減棧滅溥樑濁褲錢庚箋
鶉	鳴鵑鴣鳩鵲鵝鵠鴿鶴鷓鷗鴨鴒鴆鴉敦郭孰鵡鵪鷂鸛鴦鴛鷹鳶
週	惆啁稠碉凋蜩綢調迥鯛周裯雕肚造運過彫遙膨吉
靨	壓魘湎偭饜緬麵面靦厭奭百璽盟覃然症毒左宿釐燃膘撚弼胯陌明佰
陡	隄越防陣陞趙趨限陪阪阡趣起趟弔陸阿除陌陝陴徒阱阬陵赳超走阻陳趕赴
艾	若哎莢茄荻荔菴惹廿送朕爻美茵薦匿莫大偌尖芯昔苗鄭
抨	坪枰砰秤評平萍拓打不扛杯壞振扼捱捺搓撢擂芣否示
岌	圾吸汲伋級及反峯各冬閣扳阪板返峻殼鈑客疼皮咚恪咯叛洛皈降格烙
嘛	麻摩唆唉哺嬤朮麼痲麾磨糜蘑魔述怵賊絨褲礦吠靡戎
詐	詞訏訴作訥諛訢詢訣許託話誅記詳炸誠誰討乍詁訪計詛課訊訂昨訐註訕誚詬訑
墊	摯執塾丸孝堵汍墅圭爹軌勢熱痛麥究多宛夷夕丈九哮鐵
袞	袁兗衷褒六哀旅遠呱裳園兌釦迎滾鋁冥昂衣脫逞舐砥悅猿銳抑仰
筏	符八閥伐篌篠答今麼箋簽籤籥矜伏代念岑含令袱鈐傖踐俟吟伶扒叭
遷	這粟韆迺腰逗纖亞覆賈要慄奄價千迪逼遛遝袖溧近還
駒	馳馬駐駟駛駢馱馭駁駭騙駝駱騎驗駙馴驅騁駿騷騵驃騾驕驍驛驟驢驥
颳	颼颱颶颺蛞活括恬話聒風颯楓舌瘋嵐闊甜舐舔刮諷飄
瞌	磕溘嗑豔蓋闔盍睦濫尷檻襤鑑盞瞄睬艦藍籃瞞瞧睛睜塭眸眩睢目監瞿
慈	葬藥惹芯鄉茹蕙忍蕊孳樂萄茲玄關幽蔥苓蘊弋惠怠莊幾滋蓄苔莽畿磁
審	蕃墦播潘幡番繙蟠嬸瀋稞鞦痿萎禾莠秦穌鍬啾愀揪逶倭
簸	箕菠祺琪棋淇麒鈹其皮疲詖欺期被破玻波陂披彼坡
鄹	聚耶邱那鄴鄭鄧鄱鄙鄘郾部都郡郢郊郎鬱郃邵祁邢邦驟
票	漂鰾碳縹宗飄剽標禁祭嫖三示瓢膘奈驃祟鏢禦瞟
闆	問閭闡橾操閑間閒悶閃閂奩門樞嶇嫗嘔闌閱閨閩聞閘閔閏開閎閉閤櫚
篦	媲崑鹿罷錕琨焜棍混餛皆楷揩偕陛琵階毗比毚昆庇屁諧枇沘批妣仳
輔	軸博捕敷莆軏軌哺蒲搏補轟甫軔軋鋪圃輊膊車脯軟軾匍浦埔軒
悖	脖荸孛浮悸俘孚勃肺慎沛渤芾惇嗦酵嚏子厚享字學
顏	頻穎顧顆頂願顛頃頹頒題頓頡頤頌頭顯頰顥彥諺碩頊頫領額煩須頷頗類頜
鯀	縣係孫鰍鯉鮪鮭魷鮫鮑鱷鯨鯧鰓鯽鯛鯖鰭鰥鰾鰻鱔鱗鱖鱸鰱遜蓀
佚	跌迭秩軼件失伕俄牧伯作任仟傀夫牛侏俾佾入
痙	莖氫逕涇經徑輕奈痘誇陘勁左頸災姦巡痞三巢淄錙
讓	諒諄嚷誶訃謎鑲瓖攘孃壤識諳譴釀禳譟諦詰謫該詨註訪
缸	缽肛槓釭江扛缶缺罈紅虹訌罐工築佐槓鴻汞攻功淘掏啕搖遙榣萄
闈	葦圍韓違幃偉緯拿韋閑閉閤闌閏開問閂門嫻闋閻闔關閣闡闆閭閨閩聞
疊	壘儡且疽胃宜誼沮姐咀勗鋤粗組蛆砠祖租俎狙阻助
蓿	縮宿萱蓉莞薴菅佰葵荼荃蔡蕙荸氨著苦芾芰荷百丘暄幹渲喧
試	請詩訏謀詢誧詼談託謂認誼拭誠訟討詮計識詛諮詠訐訕詰誡詆訑詫式諜誌
缽	缺缶缸罈罐淘掏啕搖遙榣萄陶偉瑤笨苯違韓本圍葦
啁	碉惆週凋稠調綢蜩鯛周裯臺肚雕吉胡咀彫娟捐涓噯檯硼膨薹
臂	檗擘壁劈璧襞譬蘗闢薜癖避僻闢霹辜薛辛莘宰芾鋅梓
燻	薰醺燃造浩衽妊任壬呈少皓廷燠樵糕憔嘿熄誥酷煌淡啖飪炸炒聖窖望
懇	娘貍霾願墾貓豺貂貊懲狠篁怕狼忘忿慇豹解恨貌忽貉艮
饜	魘壓靨食厭餐養癢瘡良飧饗餮琅狼浪娘痕倉奭饕艮百餒
皮	陂破板皰彼玻菠疲皺跛被詖披鈹皴波坡簸格頗 
仄	雁丙一巫二人欠病筮三蒙柄炳準元雲厄示閃厥仁囚八冷
喀	擱落露咯客雒各咚略路格烙珞胳鉻恪洛嚀閣喧絡詻賂唆噴骼吭吸額反
鎊	膀榜滂傍磅謗螃徬旁肪楞愣方枋妨坊仿鏃攏嚨朧龐寵籠芳房
鵲	鴣鷓鵠鵝島鵑鳩鴒鶴鳶鶉鳥鴉鴦鷂鴨鴆鶯鴿鵡鷗鷹鳴鵪鸛
吧	邑把杷肥浥巴芭疤笆扈耙邕爬靶爸唱滬色琶梔葩
忍	急忠思藍慰芯愚籃蕙認忌代檻感濫弋仞惠監襤涊尷鑑怎式志刃
洹	渲喧暄萱垣桓晅宣奭汪汗汙江汀渣百河酒沍源沅湯旦
浚	峻唆梭俊竣酸駿痠淺洛鈑治渡滲蔆凌沒沆鉻鋒販波汲反菱
睏	梱睬目捆瞄眶綑睞睢眼相眇盹盯睜瞳困瞇瞿睫睥睨睹眠睡盼瞋瞭睛睦
省	眉算篡看苜冒眷纂渺緲盲劣督瞥自目相眇湄媚楣
拮	桔持周吉結撓黠擡掛牡捂招浩造嘻扣圯擷告售
老	耄耋佬姥丈杖仗者宏忝宥恩考孝慕協怒添渚帶屠奢堵著煮楮暑嗯箸褚
閭	櫚莒宮問鋁侶闆呂闡閱閑間閒悶閉閃閂門閡閨閩聞閘闌開閔閏閎闊閣
溧	慄腰遷慄價粟要賈覆袖江樑裸油溜湮湍涯淹潭澴沅洩沸沂汙淋淅韆梱
驃	鰾鏢縹膘標漂嫖瞟騵騾駁馬騷驍驛驗騎騁駱驢驥駝驪駢駐駟駛駒馳馱
浩	造皓誥酷窖告淫呈洛燻衽洗妊任壬沼廷薰桔涪拮逞渦沿治醺飪望聖吉
躍	櫂羿僇襖擢沃廖穋妖褶翟嘐蹋寥膠耀曜謬繆濯遢夭摺翰 
釉	乎柚悉呼釋鈾袖迪油抽岫妯笛軸宙釆竊鼬蟋由
羞	扭羋羊差醜鈕忸妞羚庠紐烊洋咩佯羯羶祥翔搓嵯嗟鮮
陷	防陞陪阪掐諂隙弔陸閻降阿阮滔除隆陴稻焰樁陀阬餡啗隍陽阡
霎	雷霽霞霜零靈雩雨霪霆靄霰霄雲霹霧霓霑雹雪雯霏黴霖震霍
諭	論詮訖誨診喻逾偷訛褕譙瑜榆渝愉訥謂輸請蝓誰許訂
猶	酋猷奠猓狸狎狙狂狽狠狡狗狄犯猥狼狹狐猜猖狷獲獷
帕	迫鉑帷幫錦怕帖帛綿陌腺棉白柏帆粕巾幡拍泊伯舶 珀
呱	弧孤狐瓤瓠瓢瓜瓣菰吆以袁叭姒似袞咋哦吒嘰哀系
津	沁律洩泱毽洮沈肄筆肇洋健建沸汕油沖淵沐聿汁肆淦汝腱汨水鍵
究	穹空突痍簾窄窗窠夷九姨咦胰仇穿窒窈窮窘軌
北	邶兆此比叱化能仳妣批沘枇毗雌屁庇昆死牝匙佻姚挑洮桃紕逃匕它尼
褓	葆袱保澡噪燥躁堡藻滌條附爪複褕裕臨譟褒谷呆
硫	琉梳流疏毓識唷磊砧碎碳碗磅礫石砭堉硿磁碟磋碾磕幟磚熾磴礁職礦
搆	溝媾構遘購講拼苒摒稱鉼耕胼迸姘併屏攜駢阱並冉井
訂	詞訏訴訶訥訢評詢訣許託記訝詳打証詐誣丁叮訃討詁計詛訊盯訐訌註詠訕釘詬訑
佐	倚工惰隋槓肛扛江釭汞佈佑俺攻功缸巧紅虹貢築
璿	濬瓏睿斑璃琉玨琥玷玟班璩璨璜璋瓖瑤瑁琛玥
紊	絲累系素索紮紫絮繁繫緊紋糸喲縲濰細辮吝羅蘊文紗純紐納紂絆絃絀
賽	鋇貝隕慣寨臢潰債遺韻賡搴貧賸簣賁嘖損寶匱騫鑽賞寒圓漬塞實
片	版牌牒牘牖串亞川堊啞惡介圳患釧止斤弗工蟲北兆甽邶徘袖氬順罪蜇
鬢	鬃髻髡鬍髯髦鬚鬆髭鬣髮繽臏殯檳濱嬪儐賓箄
棺	棕菅倌搾檳檸刮耜梡官枝管枯琯杖綰榕糊橾棲楛館
赴	走起越趙趟超趕趣趁趨陡徒僕卦躋躂趾進跤坑偯伉壕卞
剮	咼媧禍鍋渦
琴	零泠王玳班琵拎琶蛉捻吟玨玲矜瑜斑枉苓鈴唸鈐瑟黔岑冷狂伶今
鏈	漣軸陣渾軏運軌軍輝庫揮葷暈鰱轟褲輦輩攆載蓮軋連車軟暉琿軒
難	準雕帷歎艱離碓唯雄維攤雉坐睢淮堆癱稚舊惟椎嘆錐漢灘雊推雜雖進
諫	訣討課誚詖訏訑訕計訃誰詳誅詢註評詁詛詐訥許記託訐訊訂諱謂談詼
蓬	芟菱亢炕返峯菠抗篷蜂冬葭縫反鋒蓮芳伉沆坑阬杭吭落逢
槳	牀寸博藥蔣森獎爍將鏘傅樂搏辱漿醬鑠樑廂林琳溥膊縛栽村採肘霖膝
嶙	粼磷麟鱗
盪	燙盟盃扁盂湯盥監盜盛盔益盍盅孟珊盤盎盈蕩盆血洫柵姍
弊	短幣鱉撤疾敵氅銷屑敗澈矢蔽敞散矣撇斃廠瞥憋藪撒梢瘩肖尚彆宵敝莽
匾	騙扁偏遍篇褊盛翩肩編蝙匠冊乍皿戶盆籃匝血刀屜笮怎昨柵柞炸盅咋
咎	晷各偺咯客反恪洛格烙胳略鉻冬閣咚板返扳珞鈑路
灰	傑碳熬偽火詼疢大煞爻疝撚瘠狄炙炭恢痰左炎有盔然燃
時	待寸詩守博狩恃寺褥痔撙持奪將傅過搏耨峙襯曉傳等討特樽溥遵對塒膊侍磚村付封
邕	扈災浥巢邑吧巡淄錙姦葩巴梔絕惱腦瑙緇輜繅獵邋臘蠟
表	婊錶素青畏嗉長生拓差打佞辱害倩清情偎菁晴喂煨
珍	王玳彬珪班玫栓玖趁穆銓診玨玲瑰瑜諺斑澎璀琨疹膨佺拴珀
浦	溥捕埔哺脯補鋪圃莆匍蒲輔誧博傅搏膊甫沛縛賻
翰	瀚蹋遢煽榻塌嗡蓊翁僇羿褶濯擢櫂曜摺躍翼翟習翌
擘	檗臂壁劈璧襞譬蘗闢薜癖避僻闢霹辜薛辛莘宰鋅梓啦
褥	耨辱將遵磚樽潯撙傳特時狩持恃待峙侍附畏縛轉膊詩蹲溥搏博傅榭咐
京	哨吵咪晾涼亭啖佔烹驚掠鯨亳毫豪膏憬亮高景逞襄諒享亨
氟	佛氣氧氤氖氬沸拂怫氯氨氮氦氳氛弗彿紼氫邱
你	仔俏仍俑佃們伋侯鮮爾您仙仕僕癬獼吃仇夥迄屹蘇伴像穌侈仲什乞妳休伐彌
蘑	磨嬤摩磊魔糜麼麾靡礬閤詹答言麻銅嘛訾苔莆筒朮蛤給減喊胴桐洞洽
紐	組約細絀絢繡糸維紗結紋糾紀級縲紆絆扭紂紼絰納絲醜鈕紲純
紉	絲紹絕紀縲約紂紗細仞紛糸紆糾紡紋純紐納紙絆絀組紲紱絢絰維繡絃
羶	擅檀澶壇羋羊差羯羚羞搓嵯嗟氈翔磋掠抗鮮顫祥烊洋咩佯撲蓑庠
飲	飭餞飴餃餚餉飯餌欠飪蝕餓坎飼炊餡餅吹餽飽飾餒餘飢飩歡
堆	準隹雕帷住離碓唯雄維雉睢淮稚惟椎錐崔雊推雜進
搬	瘢鍛緞澱燬般廄發投槃盤磐轂殷段股抗疫芟毀殿殼撥穀役慇擊
巧	功朽項工攻汞兮圬污誇貢扛江槓肛釭粵佐娉虧
映	匝瑛泱盎吊央錦殃鞅鴦怏帛綿棉秧英巾晞明然布
螞	碼瑪媽嗎馮蟲篤罵闖駑駕驚蚱蚌騷蟲騖蛹蛾馱蛙蛔蛐蛀蚶蛄蛆蚯蚪蚊
差	羋羊嵯搓嗟磋羞蹉庠烊咩洋佯菁羶祥羚翔靖羯鮮
初	叨賴刀分切沼招迢炤昭忿券岔召貂解盆拐汾枴扮吩份紹詔超絕韶瀨懶
英	映泱怏秧瑛鞅央殃盎席滿鴦蓆瞞萬蕭巾蹣懣蒂
搜	嫂託扒抑抓叟插瘦播投浙艘捩臼颼抵遝餿臾拍折撬
攻	功工政汞巧孜項貢槓肛扛江釭收枚玫畋致敘敕敔敢數佐
怔	症徵証歪正整政焉止扯址嫣遣武肯芷企歧恆祉啃逃步
巷	共恭基僎撰潠選益巽巳圯祀異拱哄洪烘供起斯港
莽	犬畎吠伏蟒苔葬蔗器臭哭突戾猷獻蓆茂狀默獸
佺	拴栓銓荃痊倫偷詮儈儉全傷伶侮傖班斑玲珍瑜玨王
癌	巳品圯喬巽巷吝吞君癡右噪知祀咆佑器嘗痞各區奩包燥澡選潠撰僎起
橘	譎茅矛栘矜霧務夥移杼懋桶多侈楣棚予爹橙樣簷楹櫓猾揉桅抒妤榔梃
寸	守恃寺專痔尉持符射忖過辱咐峙襯等討吋對侍時府村付肘尊封
匆	勿囫吻忽易必鬼刎物惚惕愧錫麼泌剔射傀塊鉍槐蒐蜴賜踢魄
評	訐訏砰訂証詁詛訶訝許訌訕訊誣誚訃計註詞詐訴詳話誅詢詬訣訥訢記
姐	咀沮且宜疽狙阻俎砠祖租粗組姍蛆媛詛齟鋤勗
弛	悚施迆也馳忖弘池地她柒拖快他迤牠引悶訑弓
疥	界芥尬介疾串佛仲患爻癡疙痊奮疢病疝疚奄灰有布左疹希瘉奪瘡癒夾
蟾	瞻膽簷澹擔譫贍簷蟲蜢蛤蚓蠔蝠蝸蜻蚣蛹蜓蟲詹
忖	吋村付肘恃寸寺守封射尉對快紂悚辱專尊耐討也
萄	淘掏啕陶搖遙榣缶瑤缽缺謠蕊芯缸罈萃罄罌遂佗罐
吾	違葦本寤圍梧齬語悟五鼯於捂韋晤圄伍敔偉唔
述	怵朮術麻摩迨嘛率戎穴麼磨糜魔弒遮嬤邃穹空棄充麾蘑
瀰	彌爾邇璽漲泓沒溺消燃渙甭盃淌泱澳漁滅湧澦弼涎淑削敞硝涵敝湧汲
諺	詣詔詼諂談諉謂謎誥顏診諳謗讓彥訟訃訪識謫謝該諄註詰詨誶誡詫諒誌諦
藕	耦癘邁藉愚寓禺遇偶隅萬籍躉厲柙耒藩蘿英芙薯蕃夢蒂菁席禹耨滿揀
塒	時寺封峙恃持侍等痔對特坦場堤捏涅待奪垠塌詩寸書
七	缶它十山佗沱軋缺啕掏淘缽萄搖榣遙陀缸陶瑤
惋	慎怡字悽悖外麥蜿宛弘碗舛憾殯婉栘夕腕剜侈憐屍怨苑汐忪死豌多憤
沮	組俎滇砠湲姐且疽齟鋤詛狙蛆祖租阻粗洞宜勗咀
愣	楞遝澴還傍徬滂榜膀磅螃環鎊鰥防蔑寰篾謗儸囉玀邏鑼彷方罩夢甍爵
渺	緲眇督省湘沙莎測濺相湄苜冒瞽瞠懼目眷算眉看盲篡纂
麵	偭湎麴麩緬靨面靦麥乾侈外夕多領弱俑矽舛汐弘銘夥傑移栘溺篛舞夤
募	荔慕漠墓努茄昔膜糢摹蕞莫摸萌模寞痂幕暮驀晞蔓葛
耄	尾老耋麾氅耗撬橇髦毛姥佬氈娓毯毬毽牝性看牢毫密牛丈屘
臏	檳濱嬪儐殯繽鬢賓腕靛腔錠暄嫁貯渲棕喧傢脖淙梡佇肺肢
馳	馭騾驛驅駁馱駙媽駝嗎騎驗馬罵駟驢駱駒騵駭驥馴駛駢騙驕駐驃驍駿騷騁驟
賴	瀨懶癩籟初獺束分解貂迢炤昭沼招叨貧盆忿岔
柚	軸笛岫樓束胄聘冑婁迪妯鈾棣娉油由申鼬曳袖廟枕抽釉郵梗宙
檬	樺植矇橫構且朦糢樸湔棋模濛權樽械桐柑蒙菜柄楛槽
俘	孚字仔子酵李荸脖孛悖悸孳佾厚遊好偷學囝浮享
哀	遠迎京猿舐亭袁卞衰佔蓑砥呱衣轅袞亳毫豪亮高逞園褒稟襄衷享亨偯
褚	署楮渚堵諸睹箸著暑屠奢緒賭赭豬曙嘟者薯煮
匍	圃哺埔捕浦脯莆補鋪甫博傅搏溥膊輔誧葡蒲縛賻
蔬	疏菲芷苑止蔭蔣蓀霏薊菰薩莊肯企歲遣遺硫逃琉梳流扯址
廿	艾昔芯苗弁卉戒卅升井冊甘皿世立並曲共羊羋
滇	慎填鎮瞋縝闐真巔癲沛顛沮宜演汁濬淇浦酒沽沬濱直
儳	巉攙纔讒饞毚偕仳逸侃比毗枇妣批沘菟冤兔昆含屁庇
籀	霤留瘤榴遛溜卯茆鉚聊柳泖箝餾貿節笛笮劉卿
晉	參螂瑯縉厝廊朗鄉榔雲郎厚三響熾濺織芸箋乓二晶幽鹵良至蟲一淺棧
扇	翳栩翩翡翅翔翻翎翱翮翹羽煽羿翌習翟翁塌榻遢
啖	淡談炎痰毯燄京嘮氮嘿哨咪炒吵燃燻煦熒噹啾照
涮	刷測瀏洌前捌喇湔琍硎側惻倒咧蜊俐冽例沸匝
篷	扳亢板炕各鈑蓬皈返峯抗簇瘢蜂冬槃搬縫反鋒般伉沆坑筵阬杭吭骯逢航疼咚
貲	貸貨貴責柴員惻貫貢贊鋇資賈賃費賀買紫些狽
咱	洎鎳自臬噢癟嘎邊首省眉算咋吒叭道媚湄楣目戛憩篡
駱	洛馭絡烙路咯駁珞骼各馱恪賂胳馬驕鉻駿貉格略
危	詭厄呃扼弱桅杞記配忌己脆軛紀已卷妃氾卮犯跪
烤	尖勒熔火煤竈焚仗孝平炸者緒燒拷杖老宏銬煮災炎丈宥考炬協燃
與	舉歟譽嶼臼六舀臾身交滾裒滔潟鼠焰舂啗冥興輿商叟兒鉸滴摘嫡嘀舅
妹	味沬昧未魅姑妓宋姥朱嬸守寐侏好她如奸株銖婉嫁嬪女姦茱
櫛	節即卿棉杉柏唧鯽榴梔槐粕柞析檄柳橋橇楷彩格柢株柝板材印榭概彬
父	爸交斧釜爹爺姣咬校鉸大金究鈽狡郊效皎奕絞蛟傚跤較錡鮫
寫	瀉潟牢宅臼燄插舀審舂宮宵宋安它卉穴裒客臾身十滔焰啗
燸	濡懦嚅糯儒孺蠕需擂鐳灞壩蕾擾優煩而亙恆雷電耍耑
醇	釀醉淳惇諄酵酉醋酷酪酩醮醺酥酊醃酸醒醞醴釅酴醣醜酣酗配酌
銑	洗先銳鉑鍾窖銖鈑釩錘鎢鎳鑽壬岔鋰鉍錐鈔鈕鈍衽妊任鉻錦錕鏡瓚鉚
鹽	宦盥盈盞益盟藍盎臣籃扁盂艦盪皿盆盜檻盒濫盃盤盛監盍襤孟鹵盔尷盅鑑猛蓋
枰	秤抨坪砰杯評平萍桿枉不柯柄槓朽本林梗壞桓棕極標槭橄芣否示
藺	蘭閃躪舊蕉閥簡閤暹潤捫們籣癱籬門隹懼灘攤燜璀澗憫嫻摧僱僩匯催
悟	違葦敔怡寤圍梧齬恪吾語鼯五捂韋晤愷恰伍圄偉唔
鰓	鯉鰥鯧鰭鯨鯖鯛鰻鮪鮭鮑鰾鱔鱖鱸鮫魷鱷鰍鰱
疤	爸笆芭邑巴肥杷把吧痕耙琶疸爬靶疝奢色浥春爻葩扈者梔
閑	閉闌門間閒悶問閃閂嫻闈閔閏開閎閘閨聞欄閩閭闆朵閥蘭籣捫們瀾攔
弁	戒度庶庠席廣拚械廉蔗戈廿渡摭遮鍍臺卉戎牀棄蓆
妤	抒杼序野舒予澦預豫多侈栘墅妞好歿奴移夥瓦矛爹
額	頡碩頷頜顆頰頻頭頤頗頊顯頒頌頓煩須頃頂題顏類願顛頹穎顥顧頫顫
甌	歐瓶甄鷗毆瓷瓦甍甕區樞嶇嫗嘔奩軀驅品操噪橾鍔愕儼互夕器闆萼嚴
醜	釅醮酥酸醞酊酵醴醒醉醺醇配紐酴醣酩酗酉扭醋酪釀酷醃酣酬鈕酌
源	酒涉江湟願箔潛隙洹潦濱汀湯原汙河沍白汪騵潭沔泊涿泉湎鴻汗
弼	奭粥陌佰百剝貊厚門宿劊刑刊彌彊弓壽割剴創副剜剔劃劂釗剃劍剁到
誦	訥桶諛湧俑誧詢諂話誅涌詳蛹誣甬誰誠捅討訃計詛課訂訊痛譎詠註誚詬詨通
稼	科黍稔棕家程稿禾穢稱穋檳穩梡移稀積嫁傢稚穫穡稻穗稈嵇租穠秣秒
俸	捧棒奉揍湊榛樁臻輳泰春倩伕年秦奏舂降債偌俟侯絳佑佈挾人擎攀
囌	蘇穌嚥哎噶嘩囈吵啾嘈嗟鰍蕃萎菌莎穫繙磺噪噥嘻噎磁喋啗噗嘆咩哄
男	另脅力肋叻劣勇因努茄痂荔劫助伽咖協幼迦加
仍	奶扔氖秀乃作孕伋透莠仔仿你戶乍偏僱誘蹂乞
腐	寸守專寺鈉腑駙符忖俯咐附吋肉瘸侍府內村付肘吶
自	臬洎咱鎳目首眉省算戛湄媚道楣篡癟向苜看相冒狽筧奧嘎箱邊纂
擂	鐳蕾擾雷電儒懦濡嚅燸孺糯蠕灞青播優描揣晴掄情清倩壩菁
幌	帽晃幔胱光幟恍洸幅帕巾幛幃幢幡帷帳帖輝幀帆幗
玻	陂破板珞班玫皰彼玖菠疲玨皺跛瑰被斑詖琳披鈹玟皴波坡簸皮頗 珀
穆	彬諺診趁珍柏疹棉粕膨澎穋稽秒秩香錦穗稷稻穢稱稜腺煌遑嗥程稈湟
物	吻易囫牠惚勿牲忽牡牝惕錫刎牛牧牯拜牴特蜴賜踢匆看
打	捱酊扼汽拓擂搓汀振抨生鄞扛薴歹丁叮可仃訂差盯表釘青佇
滷	鹵鹹鹼澶濟注泣沾汴汶淺滴涉滲潼滋濾流漣淑濺鹽
禎	楨幀偵貞祉祖祀視祥祕祐祝祚祆祁社禳祺祿神祠祈祇禍締貝
癟	洎咱鎳崙自邊侖臬癒瘟瘉淪掄倫算瞼輪綸狽瘩痿痊瞿省眉首論睢狙
殊	蛛株珠硃侏死銖歹殉茱殃殖歿誅跦殆殘列殤殯朱
踹	喘端瑞湍揣惴蹦耑蹄踩蹉蹈蹣跎足而踱踴蹂踐踢踏踡蹊蹟跺跪跨蹲躇
亮	京亭享高亨毫豪亳烹膏充逞襄禿佔乩兒常哀兕吊圖允嘯選
圓	損隕賞韻員嘖匱實慣賁貝債漬潰貧賡磧遺賽賸簣臢鑽
潤	澗閏湟瀾閂煌遑惶汪斑班開憫嫻燜僩銓隍栓拴佺捫們玨篁藺
仲	攸候條介佛伸脩人倏中夥伐休佃仕仙沖僕什引佻川修絛鯈芥界疥
介	拂芥患佻而攸亞脩釧疥階條價事川沸訓圳佛姬甽界伸尬袖仲候片弗怫人串
檠	擎驚警敬啟故痳做矢敔咻枚槃集疾某矣呆蔽藪橄撒嗷矮散唉畋知
朧	攏矓嚨瓏隴龐寵籠龍膀壟鎊榜滂傍聾龔螃磅徬襲旁
懼	憔隹雌督僱暹相罹匯催目苜睢瞧惻冒瞼具藺惟雛篡璀崔攫渺瞿摧算籬俱眷
檔	嫦黨膛擋螳掌償讜儅幅棠瞠稍當鐺鏜襠儻梢堂尚噹福
箄	痺裨脾婢埤啤俾碑睥陴卑鼙顰牌箠衫杉彩彥形彤
撓	澆捱橈嬈珪繞持蹺掛圭曉僥饒拮燒堯蟯驍鐃
譟	誤詰噪誥詔譆謀諜諮諾謂讓談諉諍諄諒誌語誡詩詼詻訟課詁訣訑訏討
癸	葵揆闋睽登久昊灸凳天飛澄嶝燈橙疚發炊坎吹欽瞪磴
渭	喟泗泅胃漯涓謂浬涸膚清溫滑潸胄冑澴瀘渾湲深淨淄淫滔溪腮浮潘澤
檗	擘臂壁劈璧襞譬蘗闢薜癖避僻闢霹辜薛辛辣梓
燧	隧遂焙炫炕煜萄燉鰱送逆迸熾爐黯立芯縫撻煆道惟粒烊烘炊泣拉垃灼
逛	誑逖狂斑遑班玨湟惶煌痊筐篁漪隍栓拴銓佺潤韹眶框王荻凰荃
鉅	炬拒巨苣矩距分鋸局凹凸鏗忿岔釁鈿釦針釙侷汾扮吩份鑑鑷金渠盆芬
耐	而耍湍揣惴喘耑瑞端肘踹封射村尉忖吋付對辱
鶯	鷓鴣鵲鵝島鵑鳩鴃勞鶴榮鳶熒鶸螢鳥鴦營鴨鴆瑩縈鳴塋犖鵬鴻
踞	倨跼距躡鋸足踝跟跦蹕跚跑趺躋趴跆踫踵跤跋跌趾蹼踐踏踩跎躁踟
枉	杯弄玥槓王本琴班玫珊玖玨閏框旺匡斑柯枰琳全汪玷桿玟瑟皇狂柄杜栓珀
伸	樓屢甲簍暢呻坤摟婁砷嘍褸佛鏤由申紳仲介神
災	淄臘鬣繅錙火輜邋巡煤瑙焚獵痙涇惱莖巢姦燒烤炎邕腦蠟緇逕
勃	渤孛助肋脅觔劫勒勦叻幼協悖脖勇荸勉劾劻劬勘動勛功勤勣勳勵迦咖
峴	莧覓筧現規硯視蜆覜覬覦靦覲觀見覺窺攪比能
疫	芟股投段殷般殺役殼毀殿骰穀設毆毅疼瘋沒瘢
禧	嬉嘻僖譆社禱結喜禪禮福禍禳祥祐祀黠祗祕祠祖祝祚祆祁熹
即	唧節卿鯽叩櫛印卸卹卻卯既孵餌昂卵飼頤抑仰泖迎柳啣慨溉概腳鉚茆
束	剌悚敕速秉賴柚棣乘喇漱嫩嗽辣簌木中禿利枕瀨懶癩籟
霪	霑霆雨霰霜霾霖霍霄霹露霞霏霽霓雯雪霎雲霧靄霤震雩黴靈零
弱	鶸溺篛夙歹危殉死桅栘脆殆侯殘侈列孑夕多殊殃殖歿乳矽孜沍汐冰舛
梡	皖院莞棕檳寇完糉玩淙棺榕檸冠元沅稼頑崇宗
笮	篇乍戶炸柞昨咋妒作窄笑怎肩祚砟房蚱淚捩唳偏遍僱褊邀
媚	湄楣眉帽瑁算省自箱篡娩咱洎湘首目廂臬冒纂
慟	動種腫湩鍾董衝踵重懂筋鋤渤黝拗拋脅觔劻湧勝箄勞勗窈男
鉗	芋謀墟嵌甘某煤甜錘鉼鎂疳虛芣錯蚶噓柑媒箝酣坩錨
寶	實賁賽瓚臢鑽簣賞賡貧讚匱圓賸磧積遺潰嘖慣槓漬損債隕
筵	涎誕延庭梃挺霆艇廷篷隻雙冬反蜓怪奴處簸各疼皮及又腱毽鈑隆馭鍵
糊	咕糉葫精湖居糖瑚估鈷糙米姑苦鬍枯固沽料胡做蝴粗
悶	閔閒們闊闆閨門閏閩閘間燜開閂閑閎問閭捫閥聞闖閉闌閃
芷	企武扯址祉啃止趾肯歷歧歲步正遣芒症薺蔬焉怔逃涉賦
礬	磊禁閤詹答言焚婪椅桐蘑訾痘楚梵筒石礎銅減喊胴洞洽拾恫恰峒哈
澇	勞撈
毓	敏梳流疏硫琉嗨梅晦幟海熾悔堉唷侮織職識莓每
水	汁汝汕沐汨沖沁淦尿支汀氾汛汗汙池汐汪決汰沌沃汴汶沙沛沽沾沫法
症	政徵扯肯企懲址逃整遣啃狀証證祉歪嫣焉步芷左怔止武歧正
格	咯烙胳洛恪略鉻板珞絡賂路骼客詻貉酪駱閣咚各
髡	髦髮髯髭鬆鬍髻鬃鬢鬚鬣元須軏兀衫杉箄疹完彬彩虺彥顏阮沅形彤
釣	約怡金杓針趵勻釦妁釙勺鈞鉋灼鈿公鉍的昀豹芍鈍勾鉤均恭喲酌
黍	稚稔黎禾番香委秋秈和黏私季禿稍稞秣租秩祕漆稼科秒利穡
沁	沌池泌洩洵泡洶淘水柒泥心沐汨沖汝汕汁淦沙沛汪決汰沃汴汶注泣沽
褊	遍偏蝙編篇扁襤盛匾肩牖濫楹檻鑑籃盅錳僱隘溢溘溫慍尷媼塭嗑鎰猛
紜	縉經縲絲絰耘絃絨縹紆紅緻糸結給絹綏綜綵織纏細組紂約緬芸
鯉	鰓鮭鮪鱷鰥鮫鮑魷鯧鯛鯀鯨鯖鰭鰻鱔鰍鰱鰾鱖鱸鯽
許	訥誰計訣訐討訕訊託訏訑記註評詁詛詐詳話誅詢訂訃誣誧誚課諛訖詮
尢	疝尤尬尷拋疣山大疤就嵇魷巳已己兀丈屯太夭巴天又匕文力兇九尹七
題	頻顧顆頂願顛頃匙提頒頓頡頤頌頭顫顯頰顥碩頊頫頑領是煩須頷項堤頜
淋	漱渣痳彬棟森漆焚淅婪樑淞林沫材琳沐孱橾村楝梱決湘霖
醉	酒釅醮酥酸粹醞酵醴醒醺醇碎配瘁酴醣酩酗酉醋酪淬釀悴酷醃萃醜誶酬酣酌
彷	徬防往妨坊枋仿肪徙房很徊律徇徉徒芳彿彼徵紡舫徠徜循徹旁
彪	衫遞杉彤褫彩彰形影彥彫彭唬虎琥麝號箄密皆
溪	蹊奚湲滔渾深淨淫浮沉溴淚谿雞幼滑漯滋拗洞縈
勺	釣慷約怡心杓怯趵勻愧旬妁忖慵戈句甸鈞慘灼憾的昀芍勾怵均匍忪惦
躑	擲蹣蹼踫鄭躇蹉足躂踟跳跚蹲躪蹴蹤躋蹕踝跡跟跤跛跋距趾趺趴躊蹶
僕	卜偌異僎俗拱撲璞備樸補併谷供濮哄借共噗烘僅恭基洪蹼 佯
牧	牛枚牡畋啟玫放牠牲牯故改牝收敉敝敖敕敞敢散敬敵數矢失矣疾
酩	酪酷醋酌酊醣醜酉酵酸銘醇醉醃醒醞醱醮醴醺釀釅酥酣酗配
燼	儘盡盃遣遺潰燃腓排眺啡桃逃俳洮挑姚佻匪簣匱痱菲盔窕屝晁
五	吾伍唔圄悟捂晤梧於本語籲圩宇汙餘芋迂竽苯敔笨鼯齬
頊	頑頓頌煩項碩頃頡頜頂頻頭頤顆顧顯頒須頫頰題顛願顫
蚩	嗤蟲工虺缸釭肛汞槓江扛蚊蚪蚓蚤蚌蚣蚶蛄蛆蛀蚯蚱虹虻強蛙蛔蛐戕
帥	埠匝嫦幣簾啟帷吊啼怖錦師常阜帖帕帛帝棉篩帟啻佈鈽巾帑獅蹣滿布
伐	今伏代俟令含念筏偽傭俯人食倉閥付傀伶吟俊傖鈐踐袱戈岑貪
氦	閡核垓咳孩該賅駭骸氣氧氤氯氳氖氨氟氬氛氮劾刻
賑	脤振娠晨宸震賬貝賄賅貼敗財賦辰脣脣賭販賺賒賊賤貯貽則
刊	幹刑劃刖刈釗列判刪利刺到刮制剎削剌剋剜剝副割剴剩劃劂劍劊劑
磋	嗟搓嵯蹉磊硿詳咩磺砥差磁磴碰碘羣碾碳碟礦石
陪	陷倍隄防陞隕競賠焙漳隔隨噫弔陸幛接阮菩除暗培障隧僮陀阬部隘涪
杓	灼妁釣芍的枸約豹酌勾勺林怡勻村杜均樸昀札鈞槐喲木森
蔔	匐苟芯富逼荀苞芍福幅副葡菊葦石蝠輻茵茴苛苦若苗苯泵芣巖芋磊瘩
堅	腎緊賢豎宦臣服臥怪臧壑藏報候臨型壓鑒痣捌贓臟
愆	衍悶恐慫恣銜桁沅行汀惡您息怎急忝愈葬黎竺丁街術衡釘酊汽佇污扒
鞋	革鞘靶勒鞅鞠鞍靼鞣靴鞦韃韁韉蛙畦桂掛娃哇佳鞭韆
霹	癖薜避闢僻雪霞霖霑霎雨霰霪霜霏霆霽霍霄雯辯辦闢
咆	抱砲刨咄苞皰叱劬泡炮胞跑句匏鉋包巳袍鮑庖雹飽 
排	誹菲徘匪罪悲非靡挑俳輩斐徊屝痱啡靠霏裴腓扉
綿	終絡幫繙錦絹絳糸線締帛編總棉繳縲綵紙綏絲
睛	倩請猜精債蜻磧情菁睜積瞎睬清嘖晴鯖漬青靖
忙	罔虻芒盲丐心惇憧茫憶肓玄氓懷慌悼妄忘惘裊荒悴恨杗亡
捌	喇涮咧硎俐拐揖倒洌琍側惻測冽例蜊瀏叩鬥荊前莉痢
箇	錮涸個固古楛苦居舌鈷胡牯枯沽姑咕估罟葫毋湖故
濾	瀘慮爐擄臚鑪廬蘆膚墟噓唬驢鱸盧虜遽據噱琥瘧
峪	浴俗裕容豁谿谷鎔嶔溶榕熔卻欲蓉敗腳慾鉛鈉錐壑
泅	泗涸渭囚溫浬畋漯佃澴水界捆個梱油沁沐汨沖汝汕淮淦汁鈿泠汽洽海
娩	奴攙饞逸冕媚輓妣鏡菟好兔妤晚竟勉妳奶媳挽冤妞免境
塘	瑭搪糖醣唐埔城域班去埃塊垢坤坷怯法圻址均圯壙劃州康庸丟玉允土
掇	輟啜綴
汴	汶泣注沾濟犀屬卞滴淑涉滷沆流涼涪滾漓沁沖沐汨汝汕汁淦液淳淬滂
挪	邵哪梆邦耶嘟弔躑擲瑯椰鄰那廓郾郡爺榔槨琊綁螂廊邶娜
碌	砍綠斫砠礫錄碓研氯磯磴砟砝砰矽泵硝砂砧逮歌祿磊剝石
遨	埃熬撤橄嗷攸擻澈敖激倣竅撇放鼇繳邀撒檄傲傚做族贅聱嫩
梗	埂鞭杯樓槓橄哽粳朽柚柯枰枉由析便桿更硬柄甦
蝨	蟲蠡強蚤蠱蝕搔閩蛋蜜騷虺蜇蜃蟹螢融螫蠻蟲螻
盞	蓋藍籃闔溘嗑濫檻襤鑑箋監盍瞌磕尷侖皿冊棧淺錢艦
窄	搾搾窗窖笮空穹窮竊穿突簾窠究竅竄乍戶炸柞昨咋妒作
告	壬浩造吉窖靠皓呈售妊任衽逞誥酷程荏周薰丟廷拮桔淫糙燻
檐	詹瞻
飯	飭餞飴版餃餚板餉饉返餌飲反飪蝕餓飼餡餿餅餽飽餒飢飩
屎	米咪迷粱屑氣粥粟慰熨糜尉麋蔚乎籽敉料掬粒粗粕憐燐璘遴磷
躺	黨膛徜身窮擋掌倪檔常儅嚐趟棠當鐺躬鏜躲襠堂軀尚淌倘噹炯兒
找	拚擡挨摭拔捕搪拭摻撼擴我手戈扣伐撲弘俄扎峨娥哦
醺	酷醮酪醜酥醋酉釀燻醞醒醇醉醃酵酸酩酣酗配酌酊
峯	洛扳烙咯板鈑絳蓬返恪篷蜂烽降縫胳鋒夏逢鉻咚格略
逸	儳攙饞冕輓鏡溴菟嗅兔娩晚竟毚勉臭挽冤巉免境
袒	怛坦但靼晝疸查旦陽隄褐得暢焊桿湯捍悍暘銲旺昊旱
產	笙鏟星牲性姓生旌甦彥剷薩猩惺腥甥隆頻猜拜醒
涸	個錮箇固沽泗泅湖古渭楛活枯胡鈷姑咕估苦居
莠	透誘秀萎蕃莉乃悸扔奶仍痿審季孕菌馨秦氖痢蘇逶揪愀啾倭俐潘播墦
端	湍竭颯意而瑞耑揣耍竣耐顓立章竟踹站音惴妾靖童喘
伴	胖畔倦俏勝謄半蜷叛踡拌賸券卷夥圈絆判騰滕捲姅倘拳眷
蛆	蟲蚯蚶蜆蟲蛀蛄蚵蚱蚪蚌蚊蛙蛭蛔蛐虹虻蝸螟蜩
愎	扳復板夜憂伋各鈑覆皈返複恪冬晷反腹怪愉恰悔愴馥
綺	絡寄琦緯絹絳錡糸綻緩騎絨結奇給縞縲倚綵崎綰緝畸緹綏綸綜椅絲繚犄
蠡	蟲蝨蛋蚤蠱強蟹騷蝕搔螫蠻篆閩蜇蜃螢蜜融喙虺
銻	梯涕悌娣弟剃阡第銳鈕欽陴阪鉛陞陲釵郝隍降鍵弔
妳	妞好奴嫵娛婿你奶粥弩氮啖淡燄妤娩女姦煎始恢娟婉娼婷焰嫘漁嫻燃
然	燃撚疢灰痰煞炙央恢奧熬奐炎胰肱肋英傑爾煥映泱怏燠
布	希帑吊幣佈怖鈽巾匝簾帛帝帥唏晞烯帟啻幕刈稀
急	患忠心思恣慰芯您穩忍怒弭忌泥癮恩隱恿恕忘感惠悶怨忝聞恭息恥怎慝志恙
吝	文吞君紊抆汶右知各虔閔佑玟迦斕若癌紋蚊憫
碳	礁砲磋斫砠礫票詼研磴碾碗滅砥砌砰硝灰禁硫砂礦祭炭碟恢訕祟硿磊磺禦石
娣	悌涕梯銻弟剃阡第陴阪陞娜郝陲降隍婀弔娩姨郊姊妯郾妒妞妙妖妊防
隕	槓慣臢員潰債遺韻磧價賡賸簣嘖賁損匱蹟鑽賞圓漬
勳	壎動劫脅觔劻助肋叻幼黝男劣勵勦勤勛勸勒勘勉勃劾劬功協迦咖伽黑
黌	簧鱟橫學磺璜覺黃攪餚蕈廣淆崤薑冪夭髒朦餚膜
衝	街銜衍衢衛衡衙術桁慟種腫鍾湩董踵循行徵徨役
伺	侵叼倀合刁浸婦掃司虐彗佑倍儉祠雪慧信哈倔唔偉超遣歸伊侷倨嗣飼
魍	網惘輞罔魁鬼魅魑芒魎荒鋼魄瑰槐愧塊傀籃蒐監盞幾盍肓
稀	烯晞唏希幕鈽怖佈稱稻秒稍秧租利禾禿布稈程嵇稜稔移稿稼稽稷積穗
欲	卻吹砍歌慾欽歐歉炊歎坎溶榕熔鎔蓉軟欺畝飲歇欣玖次歟磴腳疚
肢	鼓取梂月最娶屐臏軍肺脖豉技山肝枝吱支朋妓腕腔受肚芰歧岐求
簽	儉臉檢撿答瞼殮險籥驗鹼閤洽拾恰哈合八拿篠篌筏斂劍碓鑰給蛤
巴	把吧邑杷肥芭疤笆色爸浥耙爬扈梔搗葩靶日曰山皁邕琶
甽	圳釧川順串遝澴還甲界罟罪寰彿環懷壞襪訓馴眾患買介罩夢罹
兜	徵鄉微昂迎抑禿仰懲兒癥衣允氏風笛袞筆衷袁亮媳嫂很徊徇律徉雍兕
兔	免冤勉菟逸娩挽冕晚輓臭竟嗅溴毚戛境儳鏡巉攙
隍	徨湟惶遑煌蝗韹凰篁皇陞階珀阡隆隙降陲陴旺阪斑班
寧	惆孚獰嚀密十恫耆檸孛亭悖惻愈蜜愉濘恥勃恐擰俞
澠	繩蠅鼇況泯涓浥泡汕澡潠濟淌淵涵淦活洶洸洎沽沾河沁沈沖沌汨沐汝
請	謂譎諍誼談論誌誡諭諼謀試詮詰詼謠訟誚詳詛謹訥訕訏訐計訂訃調
鰍	鰾秋鮭揪鯉鞦愀鯛鯧鮪鯀啾鰱鯨鰓鍬鱗鮑鱷魷鯖鯽穌鮫愁鰭
幣	弊彆瞥氅鱉斃布佈帑敞敝帝簾帛吊廠蔽希撇鈽怖
裯	雕彫週惆啁周蜩稠碉凋肚鯛綢巾盅吉調補裡袍帷衽帖圯兒桔拮膨川庸
翻	櫂瀚羿翔煽擢翩穋扇翎塌翹翱褶翅戳翳鄱嗡翮曜栩濯遢羽翼摺翡翰榻
棟	痳凍柙彬森欄東淋焚柬番婪棵林材琳楝村梱陳
庫	載轟軍輦連褲陣範車輩軋蓮暈葷軒軏軟軌揮渾軸暉運漣鏈囀
捷	睫豐抹拂捕扯撲找按技括攤抨押抓扶掉抖拷拽捉挾搪推庚抽折控妻挫
崤	餚爻崎淆洧侑髓宥囿希有晞烯唏稀駁賄鬱兇學
磐	槃盤磬磊般瘢搬碧巖疫芟設殷段股投磨穀骰毀殿殼拓役司
鞅	鞘勒映泱怏革英靶鞋秧鞠殃靼鞍鞣靴鞦鞭央韁韉韃韆
蘗	檗臂擘壁薜襞璧劈譬闢癖薛避僻莘闢辜霹辣孽葉菩菜棻茶辛梓
柱	蛀枋拄注樸梳主椒梓林楨杭柿核駐往校註杜棹枓住
若	惹匿偌艾右祐諾慝茄暱莢哎薦吝吞君荻落荔送知朕佑
璩	遽據噱琥豳邃逐斑豕豚墟豬玨劇班豢璨璿璋璃瓖琉玷玟豭瘧
銬	烤拷考針鈷鎮銨錠丈鉅賭鈣釙杖仗鎔鐵鉸銖鋅鋪鈸鈹鈿赭鋸鈑釵釦鎂
啻	帝啼蒂締蹄諦吊睿布匝常幣旁帟帛帑簾巾帥敵龍離獻
蛟	蟲蚊蛀蚪虻鉸餃校姣咬蟲蛙蛔蛐絞蚶蛄蛆蚱蚯皎蚌狡蚣蟑蟀蠔
汝	水娶女汕汁沁沐汨沖淦淄姦汙汗池汛汐汀沙氾沛汪決汰沌沃汴汶泣注
涿	啄塚琢塚浹汪沔汙汗汀湎酒源洹河沍江污愜尹
胭	姻咽茵胛嗯恩腮氤因朋腦囿男雷胰朕肱肚肋更囪月
猷	酋奠猶狀畎默吠獻伏莽突獸臭哭戾犬獎器醣袱酉
梂	球毬求救枝裘村支械棧寸戎林肢技岐妓吱芰梓棹棲棣楮株枯枰杵枓槐
疽	宜有且狙沮姐咀餚砠祖租粗俎阻勗組蛆鋤左亙詛助齟
弘	夕泓外汐舛強歹弓凡丸令名殘戈引汎汍伐找矽釩殆銘瓦矛予甬多宛桀
呀	訝芽蚜穿琊牙邪雅鴉撐籲辱叮唔喂褥呵呸哂哽啄啞耨才
饕	饗餮餐號飧癢食養良娘虎琥琅唬狼浪瘡蒼岑傖
摩	痲麻糜魔空麼蘑搾戎嘛述搴挖靡麾磨朮穹穴嬤舉怵控
城	坊妒埃作戶笮去蚱炸誠肩蝙茂乍成盛咋塘祚域昨戊怎埔柞
鄧	郃邢邱登澄嶝燈橙磴鄭鄴瞪蹬凳鄱鄰鄘鄞鄙鄗鄹郵郾部都郭郡郝郢郊
戡	湛甘辰諶農圬堪佞脤甚儂斟振芸勘棋脣宸膿箕娠淇濃其期晨始噥穠污
琺	斑班玨法玳溘王琳瑯瑚琅球理瑰瑭玥琉珪璀弄
擺	襬罷態熊擇能押批揩攪蜆比毗庇曙燭澤濁獨觸躅鐸鐲髑鉀柙胛呷紕枇
休	付咻茶榦條人仔他林保咐木府符夥伐仲佃仕仙沐僕什俯偉搽餘森集
躉	萬厲足蹣捉促癘躅躋躇邁蹄踐踏踩踝躪跟跚跆距趺趴
譴	謎訃讓諒諄誶誹訓註誕誑訛謫該詬詨詞証詁詛訶訪訢訐訌訕訏訂計譟
蛀	蟲蚪蚊虻蛟蛙蟲蛄蛆蚱蚯蚶蚌蛭蛔蛐蟀蟑蠔蚵蛛蛞蛾虹蠅蚣螃蚓蜩
寺	待寸詩守恃專痔持奪忖辱峙等吋特對塒侍時村付肘尊封 
崛	掘倔窟屈出咄拙茁妮怩呢嶇己已屆矚絀黜祟尼
獎	獸器蔣獻哭默槳畎將鏘狀漿醬棧吠伏戾突肘臭犬莽猷
慄	溧腰遷慄價粟要賈覆袖裸惴悟怫韆梱亞惡匐牒愣惰懦懷懵啞恆柚褸怔
禿	利禾秈秧委香番季莉痢秉私和秋俐秀兕黍乘科秒秣租祕琍稍稅稀嵇稚
趟	越趙徜趨俏躺趣趁起儅嚐陡儻徒尚赳超淌倘走趕赴
嗑	磕溘瞌蓋豔闔盍濫檻襤鑑砝盞尷藍籃塭監媼慍溫溢遍偏褊錳鎰艦怯法
洋	羊磋鮮搓詳樣咩徉羣氧祥羼烊差漢嗟嵯羋蹉庠洪羞佯
喟	渭謂喂胃哩咽呷膚嗯啃唷嘿冑胄娟捐涓噹嗶當
淳	惇諄醇涼濠享液沆沾淬哼漓澶浮孰郭敦槨墩燉廓亨
潠	撰僎選巽巷溢港洪圯瀑起鬨祀共巳戴糞涓浥烘拱泡供濮暴冀異基恭
曉	橈燒撓澆嬈僥鐃繞蟯蹺饒驍堯珪時圭捏涅翹畦桂掛娃哇卦佳塒閨奎
馬	馭騾驅駁馱駙媽駝嗎馳騎驗罵駟駱駒騵駭馴駛駢騙駐驍
嘆	漢攤灘癱歎艱難嚥噗哄咩哎嘈嗟噶嘶剴庚豆嗶嘯唯呻呷聽呎吹吶吐叫
拉	倍啦焙擠抆撲拄垃泣拈接撞菩暗培立粒位昱抖站笠音涪妾
氧	氣氤氟氳氖氨氮氦氯氬氛庠氫佯烊洋咩愾磋鮮
偷	喻儉瘉輸蝓癒逾褕諭儈渝倫瑜傷傖侮愈愉佺伶榆俞
握	渥喔齷屋至姪室致到窒摒掘絰蛭輊倒耋掃臻緻套
辦	薛僻辣宰滓癖鋅瓣霹梓辯蘇辜避莘辨闢薜辛辮協脅
鍾	腫湩董踵種慟重衝動懂銖錘鋰銑鉑鐘鍛鎢鈑釩鏈裡千
三	竺二些仁雲元示完言奈宗岸芸票誇祟祭雲禁禦嚴辰韭佞沅
蠅	蟲澠蛔蛄蟲繩蛻蛙蛐蛞蛀蚶蚵蛆蚱蚯蚊蚪蚌虻蟬蜈蝦
煮	諸署堵屠楮曙渚薯睹箸嘟者暑賭緒都藷躇褚儲奢著
帑	弩怒努布駑吳幣吊希怖佈娛鈽簾帛帟帝虞奴匝
鹵	鹹鹼滷朗鹽淺參迴畝棧晉郎畎箋錢幽圃國鄉衰茲廊遇盞瑯榔裹蓑踐濺
買	鋇貸貫賃貴賢眾贊員罟賈罩賀貨質貿費責貲置貢賣狽
腎	賢堅緊豎服宦臣臥臀臧有藏報候臨臟鑒前捌贓
系	絲累紊素索紮絮紫繫纂糸喲縲濰細緊繁羅蘊糾紂約紆紀係紗紋純紐納
苯	葦笨本茉圍缽偉違萊韋闈五幃緯韓葉杯枉桿苗芣芯昔芋吾艾薪廿伍
藩	瀋嬸潘落蕃藻蕩莎鄱蒞蒲菠萍茫範番蘇薄蔆莉審播墦稞
唷	堉硫育識梳啃流熾琉毓幟織職疏喟囑啼吭嗑嚎嘀嗨撤澈
廬	妒虜盞鱸墟唬爐擄戶慮臚虛顱瘧膚房鑪瀘驢濾噓盧蘆琥
孀	霜櫺雨霖霎霄漏霰霪霽瘺霑霍霓雲雯雪霹霾霞靈霏震黴零雩
褪	腿退艮堰偃銀根限恨垠痕艱跟眼狠很鼴隧隨褂襯川齦良罩
憧	倍陪潼焙漳垃憶噫鐘泣接億撞暗樟培拉位昱僮幢瞳臆笠喱涪黯童
浸	侵沒寢殷渥股殿投伺叼般液洛段掃婦設殼毀役漏骰毅毆穀候涎假煆瑕
爛	蘭攔澗鍊們櫚欄嫻煉柬簡揀燜閑籣憫僩捫斕潤瀾楝閉闌練
艙	傖鎗槍滄搶愴嗆船舟艦舷舵航舶舢瘡蒼艘艋舫舨
援	探捐暖湲助揮掙搖緩媛撚鍰鋤爰揆煖塚採胴諼天授勗
建	奴律夜毽沒肄肇筆健又津延廷聿怪肆桑隻候腱帑雙鍵
鯨	鰍魚鰾鱸鮭鮎晾鱔涼鯉鮮鯛鯧鮪鰱掠鰓鱗鮑鯖鱷鮫景鰭諒
沫	抹沐末茉秣決淋汁波枝枯杖渣漆淞湘沽沬沁沛汨沖洱汝汗汙汕汛池淦
關	藥闔門閻閤畜奚閩開閑間閒閎悶問閃閂玄閥茲吆
隆	降阪陵處猩烽峯鋒鏟版絡絳惺逢路賂蜂腥終略旌鉻胳珞烙格洛恪咯骼
淑	鴻漣督寂涼澈沾漓注椒泣菽流遊叔汶沆濟汴涪淤滴
鏜	膛螳瞠鐺堂銷襠檔擋噹儻嫦尚償當棠掌撐讜鎖逍梢消捎悄峭哨俏黨常
羋	羊差佯洋庠咩烊羞祥搓嵯嗟鮮芙羚羯羶徉氧翔羣達磋癬
免	昇攙虎侃楣饞眉逸冕媚輓兄鏡間菟兔晚娩竟毚昨勉息沉臭媳挽冤旭色湄境
胎	迨治擡怡始冶貽苔笞臺殆腑跆飴颱怠或胳域銘哉名
嘹	撩暸咯另咦唏潦啖叻唱顯了哎咖僚鐐療剎寮繚燎遼瞭
顆	頻穎頂果頃頹頒頓頡頤頌頭顫顯頰棵稞碩課頊頑煩須項頗類頜
羿	翌習翟翼翠翁蓊塌遢榻嗡煽摺翰褶濯擢櫂曜瀚
垮	雩捺琦圬堪佞萼朽匏挎虧巧胯瓠愕奈誇污鍔跨
吵	砂妙抄沙杪炒鈔眇咪哨紗啖少劣京省莎炸囌渺
拱	異巽拼寨暴撲鬨港撰搴供哄共寒烘恭塞基洪撕
聘	取軸笛岫聶聳圬耶聰朽餌聯娉鈾虧迪柚妯巧職油耽耳兮袖恥耿誇抽污騁茸宙
釧	圳訓馴川順釗串甽患介剌剎鈾彿鏽丫則袖鏤襪弗片
蟆	蟒蟲膜模漠摸糢蛐蚶蟲蟑謨蝶蟻蚣蚊寞螟蟠蝠蝸蝙蝗蜻蜢蜴蜈蜂蠣蛤
菁	靖晴清情倩睛猜精青蜻鯖請債漬嘖害責積磧差績蹟
婉	字妹姥嬪外麥蜿宛弘碗嫁舛姑殯妓妤夕栘腕剜侈屍惋苑妳汐死始豌嬸
膳	繕鱔善糕喜樣儀漾曦犧窯蟻議胼羹羔恙美姜膜朦對敬朕羲義羨岡
低	氐邸仁柢舐泜昏砥胝婚祇祗係牴仰抵紙但衹詆氏底
互	沍瓦彙碌錄畏剝瓶氯祿孑表長奴危好佞妞妳侯閂弱辱偎喂喙溺煨綠篆
苓	伶泠拎鈴零羚玲蛉聆冷齡令蒼岑茶莓昤侈吟鈐
恢	憔碳心尖淡怖詼愀疢惰啖煞爻懊撚瘠灰炭痰然燃憮
啡	排俳腓誹徘匪屝菲痱扉罪霏靡非靠悲斐遣裴輩
霞	霽霜零靈雨瑕霎霪蝦露霆霰霄假遐雲葭豭霹霧霑煆雯雪霏黴霖暇霍
詞	記詁詛詐訶詬訐訕訏計訂訃詔註評訴訪訣訥許訢詳誠話詢討訌訊託訑
揖	楫緝輯拐捐攝囁扣耳損戢捌聶撮恥耿弭洱取茸
選	潠撰僎巽巷起圯哄祀乩共巳糞戴烘洪拱供冀寒異基恭
賃	貨員贊貴貸責貫鋇狽資貲賀買費貿貢贅贗側賈賢質廁貝測惻濺
最	蕞撮娶取耳支陬叢趣聞茸昌芰恥耿弭昭洱枝肢吱妓岐技
湧	渙踴勇換喚煥筋瘓肋勞奐勝渤觔鋤勗脅飭務瓊觼拋拗懈邂力
師	埠霽啟雨吊阜霄漏哽倆佩瘺篩帥曇啞珮雯雪兩巾獅魎霖霍
濬	璿睿滂鎊榜膀啼傍滇謗螃諦蹄磅締滾漓徬港流攏嚨朧龐寵蒂籠籬
丘	乒乓嶽卸邱兵仁全合餘佰啣蚯人一伍佞何汽侖佺捨俞哈恰拾拴洽癸拿
氯	碌錄祿綠氬氧氦氤氣氟氖氨氳氮氫剝氛愾互邱汽
疝	尢疣尤大疤爻山疢灰有左疚餚嶽奄奎疾疳疽痕痍布汕札仙扎兒
下	卡斥丐正坼定拆是柝卜一焉沔怔症堤提鈣錠非政歪匙悲隄嫣
呢	妮怩屁尼能叱枇妣批毗沘仳昆庇沱佗跎比紕匕屍
怏	泱映秧英殃鞅央忱盎瑛鴦慵怖滯巾怫懊吊布匝然
鷗	鳴鵠鴿鴣鵑鷓鶴鶉鵲鵝鴨鴆鸛歐鳩毆鷂鵡鵪鴒甌鴉鷹鷺鴦鴛鳶
咋	砟唳妒作昨柞炸詐乍戶笮祚吒叭蚱肩怎窄偏捩淚遍僱褊邀呈篇
鸛	歡勸觀鶴鷹鳴鷗鷓鵲鵠鵑鴿鴨鴣鳩鷂鶉鵪鵝鴒鴆鴉鳶
帩	肖消梢銷捎悄哨稍硝峭俏鞘睄誚
哩	嘿埋娌浬俚裡鋰喱裡狸理咽呷鯉童黑貍喟嗶量墨黛
纖	組約縹紜繪紅繡糸維籤絨殲千糾讖給縲遷絃韭紆紂綸納綁紇絲繈懺
炮	抱砲刨苞皰劬泡胞跑匏咆鉋包灼巳袍鮑庖雹飽 
扒	叭託抓拍趴佾八扳折拆括搗插捶播據揪兮契筏
醬	酒醮酥醞酊酵獎醒醉醺醇槳配漿酴醣酩酗醫酉醋酪釀醃酷醜酣酬酌
壞	環囉罟址寰蓑坤懷圳澴培羅甽不壤坑蘿籮遝鑼儸壇邏賣遇堉壕還
鰱	鏈漣轟蓮鯨鮫運鯉連鰓鱸鰍鯽鮭鮪鰻鰥鰭鯧褲輝暉渾揮葷暈
團	傳磚轉專糰栽撙博樽遵狩府囀寸奪榭膊廚搏溥蔚傅等蕙褥痔穗符時特
倉	飴含養蒼飧艙食滄創搶代嗆傖槍伏白瘡今鎗伐愴
米	精繼粥咪迷屎糖籽粉糢斷粱糠糞乎粒眯粕糊料敉糟掬糕粗
區	叵器噪驅闆漚奩歐操囂軀毆嫗鷗臨甌嶇橾品嘔樞
閂	閏開門閃問閑間閒悶閉閔閎閘閨閩聞潤閭闌闆闐閥閤們捫
腴	萸庾諛臾舀滔稻肌蹈臼脾脈韜冗腫朋腺鵬豚肪肚臍焰淫啗胳胝潟股沉
戢	楫揖戟耳戰緝輯囁恥耿弭洱取茸耶找呎伐弘叨叼叩聆職惠聞栽哉居聶
夭	奏喫襖祆沃嬌大添妖楔笑舔契鍥劣僑湊喬忝橋躍竹吞揍
犀	屬墀遲汴囑矚卞屝匪屍排悲尿尾扉菲痱手腓啡逝俳適非叵匹
長	畏彗悵漲刁佞煨脹伺叼賬偎辱喂匡虐萇帳表張倀司
痔	等奪時持恃峙侍特寺待詩痣封對寸符府廚狩塒咐樹
首	道自省眉洎咱臬算目苜湄媚楣篡導鎳狽戛備筧纂
膜	模漠摸糢蟆寞謨冪莫朦朕暮摹慕墓錯措惜借臟幕募昔
暢	暘陽楊煬腸揚場鍚颺瘍申袒坤呻伸砷神傷紳殤湯隄得觴怛坦但豕婁
肓	罔芒虻盲育月脊姐望嬴背茫玄氓牽脣妄朋忙忘惘膊脯荒膂杗亡姍
剖	部刮割創剛釗副刪別刨劃刖刑刈劑蓓剌剋則削剎剴剩刻刷刺到制剁判
黃	薑簧橫璜磺芸蕈莖蕨黌蕾量葬會芣芋甘四票廣三華苛喱駟
叛	洛扳烙咯板阪鈑半皈返恪烽拌胳販伴絆判逢鉻疼咚客格略
戳	櫂羿準僇翻翔煽擢廖穋扇塌褶翁翅翟嘐寥膠耀戮嗡曜遢栩濯繆羽謬躍摺翰榻
功	攻工巧汞助項勤貢扛江槓肛勁釭脅叻肋劻勒勘佐
磕	嗑瞌溘豔砝蓋闔盍磊濫檻襤鑑盞尷藍籃磋碾蝙碟蜢磴礁謐塭硫礫礦艦
肅	嘯蕭簫鏽瀟淵姊繡中鬥齊束串聿臼甲由史弔巾丫忠沖仲引兒
剽	瓢飄票嫖漂標膘鏢劃副劊釗削判劃刖刑刊刈瞟縹鰾
蚜	蟲呀芽訝穿虹蚵蛭琊虻蚶蛆蚯蚱蝠蟲蚊蚪蚌蛀蛄蛙蛔蛛蛐蛞蛾蛻蜆螻
耀	櫂瀚羿僇煽擢廖穋塌褶翁翌翠翟習嘐寥膠蓊嗡曜繆謬濯遢翼躍摺翰 榻
元	院軏遠仁玩梡莞雲兀阮沅冠竺三皖示寇光二園完髡
詮	論諭診誨訖誑譙誰訛誌訥許詩詰詼試誡誥誼談請訟謀謂讖註詛訕訏訐
鑿	芟疫毀躬般殷段股投鍛穀骰殿殼役慇窮瘢發廄身燬澱毅毆躲搬設殺
瘩	褡搭塔郃癘答荼癢荃合荷頜鴿洽拾恰哈瘉閤痘痊拿疳
盛	盥盈遍褊益盟盎偏姍扁柵盂盪誠編蝙匾盜肩城成盃監盍孟盔盅篇
彈	釅器闡毋闆萼巖嬋禪戰蟬簞囂儼憚愕囊單殫襄鍔 
晁	窕桃逃挑洮姚佻眺跳兆北屝扉菲痱簣匱邶覜遣潰頫遺
據	墟唬豢擄居遽劇豬瘧豭邃揚濾璩噓豳豕噱琥逐豚
校	父餃跤狡六交樸郊較鉸效絞膠柱蛟鮫傚姣詨咬皎 枓
丞	拯亟蒸永二汗汙沅汪汀涯左旦閂三污泳極式空差竺一江仁河洹涇溼
啕	掏淘陶萄搖榣遙瑤謠缶缽缺缸罈佗罐罄罌喋跎咆午七恕怠感
阻	組俎限際砠姐且陲疽弔癮誼阿隱陌阱狙隅蛆祖沮租粗陳宜咀阡
燈	橙澄磴嶝瞪證蹬炊登愷澧皚禮壹揆醴體凳睽鄧葵
砭	眨泛貶乏磊磴砟砍歌之砥硃斫碑芝硫礁礎礫砝砂矽碓石
短	痘脰逗登豈豐仃豎知矢矮豆矯雉矩凳愷倚磋澄嶝燈橙豉畋枚壹盒癡疾
牀	栽樑樂廂戈藥木樑爍鑠戒宋呆戎杲採弁臺專槳森林
法	溘怯琺去砝嗑蓋劫瞌磕丟玉盍闔濤豔注沁汪汰汨沐沖浬汝汕汐淮淦汁
版	洛扳烙路咯板阪珞飯牘鈑皈返舨恪叛蜂降反牒胳隆販牖牌逢鉻片咚格略
寄	崎倚椅畸錡犄琦綺奇騎荷可婀啊苛柯坷呵河何
鑄	檮鏗錄錢弱贖鐵壽禱雲躊崁疇鈴坎濤儔籌蟯燾堠基鐃銘
鎰	溢縊隘益錳鑑盆賽檻濫襤褊遍溘溫慍媼塭嗑港偏烘洪拱哄供鋼藍蓋異
罹	羅眾罟罰罪罩買惟羈罵置患憔蘿寰籮澴還遝懼儸囉邏鑼
教	敦枚敉哮敘孝敕敢故敝啟敖救敞散效敬畋牧玫改敵數孜收墩燉疾癡
牲	性姓笙星產拜甦生牴物牡牝猩惺腥鏟牛牯牧牠甥旌
擊	繫段投疫芟鍛殿殼殷般股轂穀緞骰搬毀殺役慇瘢廄發澱毅毆設沒
鏘	蔣將寐莊戕寢寤狀妝壯漿槳肘牆獎醬姚釭鐳鑠貴肯
婀	啊阿崎倚椅畸錡寄荷犄琦綺可郾柯坷呵河何騎苛奇
玄	吆藥玆似礫麼以爍炫樂機鑠茲弦奚關眩嘰畜絃鉉幻拗舷蓄亡姒
典	腆碘苜菜罕散共前探深賁萵蒙撒籐金廿月脫莧湔琛菔煎葷噴墳憤箭濛
巳	圯巽包祀巷癌叱乩咄庖抱咆泡炮胞苞起袍鉋熙僎撰潠選
莢	荔芙芥愜惹疾芯茄昔苗艾芝萸頰陝若哎萊狹峽挾英薦夾荻浹萃茵俠著
瑟	密王琴珪班琵玩琶理玨必瑰斑鉍枉頊蜜琊琢泌狂祕謐珀
唁	這信警誓譬譽訃言諒哼諄誶嚎嚷讓訕計謎唔詔吭詰誥譟
沘	批妣枇仳毗紕庇屁昆比能沱砌牝叱化混皁尼它
姍	盥益盟媼盎珊姐扁柵盂皿盜跚盃盛監盍冊孟盔盅
實	慣賁貫賽寶圓賡賞貧簣損匱貝嘖漬債價潰隕遺賸臢鑽
枓	科料斜抖樸斗魁柱蚪梓斛棹斟蝌枋柿校林核楨杭梳斡樟椒
咿	伊咻咐喉尹君哈吟吃裙啣啄吶唯唸喻嗆噙窘咖伺儉
瓜	吆瓤似懸以樂菰瓣抓呱弧玄孤係瓠幻狐瓢系姒縣
香	稈禾委番杳秋秈和私季禿曆秀黍科秒秣租祕利稍稚稞
矓	朧攏嚨瓏隴籠龐寵龍瞇膀壟鎊磅榜滂傍眩聾襲龔
餃	飭餞飴餚餉飯跤狡饉交郊餌效飲絞膠飪蝕餓飼餿校餅餽飽餒咬飢飩 
似	姒以吆玄拗爍鑠瓜奚畜茲藥絛黝呱弧係幻俟嘰機璣礫窈麼樂關
貂	貉貓豺貊豹貍迢炤昭沼招超詔紹韶解切召叨霾
拓	磊拾石巖司打泵害抨矽砂研砍扣扛砧砝砠砟硝碓歌恰洽哈搭瞎撿割硼
蔗	遮摭蓆庶苔莽戒弁蕪械拚度薦茂廣盞席莆庠芝誡鍍渡鷓
順	劓州劉釗刈釧爪川中訓圳裕褸甽刷彿沖頑馴領引煩袖刖仲須頁劃剃弗兒剌串襪
蕭	簫瀟肅嘯鏽繡英燕革薺苗芯昔艾藪荊蓆席廿滿淵姊
粳	梗硬埂哽便更甦粗敉鞭粒粕糖料糠籽糯米精糢糟糧糞
劑	刊釗利剌制割劊劍劂剛刈擠削剖齊創剔剷副剴判濟剜刪刖剎剩劃刺躋刻刑
圳	釧川訓馴順串甽介患剌坤彿壞到袖襪弗片州劓佛怫拂沸姬褸環而亞事
愍	悠民怒抿岷泯恩忝忘湣眠氓慇矢敬嫉嗯數啟啕唉故收
薄	藩博莆蔣範蒲菠茫傅蒞搏蕩莎賻萍溥藻簿膊縛礴浦
崖	捱王褂豈涯珪卦娃閨奎哇掛巖圭佳窪畦桂蛙堯炭岸封
顓	頤顆頻頭頜頡碩頓頊頌頑顯煩項頃頂題類願顛頸頷頰頹穎頫顧顥頗領
疇	檮鑄弱黠圉壽禱雲埋畦壘躊崁黷坎濤儔籌蟯墅野燾園堠裡
穗	蕙惠稼稔稈私禾穢稻稱鐵傳程嵇移秒祕秣秤秋科秈和番香委
不	環碳杯宗票甭坪爾滅胚抨壞歪平枰芣禁祭炭盃呸否示奈祟丕痞禦
豪	高亭膏亳嚎毫濠壕京亮享亨烹蠔蒿嵩篙槁搞婷逞停鎬
弋	式代拭忍惠鳶岱玳貳心戈庖涊軾蕙弒試膩怠殉袋貸愚慈感慰穗黛
啜	輟喀奴哼咯咦嚕唆喚姨綴殼沒友股吸吼假胰遐哮咚投仇煆啗桑掇吹旭暇
兒	倪睨霓身躬臼躲窮躺息舀軀臾先兄侃虎沉臭啗舂焰媳滔裒熄潟
喻	瘉輸蝓癒逾褕諭吟渝噙倫瑜吃哈愈偷唸愉榆俞
丟	去壬任呈告妊怯法衽玉等劫廷浩盍砝荏淫逞造燻薰
恣	姿諮資瓷懿次茨諮慾嵌恐久丁勻急惑悶惠疚感愆忍灸慼慫欠應之準釘
嵌	漱嗽甘煤甜簌嶝疳虛撳嶔次崁蚶羨闕鉗久掀柑媒茨坩柩欺
釐	犛量喱鐘潼撞憧僮短俚枚會黑霾裡瞳鋰纏幢裡理狸浬敉娌埋哩仃
鱖	獗蹶蕨鰾鱷鱔鰓鯧鯖鱗鰻鰭鰥鯛鯨鱸鯉鮪鮭鮑魷
亭	高豪亳膏毫停婷京享亨亮俞烹寧嚎嵩蒿篙逞搞槁壕濠鎬
噢	懊澳燠襖奧喚咱喫向嘎咯哎筋嘮嗅嗥煥換渙唳咚咋吒叭制瘓呈
燙	盪湯蕩狄熊照炎旦煬源渣淡汨願煦煮烈原疢炙傑昊旱釆灰乒荻瘍賓氮
喉	堠猴篌侯吃咻咿咐喻唸哈吟啣吼嗆噙唯吶跪訖儉天夜
放	族倣於邀敷旖方施旅旋旌旎敖旗嗾激檄鏃簇枋肪妨坊仿淤繳房芳菸瘀
公	錢忪鬆鍍金鈸鋪戈賤麼突崧翁蚣淞釣貽賊鐮分乓箋勾勺弘伐找針釙淺
凳	豐短痘豈脰逗凱嶝橙磴癸拿證灸蹬鄧盒久澄合瞪燈登 
段	芟殺穀鍛骰殿殼沒股殷緞斷擊役投毀設般毆毅疫
橋	奏矯犒蒿祆稿沃嬌鎬添妖嵩轎笑吞舔搞縞僑篙喬槁驕 
酣	醋酉酥酗配酌酴酊醜醣醴酩酷醒醞醮醺酪酵酸醇醉醃釀釅酬
岐	鼓取救岫梂崇最球娶屐崆豉技撮山翅蕞枝吱肢毬支妓峭嶄芰歧求
志	恙痣地應土均圭心忠吉芯思忘忍忌忝寺急怎恕恭恩息患悶惠感沁筠誌
頗	類煩頻頂頃顆皮領碩頑頓頊頒頌預頡頜項須頰頷頭頹頤穎額皰願顧顯
挫	夫隹雁難擭唯撫攤雉坐催扶仕撿淮堆癱惟拾椎座錐拖灘挾推摧銼拴進
擎	俸啟疾嗷警唉擻矢蔽敬捧擊散矣撇驚故畋挨儆藪撒檠做知枚敔奉
樓	髏柙屢螻數簍僂呻坤摟婁縷屨砷棣嘍柚褸鏤申伸棲釉蔞梗神
蔣	鏘莊將寐寢寤戕狀妝壯薄漿槳獎牆肘蔚菲茲茹醬菜
督	盲懼看寂相眉椒菽目苜瞥冒省叔淑篡渺算瞽眷
僎	撰潠選巽起巷供圯哄祀共巳戴糞保侃僕烘拱洪冀基異恭
另	叻咖男脅力肋劣勇茄痂加伽迦努荔幼劫助劬協
爐	妒虜鱸廬墟唬擄焙戶慮遽號臚虛顱瘧膚房鑪瀘驢濾璩噓據盧蘆琥噱
菅	管棺倌琯綰官館蓉苦耜莞萱蓿薴葫楛荸蕙萋芰芾刮
擢	櫂瀚羿僇煽廖穋塌褶翁翌翠翟習嘐寥膠耀蓊嗡曜繆謬濯遢翼躍摺翰 榻
隴	攏嚨朧瓏矓龐寵籠龍隧隨防徬壟鎊螃磅膀榜滂傍陪阬襲聾龔
揭	褐捏藹曷竭謁歇把蠍擻提噶撮措羯揚暍惕碣渴捫錫愒捍遏葛 喝
血	卹洫恤皿冊盆向姍盅柵扁奧盪自岡胼朕算刪盂孟制侖盃珊益盍盔盛偏
舨	舶舢航舫艘艇舟舵船返舷艋艙艦皈鈑飯板扳販叛阪胳逢蜂處
漿	雷寸博守蔣電專寺獎符槳將鏘傅搏辱醬泵等薄溥簿膊縛府採肘汞尊蕾
邈	藐貌搗笆迫皁脾脈遑篁毫亳肥帕皚遙過腺週迥白巴箔葩牽皆
瘁	卒瘴杵粹奔踟率醉傘碎冬翠瘧疵癱遙掖赴液腋淬悴夾疼午萃誶摔瘀進
碧	磊珀磬巖磐磨皇拓司篁答言筒石瑰煌遑湟惶泵凰閤歌銅碉硼碓蝗硝減
肩	扁乍戶怎房戾僱篇偏遍褊笮咋炸柞昨妒作盛膂扈所匾編蝙
桂	褂捱鮭涯橈卦娃閨奎哇掛圭桔鞋佳窪畦蛙崖堯封杜
霧	雷霞霽霜零靈霾雨雩霎霪露霆靄霰霄霤雲霹務茅霓霑雹雪雯譎霏黴霖震霍
已	己忌厄氾妃改杞凹卮犯危扼呃卷範尼屈屆紀苑桅倦脆捲圈
築	恐築鞏竺工槓簣竿竽汞斤釭析肛江扛簪籤芹霖槓晰淅欣近昕沂攻折圻
憬	璟晾景怛慢惺愒惕悍就旬影惦掠涼京憫惇顥蹴曩
鏢	膘標漂嫖瞟驃縹鰾蒜票棕淙捺襟噤賒糉崇際綜蔡察
勣	勛責肋債嘖漬脅勤助叻磧積績蹟煩賄勒勘勉勁勵勃觔劻劫劬功幼頁貴
坷	呵河何柯阿奇苛蚵軻訶可倚崎椅琦畸錡寄荷犄啊婀
本	韓違葦杯槓木圍桓幃朽吾柯枰一五闈笨枉韋缽桿極伍柄苯體偉
踟	跆足蜘趺趴躁癡跳躑踝踞跼跟跤跋跚跑跌距蹼躋踐踏踩
呼	乎竊蟋悉咪釉釆咋吒叭釋米咱聽哦啤嗚鳴啾呈
耶	椰爺邦耳耿恥取那聶鬱郎耽祁邵邱郡都邢郵郾鄭鄴梆弔
聾	壟襲龔龍籠龐寵聶朧攏嚨茸矓懾瓏隴聱聞攝囁躡鑷洱弭
祀	祝社祐圯禪祁祆祕祠祖祚祥視禎巳祉祈祇神起祺祿福禍禧禳巷
經	縹繅紜紅糸縉痙涇輕莖給縲絃紆緬綏絰綜氫絲徑緇縴逕
透	痢莉仍誘揪秦繙愀潘諉秀逶繡悸蟠矮啾萎墦播季鍬莠乃俐穌倭奶幡扔鏽孕
鳥	鴣鷓鵠鵲鵝島鵑鴒鳩鴃鶴鳶鶉鴉鴦鴕鷂鴨鴆鶯鴛鴿鷗鷹鳴鵪鵬鴻
幟	唷幀幌幅梳帖帕流幛職硫識幔只琉幢帆帽織枳巾熾毓幡堉
獼	爾你彌
轉	傳轟磚囀團轄車專轔輯軾軒軋轍輾轅轎輻輸輳輪輜輕軛輔輊軸軟軔軏
刷	刖涮刺制削剌則別刪劃剛釗刈劃到刮剁剎剃判利刨列刑刎剖副刊剩劉
涅	捏汨湯濕渴漫瀑混澗湮潤時湄塒倡娼唱湣湟坦漕澆潛踏曉濤瀆瀾水晶
栘	移夥侈多爹令杼銘橘汐酩矽夕茗苑麥宛舞桶舛外夢名
鈔	炒杪沙抄妙吵砂眇紗銷少莎省劣炸鎖渺鉑鉍鈿釦針釙鏜鐺緲金娑
受	愛朋舜崩授棚胴骨硼綬鵬滑噯曖覓月亂腺滕璦
滕	勝胖賸謄騰畔拌姅伴半捲倦炙踡蜷腺絆圈拳判眷受卷券
詰	詫誼詁計誥詔詻語諮譟詼誌誡誤訟諒談諾謂試詩詣詮認諄請諉諂諍誶
忪	鬆錢公蚣訟憎賤勾勺怡鍍惦淺棧鉛慘憾悌悅鈸鋪心
銖	株侏硃珠茱跦蛛殊誅朱錘鍾鉑鍛未千鈑釩狩鍬宋
跨	踩踢垮跎踐蹈萼跆蹊踡蹂挎胯蹋蹲跺踴蹟躇愕踹踏蹦踱跪蹉蹄蹣誇足污鍔
宇	芋訏室竽宋家迂盂士圩汙荼五於紆定途籲餘寅
竽	芋餘宇於迂汙圩籲竿竺紆盂筮荼五訏途某箴戌後斥斤除徐
橫	璜磺簧黌樺黃檬柑模楛權棋蕈樽標槽檜薑曄糢嘩構械樸廣
蠍	歇蟲蜴蚓蝴蝦螂蜘蜓蜊蚯虻蟲蝌蜥蠅螻蛹蛾蛙蛭蛔蛛蛐蛞蛟蚶蛀蛄蛆
洌	咧例夙冽涮測瀏殃歹屍汀斃倒蜊歿殉死殆殘
麒	鏖塵麋麂麟麝鑣麗麓箕祺琪棋淇簸其鹿欺期儷灑欐曬旗毗
陲	垂陣陞防捶限阪錘棰弔箠 降阿陌隆陴阱隍綞阻睡陳隊郵唾阡
派	脈泊沃洗活洎洫沂汎狐汝湩浩泜添潘潟澳泖湃
包	抱砲刨苞皰劬泡炮胞跑句匏咆鉋巳袍鮑庖雹飽 
祗	祇砥胝牴柢泜抵低紙底詆氐婚衹祚舐祆祈氏福昏
萌	昔莫明草音芭幕墓厝暮摹慕措惜借錯葫冒葛募蔓蕞
妊	任衽壬呈廷妖妒浩造燻告望薰飪皓擁臃窖聖雍壅
嚴	巖儼囂器釅萼鍔愕葵三哭闋竺單咒二天揆些昊睽鄂仁
須	頻穎顆頂頃頹頒題頓頡順頤顏頌頭顯頰碩頊頑頫領額鬚預煩頁頷項頗類頜
蹄	踩跡啼跤踐蹈跆蹊趾締帝跚踴踹啻踏蹦躂蒂蹣足躋諦
肫	盹沌胸鈍芻屯囤縐趨胞純飩噸愛朋匈肥肚洶頓月
巉	攙儳纔讒饞毚崑逸比毗枇妣批沘仳嵐菟冤昆兔屁庇
江	扛槓肛釭鴻紅缸虹訌工汞築槓攻功佐巧貢項汗汙汀汪沂洹溧潯蚩
訾	些磊言柴貲紫詬詞訕計訃譫齜詹閤答礬齧疵詳詼詢詰誌誡誚註詁詛詐
漆	膝沐渣淋黍湘淞黏沫決淅樑椎杵枚漱榫溧潘嗓渡澡樵深淨浮浴栓洽汽
遘	構溝搆媾購講迸苒稱鉼胼拼姘併屏耕阱並冉井
螺	騾虻蛔鏍螳摞蟲蝠累蟋漯蜷蛉蜿嫘蟠蛐嗉蟬蚣縲蟀蟒蟈蜈絲
頸	勁項頻頭頤頡頜顆碩頑頓頌頊煩頂頃顫顯頰頷頹穎頫頗領題顎顓預頒
罰	藹靄獄罩訓辯罹罟罪羅羈置買眾誌誡誚詳詰詼詢談課諂誰誹謂註詠詁
林	痳木彬李棟森淋焚樸框婪棵材琳沐孱村楝棲梱休札霖柄柩杜
鋤	勗助鍰拋拗沮姐咀功湧勝銅筋勞脅疽宜慟黝渤勤蛆組粗租祖砠俎阻狙
識	詣詩謁詢詼談謂認諳謗讓幟諺職訟訃訪謫只試該諄織枳註詰謨誨詨誶誡譜諒誌諦
裝	奘裁依裟裘裴裂袈袋製褽襞襲衣裳裔玷玟琥斑璃琉嬝迎坊坑瓖
榕	鎔熔溶棕俗搾檳檸梡欲谷裕腳枯容卻峪蓉棺浴
笞	箋苔麼臺胎迨治擡怡始怠或鬼冶茗哉名貽跆殆颱
釀	娘釅良醮酸酥醞酵醴醒攘醉醺醇讓酴醣酩鑲孃狼壤酉醋嚷酪瓖酷醃曩醜酣禳
婢	埤啤俾脾裨陴睥碑痺箄牌卑鼙顰妒妖妊千娥姓嬝箠
狽	鋇員贊狙責貫貨賀貴賃側測惻濺貝貢廁費買貸貲贅
莧	覓筧峴覬覺規現視硯蜆覲見覜覦靦觀苜窺寬攪
霜	霞霽零霾雨雩孀霎霪露霆相霰霄雲霹廂霓霑雯雪霏箱黴湘霖震霍
玥	珊琛玨琿瑤璦王現再弄玟玫玷珀玖理瑰班斑瑚
遲	墀犀囑屬矚卞這迢遽適汴避逝遍違娓非匪卜遊屝
繫	擊紊絲緊系繁累索紫絮紮素縲濰緞喲羅蘊糸辮段
蝠	蟲蠣福逼幅蛤蛭蚵虹蟲蝸蜻輻蟬蟠蚣蠕蛔蛐蚶蛄蛆蚯蚜富
菲	誹徘匪遣罪悲非窕排靡俳輩斐徊屝痱晁啡靠霏裴腓扉蔬
哦	娥峨俄蛾義餓我儀鵝咋吒叭蟻議牛啤咱呼呱聽找呈
追	槌鎚逅迫襄簞迭返近造迢亢遁逶阜裒迴啟帥透逢埠炕杭遍遑沆抗坑吭
杞	妃氾己已厄犯紀桅忌卷危卮記配改札扼呃凹範
卞	這卜適汴遲亢玄犀遊屬僕撲樸釙冬充亥哀棄京外迂迆迅卦赴迪迥迫迨
翹	羿翻翔翩扇翎塌翱翁翌翅翳翟習耀翮遢栩羽翡榻
插	括捶拍託扒寫搗拆扳折抓搜段瀉臼千抹擠抖技抄仟捩播撬樁稻抵投揪
蕩	湯藩萍莎燙蒲蒞落菠藻茫範蔆薄盪萱度渣汨蓀菰萌菽旦澶踏潤濱源渲
湩	腫鍾董種踵慟重衝動懂活浬洗泊沃潼洎洫派沂汎湮渾湟浩潘湃漣裡千
斑	王琴痊瑕珪班玫璨理玨璋逛琳枉玷璿琉璩玟瑟瓖琺璃瓏狂琥
乍	妒作窄扈僱戶扁笮砟詐房炸肩乃成戾方咋祚昨所怎柞
惕	勿匆踢惚慢怛旬剔物悍易賜憬惺囫錫忽愒蜴刎吻
秧	科利瑛秋秤泱盎稠央秈禾稱禿殃鞅稀稍怏稚稞映稻俐英租秩祕和私秣
圖	回砧佔圓惦嚎哼嚷店拈沾佔乩霑點站玷帖京豪諸貼儲逞黏高品亭亮藷
痺	箄脾裨婢埤啤俾睥碑陴卑鼙牌顰千箠癥瘦爻痿疹瘋狐仟
葩	芭藐扈鉑梔迫柏泊拍怕伯笆篁白巴腺遑煌嗥湟棉惶粕錦浥珀帕
菜	踩葉籐藥萵菔茶棻榮葷蘗苜睬典煎前綵採蒙肘膝彩
乏	箴簾眨麼簌之泛芝貶飲欠次欽灸歜久疚坎炊笞吹砭鬼箋
蓋	闔溘嗑磕瞌豔藍盍盞籃濫檻襤鑑監尷盡篇瘟盧盆侖溢塭鎰法怯
熟	塾孰熱享燉敦淳惇郭廓丸槨墩鶉熨烹爹亨諄醇汍
招	詔炤扮貂切刀韶紹沼岔昭賴券忿迢叨照召超拐解分初挈
咻	咐咿休茶喉吶唯哈吟吃榦付唸喻嗆噙呆附啣滌保儉檢府符
萬	躉厲癘邁苗藕薯禺愚寓茵茴英夢甲巾遇偶勵礪蠣
歇	蠍噶歎曷藹欽歌欲畝砍炊玖坎吹次款欺歉飲歐軟歜欣歟歡暍遏渴揭愒
髯	髻髮髦髡鬆鬍髭鬚鬃鬢鬣苒冉衫杉箄疹遘稱構溝搆媾須彬彩彥彤形
按	銨晏安鞍擰擦技豐案控接氨挖搾捷拷湃手姦宴
甚	湛甘辰諶農圬堪佞脤儂斟振芸勘棋脣宸膿箕娠淇戡濃其期晨誇噥污
債	嘖漬蹟磧積績倩責價潰遺損槓匱簣賸睛隕慣晴情清瓚臢鑽圓賁賡
琶	瑟琵琴玨笆疤爸芭邑耙杷肥把吧巴琨瑁靶玩爬
顫	頻顆頂願顛頃頒題頓頡頤頌頭嬗顯氈顱頰頸顥碩頊頫頑擅煩須項頜
叻	另咖肋力男脅加幼劫助劬伽迦茄痂功劻咦觔勒勛勸協劣勇荔
釜	斧父爸爺爹斑王錡弄全左痊交凌逛琛玨玥枉旺狂汪銓匡璞
藉	籍藕耕耒模萌昔糢耙草芭芙莫耜措耘耗蘚藺蕞蔓暮摹慕幕墓葛募菁厝
辯	藹薛僻辣宰滓癖諳瓣霹罰訃辭辦辜避莘辨闢獄薜辛辮 
寥	櫂瀚羿僇煽擢廖穋塌褶翁翌戳翠翟習嘐膠耀蓊戮嗡曜繆謬濯遢翼摺躍翰榻
棉	遑櫛迫湟鉑幫啼怖錦穆怕帕帛綿腺柏煌粕瞞滯佈鈽嗥泊拍伯惶滿
屹	吃迄紇疙訖乞乙挖岑崔崙催瞼仔你函夜吟伶汽侯峪涔崛旋偷鈐摧齡仙
前	荊莉薊煎剪箭湔涮廁菔籐鬥刖痢菜側硎惻測掣蒙削俐咧洌刺制冽例倒
僚	嘹撩潦暸燎遼繚寮療瞭佑傻倚俺俟佐佈侑仇剎
雋	集焦售隹隻雙崔進椎淮推惟堆唯錐鐫僱截瞿籬奪蕉奮舊藺雉雊稚碓睢
瀲	劍斂憂稷稜傻陵凌洽洛廈菱綾後反鈑板返扳路珞咯咚處各冬
柑	樺芋謀墟嵌甘橫某煤甜樸疳虛棋林芣模檬蚶鉗噓媒箝酣坩楛槽
濡	懦嚅燸儒糯孺蠕需灞擂鐳湍壩蕾優擾而亙渝清淪沅恆雷電耍耑
景	蒿晾京涼冥亭嵩佔驚烹煦掠顥鯨暗昱憬豪篙璟亮哀高曩就襄諒享影亨偯
郭	槨廓孰敦鶉鄴墩燉部享郢郡鄗郊郎鬱郃耶邵鄙邱祁鄭鄱邢邦那橢
疸	瘍查晝旦袒怛坦但暨痕疤春瘧暮昊旱左旺靼量三奢奭者晅捍悍焊桿湯
赤	赫郝赦赧赭嚇亦鬥小到弈奕倒螫帟鬨弗劃刖前釗刈琍跡
楫	揖緝輯枴囁杏耳戢椰聶恥耿洱弭取茸橾拐攝懾耶和聞
麥	侈多爹移栘夥麩宛夕汐舞茗銘矽麴麵名苑令乾傑俑舛外
涕	悌娣梯銻弟剃淦阡第陴阪陞郝陲降沿隍汾弔涉洪津郊泌泊油沙汲沖沃
鐸	澤擇釋譯驛繹睪鉀鐲幸圉悻倖賣燭曙濁胛柙狎押呷閘曼匣
衢	街衝銜衍衡衛衙術桁行徵徹微御黴徘循徠徜徒很徊律徇徉往徵彿復從
蹕	踝嗶跚足蹼踫踞躋跟跦距趺趴踵跼跤跑跌跋趾蹣蹉躇踱躅踐踏踩跎跆
贛	彰頗瀕傾蘋擷澦噸癲巔嶺籲貳賂逢額鬚客骼鋒鉻路詻隆絡絳終略烽胳
蜃	蟲脣脣辰蝨蠡蜇閩晨蚤宸脤振娠虺蛋蟹蠻融震螫蟲蝕賑
匐	副蔔富逼恫石幅恰福蝠輻甸句司悟恆慄愷泵巖拓憚磊課謂戲
紆	絲紂紅細組絰緬縲糸紀約紗紋純紐納糾絆絀紲絢維練繡紜綵縉綑
覓	莧筧覺峴規現視硯蜆覦見覜靦覬覲觀攪窺脂能比
囫	吻易物惚勿忽刎惕錫匆思蜴賜踢囤必剔泌腮鉍
祖	組視禍粗社沮姐咀祕祐祠祚砠租祥祆祉祈蛆俎祀祁狙阻祺祿禎且疽宜
昤	嶺領鴒令拎泠伶鈴翎苓侈多玲栘吟羚聆冷蛉鈐岑今
詨	訃謫註該訪訣訕計詳詢誚詁詛詐訴課誰訥許記討訊託訏訑訐謙訂詼諒
毅	穀殿毀殼設殷般段股投役毆骰殺疫芟豭跺沒浸侵逐佩夜
楛	苦枯葫模樺權古橫檬涸個錮箇鈷胡沽姑咕估菅居固
鏽	鉀釗金嘯鉑誘針銷瀟姊秀釦釧繡蕭鉼鈷透釙丫肅簫鈾鈿銀鏤鐮淵鉗錐鉤銻鋰
獸	吠哭器畎獻默伏猷狀莽臭突戾犬單戰鄙憚彈嬋嗅唳獄袱簞獎
爭	箏淨掙崢錚猙睜靜諍採凸脹炙孚妥月服朋舀渠冗菔受肘肚肋
展	叵藥輾屢匹匿屎居茹屑摒碾茲接尼暱屈羼尿屍屏妾
啟	故敬敔畋枚牧敝敖敕敉敞敦敢散帥放玫改敵數收斂做矢疾阜矣
敷	政救捕啟敵致哺蒲數敗教輔敬敞散敖敏激搏倣竅故畋效牧甫放邀敕鋪膊脯檄敢敝敉族枚敦
賢	腎堅緊豎贅費貴買貿質資貲賃賈賀貸貫貨贊責貢員廁測惻側狽
咦	姨胰仇夷九痍軌旭叻究哮另咖友丸疚咽吹吠吐汍叮鳩唏啜嘹為口品染
贊	鋇貸貝側貫賃貴員臢潛賈賀瓚廁貨質資替費貿贗測惻責貲鑽貢濺買狽讚贅
賊	賤貽賻貯貝貶賠贈贓賄貼賭敗財則賂賒賜購贖賬販賺
諍	諼謠謂調請詛誼談諉誌認誡謀諜詰詼詩詔訟譎譟課誚詐訣訥討訕訏訑
弭	聞洱耳茸聶恥取耿陬餌懾攝囁鑷椰聲耶張揖楫躡輒趣爺聱聳聾
雍	壅擁臃亥甕垓妊核咳閡玄壬亡逞造劾刻氦牽畜賅鄉逵骸孩巡
婊	錶表姓素娠嗉妝娉姦畏青娥娘姪姐姅拓妍奸如打情偎清喂倩晴煨佞耨
幽	茲滋慈紮孳磁朗幾吆玄以幻樂畿纂糸炫郎弦始姒奚晉畜眩參淺似絃棧
炭	碳杯崇豈宗票詼巖壞平芣灰崖禁祭不三恢否示岸奈祟丕禦
絆	組約細絀絢半繡糸維紐叛紗紋拌糾紀練縲伴紆判紂納絲紲純
餡	陷飭饅餞飴掐餉飯諂饑館餌飲餵飪饒餓餿餅餽飾餒餘餛飢飩
途	芋宇夜竽迂逾塗圩汙荼徐除迄於迤籲餘斜伍敘佺
酬	酒釅醮酥酸醞酊酵醴醒醉醺醇洲配酴醣酩酗酉醋酪釀酷醃醜酣酌
跟	足距跚趺踝趴躋踢踏跤跦跼跋跑跌踫踞趾蹕蹼跆踩踐
丸	汍執夕九夷孰弘爹仇外名旭汐舛咦姨胰痍痛勢墊摯熱
誹	啡腓排俳徘匪痱菲屝扉霏罪靡訓謎譴証訌訃誕誑謝訛課誰誣誚詳詢詬
黑	點墨勳焦黠默理浬嘿黜壎埋狸黛俚羔量娌野黔鋰黝喱裡哩黯童
盲	肓亡苜杗忘冒妄省眉看眷督目相瞥算芒望瞽荒篡纂氓胤忙渺緲懼
眺	桃逃洮挑姚佻跳窕晁兆瞰睫睢盹盯北目瞿排啡腓俳瞇眼睞眇覜頫睛睬
心	勾句勺旬甸志沁忠芯思屯必弋也世勻匈忙忖忸忪快怯怕怡怛恨恢悄悚
檜	儈燴膾繪栓檢榆會槍梅劊覃檀橫槽標潭撢僵儉偷倫佺偭蕈
宗	富察糉碳崇棕禦票蹤宸禁祭不竺宣三淙示綜奈二祟完
秈	禾和私秋札委禿香番科秣租祕稍稚稞秧秩秤稅秒嵇利季黍
綴	終絡輟緯絹絳綾綻線緩紐締編綿級縲絃綵綬綰桑緝緹綏掇綺綸綜絲啜緇
錢	摻餞淺盞殆賊鍍踐線翁殘茲慘棧訟公蚣滲賤貽忪鬆箋
邢	鄧邱鄭鄴邦那邪邸祁郎鬱郃耶部郵鄞刑弔邵郊郡郝郢郭都郾鄒鄗鄙鄘
渚	堵楮褚睹諸屠奢暑著箸緒賭署豬赭嘟者煮都汁曙儲薯藷
瑪	碼媽嗎螞馮篤闖罵駑駕馬驚騖駐駟駛駒馳馱駢馭玨駁
垣	晅桓宣坦圬喳渣洹旦喧渲暄壇萱堤場疆壞圩百奭
躊	檮踩鑄踐蹺跆蹊壽禱蹂蹲疇蹬跺踴濤儔籌踏踱跪蹉蹶足
了	芟嘹撩哼予序沒歿股吼潦擊烹閻孑投慇妤鐐孜孓乳杼承野孔抒燎弓亨疫
阬	沆抗坑吭炕杭伉骯防航陪隧隨亢降障阪陀陞陵陷隆陂弔
爹	多栘移侈夥令茗銘夢麥宛矽汐苑舞夕酩名父丸夠舛外
雯	霽雨雪霄霍霎霑霖霞雩震霓霆霜霰雲黴霤霏霪霹露靄零靈
惴	湍而需瑞耑揣頓燸慄情恆儒耍耐噸顓嚅端懦踹愉愷濡怫喘
鍔	愕萼胯垮跨誇儼釅鄂巖嚴雩顎囂憚彈嬋污圬襄誇
孽	荸孳享莘字遊厚薛蘗菩笠薜辛遊悸脖悖浮俘蕃萎薴宰茱季孝孛孚李子
抹	沫末茉秣抉耒揀披枝杖枯抖技找扣撲扎手拈抨抽押拙拍拘拉拌拒拄拓
鼠	竄鼬裒臼鼴舅鼯舀舂閻舊亡滔焰陷稻潟樁啗舉芒肓杗忘妄與臾身諂餡
很	徇徊律徉往得限彿徒徠徜彷徵彼徙循待徐從徨行徵
朱	妹狩宋茱跦硃誅魅珠昧仟千未侏沬殊味株銖蛛
撤	埃徹敵攸唉擻霰澈蔽敞散朝撇嘲挨廠潮撒邀敝俟轍遨
喫	楔鍥契啪噢喚哎夭嗉嘖咯啦吞喀換唳啗嗟嗯嗅嗥唆唉唏駁咚呢懊澳吩
墟	噓虛琥璩坩濾唬瀘爐臚鑪瘧噱據擄遽壙驢鱸甘箝廬蘆
趴	跌趺跦踵足距跚跟踝蹼躋跺趾跋跑跛跤跼踫踞蹕跎跆踐踏踩蹂蹈踟蹤
術	銜街衍衙衛衝衡衢桁行御徵徘微徹黴徠徜徙循徒述很徊律徇徉怵徵往
沌	肫洶鈍芻沁屯囤盹縐趨洩泡泌池洵純飩汕噸淘匈柒
鄞	勤覲瑾僅邱郵鄭鄴謹饉邸邢那邦鄘部郎郃鬱耶祁
庭	淫蜓奴荏程霆涎梃又健挺誕延廷怪筵隻壬腱逞雙鍵艇
計	詰詁詫誼訃訕訊訐許訂記討訌託訏訑訪訣訥訢註詠評詞詛詐訴訶詳誠
煖	暖湲援媛緩鍰諼爰燃炯祖助瑩綏塚綵綬燸組鋤胴天熒勞勗
廝	斧祈薪聽晰昕淅浙嘶斤沂析逝嶄蜥圻斯慚漸折近匠撕
濁	呷鉀躅柙狎蟲澤曙擇胛蠶蛋觸鐸押鐲閘澴髑蜀歜燭匣獨曼賣
盤	槃磐盈般瘢搬盎監盥盟盪盜盛盔益盍盃盅扁盂孟疫芟楹殷段股投
步	涉止扯址肯芷企遣正武歧祉逃啃歲焉怔症趾遺
敦	墩燉孰郭鶉教枚敉敘槨廓敬啟敕敵故享敞散敢敝敖效數畋放牧玫改孜
苟	葉拘齣夠菊蔔苞芯蕊枸葡句佝包筍狗駒芍鉤雊荀
糜	磨摩麼魔麾靡蘑嬤粱麻屎麋粟氣朮嘛粥迷咪痲米燐遴轔憐述怵
迥	炯週過高運遙向尚膏迨渦媧堝鍋商啻萵胴啁朋迢胎造搞遣禍槁鎬迦撾
崑	混棍焜錕琨餛鹿篦罷媲昆皆偕揩陛楷比琵階毚屁庇能毗枇妣批沘仳諧
錄	綠彙錙鑄鎮鈑錘釵氯鑠亟鈞欽鈿沍銀鏤互鉗鈣釭鈕鈹銻逮錶釘碌喙祿剝
隨	橢隧阬隴防陪陌阻障弔陬附陳陡陝限阿阱阪阡隔隋除陋阮墮
圭	澆涯橈嬈珪卦撓吉娃奎哇掛佳埋堆窪畦曉土桂僥蛙崖堯燒封鐃志
課	顆訏訥果詢諫訣許託謂誅記詳詐誰棵稞討訃詁計詛訊訂訐註訕誚訑
釋	鐸繹澤擇驛譯睪乎釉悉柙幸圉燭曙悻倖呼鐲蟋獨濁鉀報胛狎押呷薯竊
裸	棵果稞猓裡踝袖髁裹窠課由巢困慄鈾褸迪柚油抽岫妯溧慄梱捆曳申笛
驕	馭騾矯驅駁馱嬌駝馳騎轎驗馬駟驢僑駱駒騵喬駛騙駢駐橋驍駿 
梵	釩汎帆凡婪焚楚麓禁礬材皮楓板疲爨夕幾彬被格栘鈹波披坡
誓	譽哲這譬警唁信蜇言訃諒謎逝折諄誶訢訕浙計讓
欺	砍旗歉歎琪麒玖款撳欲棋嶔次欽歟箕炊坎淇畝其祺期吹斯歌簸欣
喧	嚀糉喀晅院萱棕奭嬪檳嗜洹濱桓渲梡楦恆嫁傢垣亙儐宣暄淙皖噴詰喳佇錠唔
廣	度芋盞庶甘席蘸橫曠壙蔗黃戒獷廉兵拚簧芣擴弁蚶礦廝西械醋其璜庠
姬	妃迎抑仰串昂媽叩婦妮娜患介袖姊妯卸妒妨即如印奶娓娉釧圳川嫗臣
蕨	獗蹶鱖厥薑黃芸華葬莖荊劂樺曄嘩蕈蕾厝茁芣芋
籐	籐筋炙筒箏纂算熒滕胖箱箔崩筧奧篡愛受竹自血猙胱朋叔向
躅	鐲燭獨濁觸髑蜀踝蹲蹣踱踐跆蹕足躁躇蹶蹺躊蹦蹉蹈蹊蹄踴蹂踹踢踏
攀	樊希爻礬棒稀捧駁崤俸抉韋痍疲奉餚痳筷痂爽塽椅晞烯唏袂降拔快決
麋	麟鏖塵麂麝麒鑣麓麗鹿毗糜粱屎庇儷灑邐欐曬比
鼕	鼙瞽疼咚終客洛閣冬逢咯返處鋒鉻路鈑販略烽胳珞烙格峯降皈恪叛板
吉	惆裯杏告嘉潔黠袁週圭結售桔圯土拮噩喪啁造嘻浩品臺口熹志喜周
諉	誘誥詻詆設誅詐託談諂諍誌誡謀諜謂詫詩詼詣詰詔訟譟讚課諛話詬訴
潯	尋溥磚褥詩討漏耨將時持恃待峙侍江吋撙樽膊遵搏傳渥博轉傅蹲浸特
隙	騵隍原階陷陞陀阬限陌阡弔障際隘隔隕險陽隆隄陪陵陸陶陛除院陋降
胞	炮泡抱咆袍鉋砲苞庖跑鮑皰飽包雹匏劬刨肫胸巳
蛹	蟲通桶湧俑痛誦蚓蛆蚌蜢蟲蛾蜆蛙蛭蛔蛐蚶蛄蚵蚱蚯蛀蚪蚊螞虻蚣蟾
啃	肯址扯芷企趾祉武止唷歧歷遣歲啼喟遺步正喻唁揹靖噓賦嚎壢瀝涉怔
川	順圳釧訓馴袖剌甽褸串劓襪中刈爪州刖劃刷蚓釗劃引兒仲沖彿片弗介
播	潘墦幡繙蟠揪審蕃番稞逶倭禾秦矮悸透穌鍬愀啾痿萎
嘶	斧薪斫聽晰昕淅浙哄廝斤沂析逝嶄蜥圻芹斯慚漸折近匠撕
鄘	庸鬱慵傭郎祁鄙鄞鄭鄱鄗鄴郾部都郢郡郝郊郃耶邱邵邢邦那
鑣	麓鏖麋塵麟麂麒麗麝鹿錕毗欐曬灑儷邐比熊庇
猓	狸狎猥棵稞裸狄猶狠狙狗狂犯獨果狼狹狽狡狐課踝髁猛猖猙狷狩窠裹
薦	韉茂莆芝蔗莽苔薺蕭蒐菊萸苗芣芯昔芍艾茨蓆廿
騁	聘娉駛駁騾驥馴馬駱騎駝騷騵驃驍驛驗驟驢駢駐駟駒馳馱馭
筋	勞肋湧勇勗籐脅力勝慟踴窈奧箏鋤男劣另筒渤澳拗拋懊噢燠勵助襖叻
捕	博敷莆誧哺蒲輔傅搏補甫賻圃鋪溥膊脯縛匍浦埔
看	眷牛省眉苜冒盲算目相牡牝攫督瞥篡纂牯牲牧眸牠犒
眨	睽睨之泛瞄芝目睢貶瞧睬眩眸眇盯睥瞿瞪睡乏砭
甭	盃不否用傭歪爾芣示杯壞彌邇宗奈痞盡肖瀰璽祟票祭禁禦甩平丕滅碳
硃	誅珠株銖侏蛛殊跦茱砟碑磊斫朱砰砂砥砭石砧砝砷破砠砲硝硯碰碘碓
儅	倘儻俏噹擋檔襠鐺當償黨尚趟淌夥炯掌棠堂趙伴膛鏜常
鸞	鑾攣戀彎巒蠻變孿灤灣鷥鷹鳶鷓鷺鴦鴛鵲鵡鶉鵠鵑鵝鴿鴣鴨鴒鴉鳴鳩
尹	君伊咿裙窘大屍塚郡啄涿羣脅愜琢塚兇夭天太尺戶文父犬乍丈右史尢
替	春夫芙們贊昔潛鈇昌佚扶晶輦攆杳規迭伕承推但失趺倡麩
蕞	撮最娶蔓募莫暮摹慕幕墓葛昔取驀茸芰萌草叢陬
銳	脫悅蛻稅說閱兌鉛鋁兗兄釦況侃銻銑祝嗅克鑽袞岔
誠	詞訴訥諛訢詢誧訣許託話誅記詳詐誰討訃詁訪城計成詛課盛詠訐註訕誚詬誡
摸	莫墓暮幕慕模摹漠
杳	查香杷根桿木楊昌曰日棍渣喳傑昔杏曆森晶林柏耙稈楣榻
牴	抵柢胝泜砥祗低詆底氐婚衹牲祇舐紙氏昏牠牝牛
踴	湧蹂跪踩蹬足勇蹄踐踏踡蹈蹊蹣蹦跨跺躇跆喚躊跚距
膺	應鷹截雄隹冉雖攜玥仕集焦崔售錐進椎淮推惟堆唯準
鴿	鳴鴣鵑鵠鷗鴨鵲鶴鳩鵝鴒鶉鵡鵪鴆鴉鷂鷓鸛鳶鷹鷺
杉	彩衫彤形彫彭彪彰影彥彬榭箄櫛桁樅疹珍楷穆材柞柏射槐才
跪	踩詭跎呃踐桅蹺跆踡脆蹂躊蹬跺危踴蹟踏蹦蹉蹶距足跨
滬	淚扈浥僱褊遍捩唳偏砟祚炸柞昨咋妒吧作笮窄邑
汐	泓多湧侈栘夕汍汎矽移夥爹汛舛外銘名宛茗麥
婆	波菠皮板疲反被格破玻鈹坡披陂各冬皰跛鈑洛彼返扳
誶	碎諒諄讓訃謎諳識淬悴許醉諦粹詰該詨謫註訪計譴
櫝	瀆犢續贖黷牘讀竇賣桔檮檯橈杜柙檣樓桂甲環橫楞鬆鉀埋胛押坤呷梱
敲	鄗高槁犒搞稿鎬蒿嵩篙縞膏豪喬亭僑嬌橋婷濠壕嚎停佔寇亳
益	盟鎰縊扁柵盂皿共盃監盍隘孟冊溢恭盔基盅巷姍 
諛	詐託誰話誅詬訴訥許訢訕計訃諂課誣誚該詳誠詢謙註詁詛訪訣討訊訏
颯	芟颺楓亢飈颱瘋颶飄凱冗佩竣颼立颳珮諷肌嵐音妾風
俗	鎔谿保侃熔溶豁僕欲谷裕腳僧容卻峪份蓉榕慾浴
業	共叢寨異基烘恭益洪拱哄供並溢塞葉鉗隘港搴巽寒鉼暴鄴錯鬨巷茉苯
箸	著暑屠奢署褚楮渚堵睹諸者緒嘟豬賭煮赭都藷薯曙儲
捧	奏春俸輳撩秦捺泰舂扶降臻榛攆樁湊挾揍棒掩拳奉
入	仟件任作伯傀人竹佚佾侏俄倭俾荏化仰乒低俐係趴飛倪疹偏賃僱
楦	亙恆宣喧渲
柴	牀訾悚宋某弛迂森迆也嘴忖池此林貲琳柒呆快迤卡紫採杗些杲訑桌上
靡	誹麻糜魔麼菲徘匪罪非排麾摩磨俳屝痱啡霏腓扉
娥	妒儀我議鵝姓找哦牡牢妖件嬝牛蟻蛾峨牟餓妊俄婢媳娓義
炊	砍歇歉歎玖葵歐款飲欲欠次欽歟灸揆歜久疚坎畝軟吹歌燈欺欣歡
篩	獅師佩珮帥薛埠曇雨兩笙阜魎啟倆霖築霍箠霄箄雯笮雪笑霽帛吊瘺篇
桑	啜綴輟又友建延廷疫梃殼沒奴芟隻弩槃雙庭夜痳葭殷浸挺般候段殺假
烘	洪拱哄供共異縊烊港恭基巽寒塞搴寨暴鬨溢鎰
淹	洩怖唏希潦奄庵汰油由洧烯滯佈鈽菴溧醃晞鵪俺掩
拯	丞蒸拭控搓抵揉揆換極擔扭捱扼扔永亟拾拴捍抗授沅涯搔嵯嗟仁撥擂
胴	桐洞恫峒銅筒磊朋硼同脰壹受碉膈棚石崩愛喊洽拾恰哈鵬舜答言
扉	屝菲痱匪罪霏靡腓排啡俳徘誹非悲斐裴輩靠晁房肩匱乍戶
摺	褶擢濯曜櫂習嘐僇膠穋耀躍繆謬廖寥羿榻煽遢塌嗡翰瀚翟蓊翌翼翁
治	淺擡怡始胎迨冶渡苔笞臺殆貽跆滲沿浚飴颱或怠
昇	升昨陞星昌冕昕晌杲昱旦昂晶日曰晚易昊旱眉冒飛晷免明惺暗暘腥魄
暸	燎遼撩潦嘹僚繚療寮瞭晞剎晶暘暍曝暗顯暮莫晃昌
嚕	櫓漁魯魚鯧鯊鱉鱟鰻鯽鰓鰭鯉鮪鮭鯨鯖鯛喚啗哼鮫鮑魷鱷吹鰍薊
紮	組細絀繫累絢扎糸絨結紗紋纂濰羅縲絃絮蘊緊絆素索紫紊絲繁札系喲紲純
驢	妒騾鱸廬駁爐馱戶駝馳騎臚房騁鑪驗瀘馬駟駱駒騵駭驥駛騙駢驕駐驃驍蘆驛
斤	斬斧拆祈斫聽晰哲昕淅浙沂析逝圻所芹斯折近欣匠
繹	細繙纏澤擇繒縵糸鐸絨結縷繕縲綑絃釋紳緝睪絲續驛譯
娠	振脤宸晨賑辰震脣脣蜃佞三婊妍奸甚韭農姪堪湛戡嫣巧嫖圬污儂噥濃
籌	檮丟髻篌鑄弱壽禱雲夙躊等筠崁疇竺坎篛濤儔郢笞壬燾堠箋
諼	諍謠詛調謂鍰煖暖湲援媛誼請緩詼諦諱謀諜諾諭諳諒談諉諂論講謐語
誇	請詔詭諾謀垮詼談諉諍謂認語誼誑挎胯訟詮試愕詰謨誡污鍔跨誌
趕	銲焊桿捍悍稈走赴超趙越起赳趣趁趨趟旱但幹陡
劍	斂劂瀲劇副刻刑刊劊劃劑割剴創剩剖候釗剎削剌刺到刮制利刨刪別判
型	痢莉荊刑堅邢厝鬨蕭硎塗圭鬥塹堊塑開前烈刪壓墅薦鬧妍基醜薊羞剴形
葵	闋揆睽癸澄嶝燈橙登嚴疚茨歉欽歎磴瞪炊坎吹
亟	極丞二三沅汪涯冰汗汙汀左旦竺拯污仁閂差空汞式些一洹河涇江溼錄
輓	晚挽娩轟冕軟逸菟冤軋軏軌車輥軻軸軼軒軔免兔
漪	旖河逖逛畸犄椅錡崎倚寄奇誑狹汀湊琦可嶽荻
誣	訐訏訂誰評証詛訶訝訥許訌訕計訃誚課諛詳詢詬註詞詁詐訴訣訢記討
艘	舶舨舟舵舷船航舢艙艋艦舫艇叟潟餿颼瘦舀搜嫂裒舂
蚵	蟲蛭虹蛄蛆蚯蚶蚜蛔柯阿河坷呵何蝠蟲蛀蚱蚊蚪蚌蛙蛐蛞虻蠅蛤蚓苛
鈿	鉀鋰錮鏍金西曾鈾錨田釦針釙迺曬哂佃僧憎增酋酉窠層
丁	頂坷行酊汽苛汀打河邱呵柯薴歹奇一叮次可貯仃訂盯釘佇何弓
拾	掄捨儉拓石險搭籥洽搶撿閤 瞼哈蛤給簽臉拖檢合塔恰鑰磊答拴
鈴	令零泠齡聆拎蛉銓羚捻吟玲鄰苓領侈唸憐鈐鎗黔昤冷岑嶺伶鑰今多
由	軸笛岫洩胄奄呻冑坤婁迪妯鈾柚油申拽伸裸曳袖廟更抽釉裡郵宙
篛	溺弱鶸夙侯篌籌歹詭脆桅多危跪篷筵築篆第互孑夕筠殘移殉栘殆矽侈
幕	慕募漠怖墓昔膜唏希葛稀摹蕞莫摸萌模寞烯冪暮佈鈽驀晞蒂蔓布
活	括恬聒蛞闊話舌颳沽甜刮舐湩舔泊沃湖涸古千
犯	氾妃狄杞狂狎狙狗狠狽狸猓己已卮厄狐狡紀狼狹記配猶狷猖猙獗危卷
璽	爾邇彌璧瀰玉瑩甭盃燃斑瑭球琅班玨然堂屑宵釜芣尚弄否全示盡勞痊
裹	衰果裸棵窠課踝稞逶猓裒襄巢還髁稟痿萎迴困
詫	詰誼計託誌詁試詼詣詔詆認誡誥訟談諉諂諜謂詢詐許訐訕訑訊訃
嫩	敕攸收嫉嗽漱橄擻嗷撇撒傲遨喇做邀速悚簌藪
虜	擄舅膚慮甥盧虔虐虛虎男濾虞廬蘆瀘臚爐鑪處
芭	邑疤笆昔巴肥杷把吧爸草葩耙靶琶萌莫爬厝色浥借措惜錯
暴	異巽寨拱鬨港搴供曝哄瀑鑤共寒烘賽溢塞爆洪
姘	媾拼併胼迸鉼並井屏耕阱餅駢搆溝構遘嫌摒購併
崆	控倥腔硿空邃潸窒挖搾搾麻痲穿嵯穹弒岐窕窄突窠簾究穴
鏖	塵麋麂麝麒麟鑣麓麗鹿毗庇比昆屁儷錕灑邐欐曬能枇沘批妣仳
削	刖刺制刷肖釗刪判劃刈剎剌則剛利剩刑刊劑尚
梨	漱嗽利痢琍秉朵莉束李柔籟禾森簌禿悸鬥染季閑蜊存秧俐犁薦乘喇剁
較	轟鉸校軌姣咬軋車軸軟皎軒軏鮫狡轍輊跤軻軼輔蛟絞輥軔
賂	販鉻咯略胳烙格洛恪路骼珞貉詻酪貽絡駱客賠閣
猴	篌堠喉侯狙狂獅獄猓狹狸狠狡狎狗狄犯猥猜猖狷獲
曝	曄暴曠暝普曦鯧娼昌唱猖晶暗瀑鑤暍共暘爆倡
憾	撼感怡怠勾勺惦惚惑勻慘慷慵怵惹恕匍臺愴嗯涊恰恃忪心句
俚	哩埋娌浬裡鋰佃裡狸理鯉僮嘿童黑貍黛仕喱量墨
易	勿曷匆踢惚剔物必昌鉍暍昀惕賜囫泌錫忽蜴刎吻
閎	門閔閑間閒悶問閃閂宏開閏閉閘閨閩聞閥太叉肱汰
裳	當棠掌嘗常黨尚賞袈堂衣依裟裁肖噹袁製裘裝袋褽襞襲裔膛敞擋檔敝
姻	咽胭茵娌嗯恩氤因姆囿男姨妯妖如奴媼媲嫘囪更女姦
燮	誕設雙隻言談誚馭訾諒誤詼詻護詖訣這唁訊訕計訂訃信怪奴
期	旗脊湛甘琪堪麒甚芸棋具脣箕淇戡其祺斯簸欺俱
亦	釗跡蠻赤刈鬨巒小市郝鬥奕劑迪變前赧帟赭刖逮止劃弗戀弈赦
九	夷旭仇咦姨胰痍丸友究疚鳩為汍染軌大弓孝弩瘓鄭
槌	鎚追杭糙枋樸槁檀橾簞椒核柱枓稿攘孃壤嚷權鑲樞襄曩
政	正攻怔歪症徵孜整玫敕收敢証敵數故畋致效敉放枚牧敝敖啟敘敔改敞
邊	膀遍滂鎊窄動自肪勵傍鎳遺透邃遞房遊鏃劫咱道邀榜於力癟遛方旁逢臬洎歷
軼	轟軟迭軋佚車軸軒軔軏秩軌軻跌較輊輔輓輛輥轎
哇	娃掛佳桂畦吐奎卦蛙鞋鮭掛褂堯閨圭封捱涯崖
揚	楊捏颺場扮揭提暢湯撮傷煬腸拐據鍚瘍陽暘豕捍招
煆	暇遐假瑕蝦葭豭霞候燦夜浸般侵股沒投又疫芟
襤	鑑檻濫尷籃藍艦監褊溘嗑盞磕瞌蓋遍偏闔盍盅
畫	晝書鼻三畏在喂煨偎竺奮猥埋疆票疸衰查賣或冀些薑苗二圄酋酉田一
至	室蟲致屋齷蛭到窒雲臻倒侄蛙乓握輊喔耋絰渥姪緻
盈	盤盎楹扁孟盔監盃盅盂益盍盛盜盟盥盪珊柵姍
佑	知癡佈倚伽佐俺偌侑仇蜘踟右矢智伺俟咯倍嫉裙吞吝君疾
議	儀蟻譜謨講謀諾詳譁識譏譙護謊諜謂諳談請諉諂誌誡誥認詫詩詰詼詣
閒	闐閔們闊闆閨門閏閩閘間開閂閑閎問僩閭捫悶閥聞闖閉闌閃
稷	稜傻綾陵凌菱鉻後鈑番鋒稞販板瀲反憂廈賂略格秒皈返扳各冬
瑞	湍環瑛玥而珪班琦耑揣瑤玨瑜耍斑瑁琛耐端琯璀琉琨踹璃璜琥惴琿喘
蕙	穗惠慈鐵蔥惹栽哉團磚傳薴截專苦芾芰卅弋轉
籽	李季米好仔粥料敉粒粗粕悸子孚字囝屘粳糖糠憐燐遴孝孛存孱
話	誅詬詁詐託訴諛許訢訐訊訕計訃誥詳誠詢註評詞詛訶誚誧課誰訪訣訥
遐	霞芟夜瑕蝦沒浸股假又葭豭投設般煆候侵暇疫
服	報腎候堅股捌刖腱脹胳腋別腳鬥又爭前菔緊豎賢
癖	劈薛僻宰滓蘗鋅檗瓣霹梓辯辦辜避辨莘壁闢璧臂薜辛辮擘
瘢	搬發廄鍛般緞澱燬盤磐槃疫轂芟殷段股投慇穀毀殿殼役
婁	笛樓岫屢螻數簍僂胄呻冑坤摟縷屨砷娉妯迪嘍柚鈾褸鏤油由申伸袖抽蔞神宙
翟	羿翌習濯擢櫂曜翠翼耀躍廖寥翁遢榻嘐膠塌僇
哄	異巽寨暴拱鬨港咩搴供嘶共噗寒烘恭基譜洪
芾	荸肺沛莆芰苦葡葫卅悖脖孛莘萋華著蒲甫嗦嚏灞
清	倩請猜精績債蜻磧情菁積睛責嘖晴蹟鯖漬青靖
襠	鐺檔擋噹儻當鏜膛讜黨螳瞠嫦幅儅尚償福棠掌堂
莓	侮梅晦海悔黴每誨母拇姆茶苓蒼毒荼荃毓蓓敏嗨
爸	疤父芭邑笆巴杷肥把吧斧釜琶耙爺爹爬靶浥葩邕扈色交梔
鹹	摻箴後減喊垢緘逅鹽威滅滷參慘滲縿鹼鹹戊鹵螂廊戌詬糝磊石
窯	糕羔窖羹窩窟窘竇窒空穹窪竄窠窄突簾究竊膳鎂
俺	佑怖唏侑希奄健價嫉庵仇由僚佐烯倚便伸佈鈽菴俟醃淹晞鵪掩
遇	偶寓隅耦邁禺愚癘藕遝還萬迴禹厲懷壞邏甲巾
控	崆倥腔挖搾硿空邃潸窒搾麻痲穿拭拯按搓穹弒抵技豐窕窄突窠簾究穴
磁	碘磋礫研磴碾孳碰茲砝矽硫碟磚滋慈磊磯磺石
聶	攝懾囁躡鑷耳輒茸聒耿恥洱弭取爺聱聞職聰椰陬耽耶
魔	麻塊糜蒐麼槐蘑愧瑰嘛靡麾摩磨魘朮魂魄嬤傀幾
驅	馭駁馱奩駙媽駝嗎馳騎驗馬罵駟駱駒軀嫗馴駛騙駢嶇驕駐嘔驟樞
薛	薜辯癖辦辨闢避瓣僻辮霹莘滓辜辛闢宰蘗鋅梓
火	少傑尖淡煤疢竈焚半啖米炸灼灰炙夥不燒烊炊肖痰烘烤災炎炒燻炯炬燃
改	己已枚畋敖收放牧玫故敉敝敗啟敕敞敢散敬敵數矢忌矣疾
茄	痂咖荔迦伽加另脅嘉叻男力肋若架勇艾劣協劫助勒勘幼勤
鬨	鬥異巽共烘洪拱哄供鬧暴搴寨塞寒隘港基龔恭廝賽撕嘶鎰溢
昏	氐氏婚衹底抵泜柢祇胝低牴砥祗紙舐旬耆湣詆
證	請詭徵譙諾謀諂談懲謂嶝譟橙磴諭諳狀誼歪諱蹬譆訊譫焉澄譎諮謨瞪燈譜症諒譁諜正
瑯	榔螂廊郎琊班斑瑭玨琅球琺琳鄉玳瑰玖王晉瑚瑕椰綁嘟琍梆挪娜哪擲
貧	鋇貝隕貪慣臢潰債賀瓚賬遺貨岔積賡財賸盆責簣忿賁嘖賒損寶匱鑽賞分圓賽漬狽負實
狄	逖荻狂狎狙狗狠犯狸猓狡狼狹狽狷猖狐猶狩猜猙猥猾
霑	霪霖雯霽雨霏霆霜霞霰霹霍霄雪霎露霾靄霓震雩黴零雲靈
袍	抱砲刨忠苞皰劬泡炮胞跑匏咆鉋包巳鮑庖雹飽 
迴	稟茴徊蛔嗇懍回凜遇檣衰裹薔迪遝還牆穡卜蓑卞
槨	廓郭墩燉榔椰梆敦孰鶉橢嘟擲挪娜哪躑鄴淳惇享
舉	與歟譽嶼摩臼六鼠舀舅掣舂挈兗舊閻搴裒袞冥臾身交稻潟樁滾摘滔搜
屆	屈尼己已忌厄崁凹峙杞妃崛氾屁屍妮呢怩倔掘睦
頷	頡頜碩額領頌煩頂頰頻頭頤頫顆題頗類頑頓頊頒預須項顧顥頃顯囂
鈕	妞金針釵釦疆紐釙撳嶔忸欽鈿穹錳錐扭銻鋰釘醜鍵羞銘
巽	僎撰潠選巳哄異巷鬨共烘拱洪供寒塞寨搴暴港嘶
們	僩捫門閃嫻澗燜問閂悶閑間閒簡倡但憫潤閥藺
碓	礁誰唯雊確磊雕譙雒石歌椎進淮推惟堆砝錐準砍
瞬	睬睜舜瞑睛眸崩瞪瞧瞞瞠瞻瞎瞌矇睽瞄睦眨眩矚盯目
助	鋤勗肋功勤且勁叻脅劫劻勃幼觔勘勛力男勇另
您	你愁願慼憑懸悉悶怒思急忠芯志慾憊應乞乾愾妳灼穌仔鮮
觸	鐲髑燭獨濁躅蜀角觼觴斛觔歜賣胛襬鐸擺曙澤擇嘴鉀柙狎押呷閘曼匣
址	涉扯肯企垃逃遣啃祉趾賦壢步焉芷怔止恥武歧歲症歷正
番	禾稞香委審蕃潘播墦秋幡秈和私季禿稷繙蟠秀黍菌稍稚租祕秣科秒利
激	檄繳竅邀倣放族澈遨淤嗷傲敷漩撤徹微遊傚攸泊簇
臚	爐瀘鑪驢鱸蘆廬盧膚濾擄墟噓顱慮琥唬瘧虜遽璩據噱號虛
塹	暫鏨斬嶄慚漸斤圻芹昕析近聽折沂匠堊斧斯晰淅逝浙斫祈所欣
癩	籟獺瀨懶賴簌速悚初束漱辣嫩嗽喇痳痢敕剌疲瘍刀枴
勰	力加脅肋叻男另劫助幼協迦咖伽筋痂荔勇思茄劣
轟	蓮範載車囀轉轄軸軒輦庫軍葷暈鰱鏈攆輾輯輻褲輜輥輒輔漣較軾輊運
糧	量糟糢糕精桿粗粕米查糝糯粹糉楊稈粉粳粒料敉籽糞
缶	缺缽缸罈淘掏啕萄搖遙榣罐陶瑤午七佗什罄謠
仇	咦姨胰九夷痍旭侑軌究佑鯈矢俠友丸彆仃枚知畋佈俟倚伽攸矣疚疾
粒	倍粹焙糖籽垃糢泣粳接糙米梓糠暗樟培拉立位昱粕站料敉糟笠涪糕粗黯
訛	訖詣診詮誨論諭訥許誰記詐訕託計訃譙訓誑誕謎謝訣訢訪註詁詛訴討
海	泠嗨毒淪汽滄洽渝母梅侮姆莓每拇毓黴悔晦誨
乘	秉利禿束禾秧俐莉痢簌梨琍忠籟悚祕犁秋速香和委番秈私蜊獺
硼	碉磊棚砠朋胴石硯崩硝噯銅桐洞恫峒筒泵受硎砌鵬碘碓碩歌確砧砝砟
殆	殘歹殮殉死列殯殲殃歿殊飴颱殤殖胎迨治擡怡始冶咧夙
警	言擎譙訾這謙謄謎敬譟驚讓儆譬訃計識謫諄唁信檠訕謨誓誶詹譜譴諒譽
茶	荼荃葆咻休苓莓蒼搽菜荏花榦棻葉蕉蕪藥荷蓓付
碑	啤埤脾裨斫箄硃砥砟砰卑陴砂鼙顰牌痺睥婢磊砭俾石
蜻	倩請猜精蟲蝠蝓情菁蚌螟睛蛤蚣清蚶晴蜩鯖蛆蝸蝴青蚯靖
虛	虜虎謀墟嵌甘某煤虞甜慮疳瘧膚虐蚶鉗噓柑媒盧酣坩虔
矜	務矛吟鈐黔茅岑橘琴譎霧伶泠拎侈蛉捻唸冷稔鈴筏多
屨	履屜屐屢褸簍薇癥樓鏤嘍摟覆縷螻樅髏桁律彿
嗉	素嗦縲嘖嫘漯績鏍潔螺騾絲喲糸縈纂絹結細絮累系
輦	轟攆庫軍載連陣範車輩揮軋替蓮葷暈夫褲漣運暉軸軼渾軟鏈軒軏軌囀
次	砍準凍恣嵌玖資款飲欽久炊坎疚畝姿諮茨吹歌冰欺欣歙
瘠	脊疢灰痰癆瘓希有潸恢痞奈然盔爻大鋼錚銅瘟瘺瘉療痣痠癘癒疸脅奔
蓆	蔗席苔英滿蒂莽瞞幕懣戒弁械蹣拚燕庶度萬蕭莆茂荊巾瑛
拋	脅鋤劬勝渤慟黝勉湧尢力勗勞筋肋叻加務飭踴男努痂窈另
泌	鉍沁必祕祕洩洵沌池密泡洶勿瑟蜜怕愧謐柒泥泊沐汨沙沃沖吻汝汕汁
踝	蹕足跟跦跚距趺趴躋踩踫踞跼踵跤跋跌跛跑趾蹼踐踏蹂跺跆蹲躁躅
姓	妒猜拜旌醒笙牲妖腥甥生婊牛產性隆娥惺妊星猩甦鏟
佰	侖捨縮會儉嶽仁僭佞奭貊丘儈倆兵倫陌全偷蓿百便合餘伍佺偭宿何弼
曲	曹苗尊農漕嘈槽遭茴茵描錨蛐撙樽遵糟田廿童菌萬瞄儂濃澧噥膿
裂	陷冽裘例咧褽迎襞袋裟依裁製列衣邱襲袈裔裝裳烈裴鬧
役	芟殺穀後復骰殿殼沒彼股殷投設毀般殳毆徨段毅疫
億	噫憶臆倍僮位暗意樟漳璋境幛獐障鏡黯瘴音竭諳蟑章
稚	椎雜榫樵黍禾進淮推惟堆唯錐秋秈和私稔稞碓睢雉雊種稍雒雅雄帷租
澴	還環寰遝儸鰥玀囉邏鑼楞愣夢蘿籮甍爵篾薨蔑
琳	琍痳弄玥王玳瑕彬班珊玫森瑚玖淋玻理玨珠瑰瑯斑林琛枉玷玟琺霖珀
歜	蜀燭濁鐲欽飲畝炊坎吹次獨觸躅髑歎歉歌歇欲軟砍欣玖廢疚
命	合拿盒翕侖俞登會砸叩仁儉答哈卻恰拾洽凳閤簽籥佞郃仰捌腳僵撿檢
蹟	債嘖積磧漬績躓責遺潰槓倩趺蹣蹦蹉蹈蹶賸踩踡跪隕損跎足簣匱
繚	燎遼暸潦撩嘹僚療寮縲絲繒綺糸織縮縵繪縉縊繽線緩緹續綜綿綵絹綏
儘	燼盡佻俳盃遣遺潰倫跳侖偏佐俏腓啡排眺桃逃姚挑洮匪匱簣痱菲屝盔
嬸	瀋藩審嬪鄱嫁婉番墦播潘稞蕃繙幡妹翻瀉蟠稼姑妓鞦東禾委
寵	膀滂鎊矓攏龐壟隴徬嚨龔傍聾襲蘢龍磅榜旁螃瓏籠朧
阡	陲陴阪陞弔仟降隍防阱阻陂限陌陣陳千阿陡陝隊隅阬陀院陶陷陽隆隙
諦	謗啼諳蹄諒締識訃謂諄誶讓謫詨註訪謎蒂諺謀諜諭諼諾誼談諉請論諂
嶸	榮嘮撈癆熒塋犖勞營縈螢瑩峭鶯綵毯彩崢肖炎採
飭	飾餘飴餒餞飲餌館餡餵饅饒饑飪飯飼餃餅飢餚餽
秦	榛舂奏痿臻痢矮泰春奉禾湊揪揍樁播萎審蕃馨倭逶愀啾潘墦穌鍬
焜	棍混錕琨餛崑媲鹿罷篦昆皆揩楷偕陛比階琵焊煜煬能諧紕毗枇沘批妣
苞	抱砲苟刨芯皰劬泡炮胞跑匏咆鉋包袍鮑庖雹飽 
慰	熨褽尉蔚屎忍惠悉糖糠紂憑愚米寸糝掬忖感急怎忌寺守弋憐穗涊迷恃
廖	寥嘐僇膠穋繆謬擢濯曜櫂摺褶耀躍翁翟蓊習羿嗡
陋	炳柄病阮隔陌丙阿除隋隄險限阻陘弔降院陞陀陪陸陰陶阬陷陽隆隍隘
磧	嘖漬債積績蹟責遺潰請槓損碩磊簣匱賸隕韻瓚讚圓
瓶	甄甌瓦瓷甍甕並井耕胼迸拼姘鉼併阱摒互屏矽餅沍妤駢溝搆媾構遘夕
唱	娼倡晶昌猖鯧喝暘暍曝嗜嘈吧邑暗智碣惜措袒借捏湣涅浥坦怛但澗踏
猖	猩娼唱倡狠晶昌鯧狷獐狄猛猙猜猥狩猿猾暍暘獗獰獷曝猓狼狸狎狙狗
蘢	龍攏籠龐寵壟
棵	困顆柙果棟森東柬番捆稞林巢課樽猓裸窠楝梱裹踝髁
鋒	洛扳烙咯板鈑絳蓬返峯恪篷蜂烽賂降縫胳販逢鉻咚格略峰
乎	悉釉釆呼釋竊米蟋咪屎迷狄籽敉料掬粒粗粕粥粵粱
騵	驃馬騾騎驗駱駝駁馱騷驕驍騁駿驛驟驢驥騙駢駭駐駟駛駒馳馭駙馴
娑	裟鯊沙莎少祇妙祗紙杪炒鈔吵抄縣娶婆省委妥安劣姦衣氏消淡派炸眇
卻	腳欲叩卸溶榕熔鎔蓉卹即印卯俗峪浴裕命容谷
蟀	蟑虻蛀蟲蠔率蛉蝓蜿蛄螺蛇蚌螟蟬蚣蛤蚊蚪蛟蟒螃蚯摔
綜	糉繽縮崇縹棕宗紜緯絹蒜糸綻緩經絨蹤緒縲綵嫖縯綰淙緝鬃緹綺綸綏絲縝
汨	涅湯濕澗渴漫瀑水泊洵混曰日沁沐沖汝汕汁淦湄潤踏昌晶
族	旋旎旅施於放旌旖倣旗嗾鏃簇邀方激檄俟仿淤繳菸瘀竅
伯	遑迫作湟鉑任錦入怕件篁帕仟陌腺偕白棉柏粕煌傀葩嗥拍泊泉舶惶 珀
淫	滔沉浩深淨逞浮壬望渾湲程溪荏霪滑衽妊任梃挺洞庭告呈
捐	損涓娟扣狷拐揖絹揹搞胡咀硼拮採擡喟撰操捉抿湖啁高亭葫臺豪
繼	組統絀細綠繩綽繅迷絢緘繡斷維縷緙米糾緒絞縲絃眯紳縑絰紼緣絲緇紲紱練
骼	胳咯骰鉻略烙格洛恪路賂珞駱酪貉詻絡客閣骯
颶	颳颼颱俱具楓瘋嵐風颯諷飄蛆阻箕凰蝨祺琪殖欺棋植期脤組淇租祖
圬	污虧誇娉垮聘佞騁朽巧垣兮堪仁胯愕鍔三二萼
漏	瘺雨霄雯霑霖霍雪霽渥霎雲霜霪孀櫺零霆震黴霓霏雩霞霰霹靈
跼	距侷踞足踝跟跚跑趺趴躋跆躡踫跤跦跋跌趾蹕蹼踏踩踐躁踟
衰	卜甕言畏簑猥裒煨逶卞威偎婁喂娉褻酋姦畜酉迴哀表裹稟長襄衷逕蓑還
硎	研荊磊刑礪砰硬捌喇硼咧冽砠砍斫碩矽歌磴石型前
鴉	鳴牙鴆鴣鴨鳩鴿鵑鵝鵠雅鶉鵲鶴鷓邪鴒鵡鵪鷂鷗鸛鳶鴦鷹
旺	玨皇枉汪王匡全閏狂惶湟煌遑旦篁玥隍弄凰徨蝗韹班斑昊旱量
泵	磊石巖砂研砍拓矽砧砝砠砟硝硼碓司歌洽洞斫砷砰砸砲硫硃碌碰碘碉
戛	夏嘎廈自眸臬省眉算篡洎咱纂首湄媚楣賤鎳筧目狽貽賊道兔
粵	朽兮巧娉誇聘污圬釆乎虧騁悉呼畏竊萼米粳釉猥愕耨胯蟋鍔垮糯
姚	挑洮佻桃逃眺跳晁窕兆北妝俳邶啡排腓戕壯覜頫遣潰遺匱簣
除	陷隄陞院陪際陶隔險陋弔陸褕塗陡荼徐阿阮陌陝附陰陀阬途隍陽餘斜陳敘
舵	船航舶舢舟舷蛇艋艘艙艦舫舨沱佗艇跎陀鴕駝
腺	線帕泉泊湟鉑迫柏拍怕伯鵬白遑煌嗥隍棉惶錦舶粕珀
喃	楠南嗦哺嗶咕味吱嗑嚏哮嘩嚀嘲冊皿卅唾跚哨哄咩柵咀姍肺吶沛喧嗜
旖	族於旗旋旌旎旅施放漪倣方倚仿嗾淤邀鏃瘀菸簇
姆	拇每毒母侮悔海晦梅莓姻娌誨黴敏毓嗨嫘育妯姣姪妨娘娥如妁嫡流迨
鑽	臢瓚讚贊貧損鋇賸遺積潰漬慣嘖隕債寶簣賽圓賁
遛	瘤聊餾留劉卯遍籀迎茆霤貿透卿榴迪遷鉚泖溜柳
囝	子好字孚仔李存孝孛季籽孱孕錳困孟享厚俘屘浮猛蜢學
口	吐呆句叵回臺吉如扣杏品釦巳只右古佔石叫另叱叮叩叭叻叨叼吋吆吒
韓	違幃偉緯闈葦圍韋拿榦幹廾韜斡韌朝戟缽斬乾笨苯
溶	鎔熔俗濱滓渲潸欲沱谷裕腳容汁卻瀋峪淙蓉榕濘瀉浴
邋	臘獵蠟鬣巡錙淄繅輜緇腦惱瑙巢災逕邕勦剿姦妄
聽	德廳罹寰患憲聰環還澴遝愣甽薨罟匣鰥懵懷壞腮楞鉀胛柙押呷圳串甲
鱔	繕膳鯛鱖鰓鯨鯧鱷鯉鮭鱗鰻鰾鰭鰥鯖鱸鮪鮑鯀鮫魷鰱鰍鯽善
健	蜓奴夜毽涎假肄梃肇又建挺庭聿怪隻候腱侵雙鍵
拭	貳摭找搓代挨拚祗擴膩牴抵試弋式拯軾撼弒控擡
渤	勃湧沛脖浮悖荸孛慟鋤拗拋筋脅黝肋勝踴勞勗窈孚
陰	蔭除險附際阮陶陷院隋陽隆隍隄鈐隔陋降阬吟伶隱弔
砂	吵硝磊石砟炒杪沙抄妙鈔砍研眇斫砧砰砝破砠矽硃硯碑碓歌碼磯磷泵
爺	椰耶聶梆陬聱父邦廊聞茸聲爸斧綁挪娜哪洱弭郊擲攝懾囁鑷
扭	扣揉拄找撲扎疆手打掛紐挺羞忸揆捫抒拯推挪醜扔挽鈕妞換
落	喀擱露菠雒洛蔆藩莎藻各茫蕩範萍蒲蒞蓬菱閣客芟反路鉻略胳珞烙格
兮	朽粵巧誇圬污娉聘虧答叭扒徽騁簽籥佾垮趴胯僭豳
撼	憾感擡怠找拭拚摭挨搪摑惑臺擴摻搏掬怡捕拔惹恕
胸	洶肫匈胞屯兇愛盹鈍朋沌芻囤胱胭胰朕肥肱肚肋月
尤	獻袱哭憂蹴尢優畎畚疝吠稽伏戾魷突嵇臭就犬莽疣
還	澴遝環邏寰儸玀囉鑼懷壞鰥楞愣夢蘿籮薨篾爵甍蔑
防	坊舫肪旅枋妨菸彷倣房遊訪芳紡阬方旁淤仿瘀
融	蚤虻蛔蛀螫蟲蠻隔蛋蛄虺蟹蚱蚌哥蛐閩膈蛙蜃蚶蚊蝕蚪鎘嗝蛆翮蠡鬲蜇歌蚯蝨
意	音竭憶章暗億噫臆竟立葛瘴妾漳樟黯童昱昔煜幛境獐障璋站諳鏡
邵	郡郃部鄙鄗那耶郢郾鄱啊邱邸祁邪邦邢郊郎鬱郭都郵鄘鄭鄴召
露	霞霆霰霪霜霑霖落雯雪靈雨喀霹霾霧靄霽霍霓霄震雩霎零雲擱
耑	湍揣惴喘而瑞端耍踹耐需顓巖儒濡懦嚅帚炭崙串糯
璞	瑛弄玥王球班珊玫琪撲玖樸瑾理玨珠瑰僕濮斑瑭瑣玷頊噗琢璜琅蹼 珀
枝	鼓抹取植梂楮末豉技楠茉山吱肢支林沫枯妓杖芰棲歧岐求
褲	轟庫運暉渾揮攆琿漣鏈蓮葷載暈輝車連陣軋鰱軍
窪	簾窮窟窄窘澆捱涯空窩娃竊窒窈掛圭窕佳畦究桂蛙崖窖穹突窠窯竇封
瓷	姿恣諮資瓶甄甌瓦甍甕次諮茨懿癸多嵌登爹葵凳闋互夕久丁移栘揆睽
溴	嗅臭淚捩唳沉媳熄溪瓚臢鑽袱犬虎添混澳洛泛讚洗畎況沃吠伏獄息戾
狷	猜猾涓捐娟猙猛猖猿獰狗狙狄狩猥猩絹獐獗獷狽狸猓狠狎狂犯獅
縿	糝滲摻慘絨纏縲絲縛絃緘紱糸縉織繙編線繽綿綵綏絹結絕絡絳紹終紜
豕	楊逐墜場豢刀遽豬劇邃豭揚篆啄煬璩琢腸據鍚豳瘍暘噱喙隊豚
錫	鏝勿匆踢惚銲剔物鉍鑤惕易賜囫錕鍚忽蜴刎吻
塋	榮熒勞犖瑩縈螢營鶯嶸癆嘮撈肚綢鯛炎周肖炯
庇	屁昆批妣沘枇仳毗比能紕屍死花疵皁尼它牝叱化
噤	襟棕蒜禁標糉捺淙膘嫖漂鏢崇瞟縹綜賒際驃鰾蔡察
貼	賑鋇貝賄賠賅購賊員敗沾贖賬佔帖則貶財戰賂賭賦貯賒販賜玷賺黏粘賤貽站贈贍
鷓	鵲鳴鵑鵝鴨鴣鳩鳶鷗鶴鷂鶉鵪鵠鴿鴒鴆鴉鸛鷥鷹
綽	組統細絀絢卓繡糸維紐紗紋緙紀悼掉緒絞縲絃紆紡絆織紂納絲棹縴桌紲純
褽	熨慰裁裘裟袈袋依襞製裴裝裂襲衣蔚尉裳屎裔
鍛	緞澱搬燬段瘢發廄轂殿般殷股投擊疫芟銖仟穀毀殼役繫慇
諂	陷誦詣詔詭諛詼談託諉謂誥證詐訟訃訖誕計訊譫訂餡啗譎訕詰誡詫誌
軍	漣軸陣渾軏鏈運範軌輝庫揮葷暈轟褲輦輩載蓮軋連車軟囀暉琿軒
薺	齊臍濟擠儕芒霽躋莘芳芷劑齋菽蓑菩荒蕭苗芯昔艾蓮蓄蒿蒂萃廿
詻	誥設咯詰詔語諮路鉻諉略胳珞烙格洛恪諷詼賂酪詆誤誘絡諾骼譟話誅
廢	撥潑醱發殼葵闋疫芟廄歜飲股投疚穀歌睽骰毀殿揆欽殺殷畝般段砍炊
庾	萸腴臾諛牟臼戊舀參舂座廉茂庚牀戒矣戎弁臺裒底身戍戌成戈啗焰滔
遊	遊享旁芳房漩肪枋妨坊仿防瘀菸方訪淤舫紡倣彷
噎	壹嘻脰哈吐豆同嗑逗唔懿咀銅桐胴峒恫洞痘筒豈
欽	歉欺炊坎吹歟撳嶔久疚欲歌畝砍玖次鈕軟歎欣灸
嚅	懦濡儒燸糯孺蠕需擂鐳喘壩灞蕾優擾亙而喻唔恆電雷耑耍
脫	稅兌侃兗克臢閱腆鋁悅銳兄祝袞況裔嗅覓蛻說沉
章	瘴蟑竭覃獐子意彰漳憶噫草幛億璋暗樟立障竟早臆音妾童
微	黴徹徵御街銜徘衡衍衢循徙徠徒很徇徉律徊彼往復從徐役
譫	膽簷澹擔蟾瞻贍簷證諂詭訊譟譜識譎諱謀諾謂諳讓誼諒談諄請誌語誡
踵	鍾腫湩種跦董趴跌慟踝跺衝足踞蹕跟距跚跛躋趺重
鬚	鬍鬆髭髦鬚髯髡鬢髮鬃髻鬣蘋顏嶺籲瀕傾巔癲貳擷澦噸
光	恍洸晃胱輝幌兀耀元丕嶽完沅兆此北阮呸孔炳胚虺軏煩
菴	庵醃淹掩俺奄醃艾薦幕希鵪莫惹荔若由哎莽畚莢笛胄冑宙布荻茄袖鈽
批	沘妣枇仳毗紕庇屁昆比能指牝揩砌叱化皁尼它
薜	癖闢霹避僻薛闢辯辦辨蘗瓣辮莘滓臂檗擘壁辜辛
棹	掉悼綽卓罩枓樸梓柱樟早校柿枋桌楨核林梳杭檀椒章草
栓	遑王湟檜痊班銓玨玲框瑜斑荃槍椎琳全詮梅筐枉煌檢隍潤佺珍惶榆拴
旗	施旅旌琪菸簇倣旎旋放棋鏃箕於旖方淇嗾其祺期斯族淤簸欺仿瘀
脂	指能詣旨比昆毗枇沘批妣仳庇屁叱化紕匕覓尼它
十	卉穴安宋什汁戎針七千士丈幹廾午卅豐支鬥毋古未末早耳
僇	嘐膠穋繆謬寥廖擢濯曜櫂躍摺褶耀翰翟習羿嗡塌榻煽遢蹋瀚翠蓊翌翁
洵	沁荀筍徇洩泌殉沌池絢詢旬洶泡汨恨怛湣柒耆
辰	賑湛農圬堪佞脤甚儂振辱脣巧宸膿蜃韭娠三戡濃二晨誇噥污震
裨	陴脾婢埤啤俾碑睥牌箄痺卑衫鼙顰衽千衹箠阡仟褫襖
絢	組約細絀綽詢徇繡糸維紐紗紋糾紀緒縲紆絆紂縐紙納絲殉紲純
鈑	鉻鋒販返板扳皈叛阪逢賂略胳烙格洛恪咯咚疼客
姊	妯肅嘯鏽蕭簫姓妝妒妨妖妙妊姬娣娥如婢奶叫嫌繡娉瀟姚身女姦
廈	夏嘎憂戛菱凌傻稜綾稷陵後瀲反峯各冬處賂路鈑販珞胳舨皈板返扳
虺	蟲蝨融蚤閩蠡蝕蟲蛋蜃蜇虻蚊蚪蚌蛀蚶蛄蛆蚱蚯蛙蛔蛐蚣強蚓兀螫蟹
葆	褓藻茶蓓荷荏花保堡荼澡噪燥躁蒼荃呆莓褒苓谷譟
塵	鏖麂麋麝麒麟麓鑣麗鹿毗庇陛比昆屁能枇妣儷批沘仳灑曬欐邐
銨	按針晏安鞍錠鎔鈷案鐵氨鉛貯銬鎮金宴姦滾鉉銲錯錢錙錨鏍鑠鑲銀鈿
根	退恨垠銀艮痕狠眼限杳很杷跟艱齦查腿褪偃堰良
種	腫湩鍾踵慟董衝重動懂秩稚稞祕秣科稍租秤秋秈和私程秒禾番
往	待徠很徵徜徹行律徬彼徇注彷主徐循徉從徊柱徒彿駐徨徙住
靜	掙錚睜淨崢猙諍箏靛爭青晴清情倩菁擂精靖睛猜授朋硼
氳	氤氧氣氦氯氬氟氖氮氨蘊氫氛瘟溫慍媼塭愾醞
限	很弔陌恨垠退根銀陽隄狠阻阱陳眼阡艱艮痕阿陣陡陝陘陂防陴阪隅陲
盟	盅監盔益盍盎盃盪扁盂孟皿冊柵姍盜盛盥盈珊
揪	鰍琍秋秦禾鞦愀潘蕃逶啾萎墦稍播鍬痿俐穌倭愁審秒
擬	凝礙癡疑批指牝丸擲拙汍舛扎摧揩揍挨爹撳掀挑毗拋枇沘妣仳執抒沃
墜	豕隊豚逐豢陽墮篆豬噱據豭璩豳遽場喙邃陌墾雋堊瘍劇緣暢暘楊煬腸
叱	比化呢仳妣批沘枇毗砌匕它尼屁庇昆北此牝能詣紕
衽	妊任壬呈廷浩造燻告薰飪皓望窖聖衹裨逞淫誥酷醺丟荏
射	待寸守身寺專榭麝尉忖辱耐討吋躲謝對紂村付肘尊封私
碎	卒礁砍粹碓醉傘磴瘁翠硫磅砧礎淬悴硿萃歌誶磊石
寰	澴還環夢籮遝甍篾薨蔑蘿儸囉玀邏鑼爵楞愣鰥
漁	鯊嚕櫓魚魯鱉鱟淡鰍潟鯧瀾鰓鮪鮭鯉渙鯨鯖鯛沒鰭鰥魷鮑鮫汛汐鱷泓
蛙	虻蛔蛀涯蟲娃蛭蛄掛圭虹佳蚱蚌蛐窪畦蛞桂蚵蛾蚣崖蚶蚊蜩蚪蚓蛆蠅蛟蟯封蚯蛛
魂	魏塊蒐魔戍槐譏愧魁機芸雲瑰魘嘰魄傀幾餽璣醜鬼
籍	藉耕藕耒箝模耙糢耜耘耗笙昔牛鵲耨耦措籀簌篠箱箔筷節萌符策筍筆
夏	廈戛峯胳皈販板返鈑扳夔處疼客格烙珞舨咯叛恪洛略逢咚版賂路阪嘎
鈽	怖佈希錦布烯晞唏稀滿滯巾帑棉啼錡瞞蹣幣席
瞻	矇檐眨睽瞑瞬蟾瞄瞠睜簷瞧瞎瞼睬睛眩瞞譫眸瞳擔矚澹瞪詹睦贍膽瞟
襄	囊孃曩攘壤嚷鑲瓖禳簞器闡萼巖靈喪嬋讓釀裹裒囂衰高京鍔禪憚彈瓤
多	夠令舞飧外名宛移哆舛矽夤茗夥栘夕侈爹苑汐銘
疑	擬癡凝礙丸汍爹執比飧夭夕匕痛多雄釩峨祆矽沃妖牝汐汎此舛弘外叱
瞟	膘標漂嫖鏢縹鰾驃蒜賒票際棕淙捺崇噤糉綜襟蔡察
坊	妨仿枋肪防房芳彷紡旁舫訪倣淤遊方菸瘀遊嗾漩鏃簇
孩	垓咳核閡該賅駭骸氦孜孔孑孤孫劾刻孺吼亥菰
器	哭囂嚴區獸吠單咒襄莽臨簞闡囊巖臭突戾嬋彈憚禪蟬獻儼畎伏
遭	漕撙儂曲禮曹蛐暗膿蹲樽遵濃澧嘈糟音邁噥穠體槽童
珪	玨班斑王圭僥澆撓嬈燒橈曉鐃璀蟯理玥堯弄琉珞玲珍琯琛琦琥瑁琿瑛
嚨	攏朧隴瓏矓寵龐籠龍磅啼壟鎊謗榜膀滂傍聾龔
社	禧禱竈祀祁祆祕祐祖祚祥結祉祈祇祠神祝視祺祿禎福禍繞續
銲	焊桿捍悍稈趕鍚旱乾錫錕幹鏝鑤岸袒怛坦但肝桿汗奸竿罕旦
慼	蹙戚願槭憑愁您懸不上邇感惑惠恣芣忘忍戀否示滅杯壞
遣	遺逃止潰儘啃燼扯址啡步正芷肯企逼過蝸這逗造迢迨涉祉歧怔跳腓眺
責	鋇貝貸貫賃貪貴贊員績債賈賀賬磧貨資費積財貧貲嘖賒蹟貢漬買青狽負
瑣	鎖頊玨瓚珊玥瑁斑班瑰璞理現玷珀玩玟玫玖琛瓔王
抄	少捎扣擋吵妙託找撲緲扎手扒撇紗拌莎炸沙省劣砂娑鈔眇杪捲炒渺拍
索	嗦絲累系紊素紮絮紫繫糸喲縲濰緊繁縈細辮羅蘊纂紗紋純紐納絆絃絀
絛	攸脩倏鯈條修候似紊繁爪係仲糸悠傲傚做倣細敕收俟緊累系繫
萋	棲淒悽妻苦芾芰華著莘藪卅葫菅薴蕙萇莆萬茸草茱茉苗英蕭芹芥芯芷
攝	懾囁躡聶鑷揖輒弭洱聞茸餌趣椰陬耳聾聱爺撮楫聒恥耿耶取聲聳
諾	謨謊譁護誡謀講詰詼譜詳謂諳諜諒談誌誥詻譆詔譟議訟諶謙謹詁訣訕
窟	掘崛倔窘屈窖窩窯窄穹空竄竇窠窒突簾究窪窕窈窺出
誘	詣詩詔詭謀詼諂託談諉諍秀謂誥誅認繡譟診詻透詐訟莠設訖詰誡詆詫鏽諜誌
禹	禺巾偶寓遇愚匝帥帛隅吊布耦邁癘庸市央盅胎帝怖帖帕簾席笛希帷佈
楮	渚堵褚睹諸暑著屠奢箸緒賭署豬赭杖嘟者煮都
幼	劻劾另男動勒勤助劬坳勢以窈肋樂叻勁勦功勘奚劫力幻拗勛觔勉黝勃脅
洫	恤血洎卹澳泊沃皿冊盆盪派活沂汎溢溘溫濫洗柵姍湩浩添淪湄潘潟瀘
玖	坎玨王吹玫玥炊次砍欽歌歡班斑崁玟欣玷珊玻珀畝理琢款欺瑰璞久弄
泛	洛漱淚泠澳涔湟眨沃麼之潘添泳漾泜芝貶飲溴潑羨久澄汎浩泊乏潟砭
澦	預瀕噸擷傾野杼抒妤貳序舒嶺蘋頂贛巔鬚癲籲
餌	飭餞飴茸餃餚餉飯聳饉聘館聯飲餵職飪蝕餓飼餡耳餿餅餽飽飾餒餘恥飢飩
旎	族旅施於旋旌旗旖放方倣仿淤菸瘀枋肪妨坊嗾鏃房芳簇
宅	吒託牢詫寫印託剩筍審安宋它卉穴客十守宇字宏宜宙忽宥宮宵筷忿亳
偺	晷咎倡俊傻伉伋反借侵僧佾但優鈑板返扳候佩各冬
侄	至窒倒到致
鑲	攘孃壤嚷釀禳瓖曩讓鎬襄鉉釙鎚偯喪鍔槁搞瓤鏈囊
籮	夢環篾囉楞罹玀寰維濰澴羅甍薨蔑鰥蘿遝鑼爵愣儸邏還
嵇	稽疣私就魷尤秈秒穗禾禿稈程稀稜稔移稱稿稼稷稻積穡穢穫稍稚稞秣
犁	漱嗽利痢琍牯秉莉看籟簌牲牡牢禿件梨牝牛牧蜊牟秧湃俐牠乘秩剁
炬	拒鉅巨苣矩距局凹凸炤炸侷竈火炎渠烊烘烤炒炊灼協荔兕尖少
倡	唱娼晶但昌猖鯧借偺暘暍曝替僧僭們暗僩傷趕踢
神	祠祈祆社祀呻祁祐坤砷縷祉祇祝祥申紳伸祚祖福祕
蓑	芒蒿簑薺蓬衰菽壞羶菩懷蓮芳莘迴哀芷荒蒂裹蓄萃蘆衷
樺	曄嘩譁華橫檬楛柑模權棋荊構蕨樽槽糢械楠梓卅葬厝
槐	魏塊蒐板魔戍麼愧魅魁機瑰魘材柝魂才柏魄析傀幾餽醜株鬼刃柞
瑙	腦惱淄錙緇輜繅獵臘邋蠟巡璣玨斑班鬣琿瑛媲琦琥珪珞璜珍環瓖王巢
遜	蓀孫菰孤吼係縣鯀孑孔系孩孜迎潔絃孺糸懸玄
脣	賑湛辰農圬堪佞脤甚儂振肓辱脣巧宸胯膿蜃韭娠三戡濃期晨膂誇噥污震
獺	瀨懶籟癩賴簌漱嫩嗽獅喇猓速悚狎狄犯獄猴辣猶狽狸狼狹狠狡狗狐狙
絞	組統細絀餃綽絢跤狡皎糸交維紐郊紗鉸紋效緒膠縲絃紡絆紲織蛟鮫校納絲姣咬縴 紱純
廳	聽寰德罹患憲環罵罩置買眾庫罟篾薨蔑夢串甲鰥壞還澴遝楞愣甽匣
幢	倍陪霾帷幀霎潼焙憧幅鐘帖接幛幟撞暗培僮瞳臆巾喱幡涪黯童
嫖	漂標膘鏢瞟縹驃鰾蒜票棕捺淙糉綜噤襟崇賒際察蔡
懶	瀨獺癩籟悚賴嫩漱嗽喇速初辣束簌剌敕懈快忖枴刀忿
彆	弊鱉幣氅瞥斃敞敝廠蔽撇敵散仇撒弩肖矢撤澈削
嗥	皋煌腺遑惶棉湟錦鉑鳴柏迫怕拍泊伯啪徨綿隍線蝗穆咯韹粕珀帕白葩
裊	鳥梟島白亡皎鳴嬝鉑鳩鳶鴃鴣鴨迫泉柏鵑泊拍怕芒肓鵲鵬杗忘伯忙妄
丈	仗考孝杖老者宏宥佬姥堵奢屠渚暑楮煮著箸褚
岑	吟鈐琴矜黔涔苓伶今拎泠唸捻鈴含念令崙嶺冷屹玲羚聆稔
誡	試諾訟謨誌認詩詰詼談諜諮謂諳謀謊譁譜識誧誠詠
牆	檣穡薔壯嗇戕妝將狀莊鏘蔣寢寤寐蛔迴姚茴徊玫稟
懂	董重鍾種腫湩動踵慟惜衝憧懵慌茱恬蔥狸裡千蕃薰童
秣	禾科秋秈沫抹和私稞秤租祕稍稚種末茉香番季委
儷	灑曬欐驪麗邐鹿鑣麒仳鏖麓麋塵麂偕毗麝麟能仁比枇妣批沘昆屁庇
剋	兢克刨剜剛刮制利剩刊削剌則剎刺剁剖釗判刪別副刑劃刎刖割刈劑
恃	待寸詩博狩褥寺痔撙怯持奪忖將傅搏耨峙傳等特樽溥遵對膊侍時磚封 
寨	搴塞寒賽騫暴異共烘哄拱洪供巽鬨卉港案基恭廝嘶撕溢隘鎰
醴	澧禮體醋酣醞酷酩酉醺醮醒釀醇醉醃酵釅酪醣醜酴酥酗酌配酊
繙	縲線潘播墦緇絲細蟠總編幡綿綵絡絳終紙綑糸
坪	抨枰秤壞評平萍圩不坷杯埂垣芣否示坩坼均圻址垢埔埤堵圬壩丕土
曦	犧羲儀議蟻糕膳樣漾義繕鱔墦對窯曝善恙羔姜美
返	洛扳烙版咯板阪飯鈑皈舨恪叛反胳販處逢鉻疼咚客格略
湯	楊濕混渣澗湟場怛坦濱袒渲漫燙盪蕩揚瀑焊涅煬渴桿腸陽暘但汨旦湄
冕	昇攙澗饞逸昌簡輓晶鏡間菟兔晚娩竟星昨勉挽冤昆免境
敏	毓嗨矣繁畋敵俟每敝敖救敘敕啟敞敢散效敉故敬致放枚牧玫數改收挨
鴦	鳶鴨鴆鳴鵑鳩鴛鷹鴣鵲鶴鷥鷺鴒鴉鴿鵝鵠鶉鵡鵪鷂鷓鷗
膚	夫虜鱸虎廬爐擄虞慮渭臚扶喟虛甸鑪虐瀘驢濾胃盧蘆虔
菩	焙涪培倍陪賠莘蓓笠昱立泣拉垃位競善瘴粒暗接噫
響	瘴蟑陪獐意鄉嚮漳向憶饗噫諳幛億菩鏡璋暗樟晌障昱臆音笠黯境
鴛	鳶怨鴆鴦鷹鳴鳩鵪鷂鷥鷺鴣鴨鴒鴿鵝鵠鵑鶉鵲鶴鷓鷗
肖	捎哨黨俏掌銷常屑削棠敞鞘悄稍當硝睄梢堂峭尚宵敝逍消誚帩
杖	仗楮丈枝枯末棲老者孝考林沫抹植楠酵宏宥茉
珮	佩珞玨獅篩珀瑰班斑珠師玻玥瓚琍楓颯諷珊玖頊肌瑛瑜毀瓊琊瑯凰王
豳	豚逐豢遽璩邃據噱豕豬豭篆隊喙毅劇墜兮緣切鍚腸煬楊暘陽揚場瘍蠡
暘	楊煬腸揚場鍚暢陽瘍颺晶暍曝昌娼唱倡猖昭鯧
摔	粹撤擁撻擠撲拄率攘搖抗碎拈挨掠接撞攆掉搞掖拉抖掏蟀擅淬悴拇撾
閃	閔閒們闊閨門閏閤閘欠間藺開閂閑閎問悶閥聞闖閉
蘭	攔澗鍊們欄爛嫻煉柬簡藺揀燜閑籣僩捫斕瀾楝閉闌練
少	烙尖吵妙祆火紗炸莎沙省劣砂娑抄煌鈔穌眇熄杪祚炎炒燻竹秒燠
倍	競陪賠焙垃噫泣接億菩暗培拉立位昱僮部笠涪蓓
裘	裁求裟袋依裝袈褽襞救裴製裂襲衣梂球裳裔毬
智	知癡佑矢右唱蜘踟疾若昌矣偌畋枚替春昔杳吞君吝邑鼇晶匿惹散敞敢
島	迫鴣梟鵲鉑鵝鵑鳩鴃鶴鳶皁怕嬝鳥鴕鴨鶯白柏笆裊鳴拍泊泉鵬伯皎
麝	麂鏖麋塵麟麒麓鑣麗榭謝射鹿彪毗廚符冠府庇儷灑邐欐曬待比
嫘	縲漯鏍螺騾累絲嗦嗉細潔綑糸縈纂綏絮系綵絹結絨絃繙維絢絀組絆紲
溉	既慨概
疙	迄屹吃乞紇訖痊瘉癒乙疹瘡挖奮疾瘓奪疥夜癡函侯你仔猴
疵	髭此齜雌昆庇屁毗枇沘批妣仳紕能北屍花齒齧訛穢比
繕	膳鱔縲縊結絲絹縑緙糸繞繹縞緝編緯纏續綺綵綸綰綏絨絡給絃紹維細
盆	侖汾遍盞吩藍偏扮鎰籃氛血鹽盂粉岔紛蓋貧皿忿錳盒監份叨分初盧孟溢瘟鑑芬盡猛篇
反	洛扳烙版咯板阪飯各鈑皈返恪略叛冬胳逢鉻疼咚格客
盜	跚盅盥孟溫盔盛盟益盍盎監盈盃扁盂盪瘟慍媼塭柵姍
攆	轟揮輦扶褲暉運渾琿鏈漣蓮暈葷輝車連軋鰱庫軍
犧	曦羲蟻儀議特牡犢糕膳牴牲牠牝牛義鱔繕樣犒漾犄牯拜牧物窯看
規	現視硯峴覜窺蜆覦覲覓莧筧靦覬觀見覺攪能夫
縈	騾鏍勞漯榮糸熒嫘螢營纂嗉瑩鶯縲綵索綏絲塋犖嗦
髖	骷骯寬體髑髒骼骰髁髓髏骸莧憤墳噴能沱佗覬峴見筧賁覓
怠	或感臺憾撼怡苔笞哉名胎迨擡始治惹恕惑冶茗品國戈殆咆域吻啕喋貽
彭	形彫衫杉澎膨彩彤彰影彪鼓彥樹箄廚珍射彬喜疹薇鼙
傚	效跤攸校鉸咬姣傲做倣皎狡絞蛟較餃鮫嫉俟交
豔	磕嗑瞌溘蓋艷闔盍鑑襤檻濫尷砝豐藍艦鎰蝙蜢溢塭籃盞
溜	瘤聊餾留劉卯淚淄籀潘茆霤貿卿榴油鉚遛溧泖滬柳
杜	桔桂橈檮檯櫝木堡林枉柱椎土竈肚樸吐札仕檣圭森塗
何	呵坷河柯阿奇苛荷蚵軻倚訶可崎椅畸錡寄汽犄琦啊婀
吞	喬夭忝吝君各笑妖沃僑嬌橋右知矯奏佑祆添轎
鞭	靴便韆革更鞦韃鞅梗勒埂哽韁靼鞠鞘鞋靶粳硬甦鞣鞍韉
渣	楊晅湟查漆淋洹碴桓湯渲澶淅淞垣沫杳沐稈宣桿喳決湘旦
獲	猜獰猾猙狩獐擭猿猥濩猖猶獷狸獗猴穫狄狷護隻攫雙狂猛
穩	急稼利香秋稔稠程稿秈禾穢稱背禿番稀癮積稍肛隱稻委穗稈租穠祕和私秒
矗	直植值置殖宜蠹誼疽芾且詛脖蛆砠肺沮姐咀沛
售	隹焦集吉隻雙唯崔雋告堆惟推淮椎進錐仕僱截瞿周奮蕉雀坐帷準桔雄
妥	孚爭月要女姜冗婪溪舀耍奚炙朋妄姦委受妻綏肚採汝安餒妾
鏡	瘴倍蟑競賠獐意焙漳憶噫鐘諳鋅幛億接璋暗樟培章障竟臆音涪黯境
盾	遁循目千自貫省相眉看苜冒肺芾沛仟算慣實箱
擔	坦揉拓逗小搭蟾簷撿逼拾揆捂譫瞻拯但澹旦詹贍膽換
腱	健鍵毽建梃挺奴股艇蜓涎肄怪聿又肇隻庭雙誕馭津服腋胳舜筵筆霆帑
繁	紊絲繫累緊紫絮紮素索系縲敏濰喲羅蘊辮糸織鏍漯嫘絛絃
違	偉幃緯韓葦圍闈韋拿韜韌笨苯這諱缽本吾逼遣逗梧晤捂悟唔衛圄
含	今念令貪伐伶岑吟鈐苓何拎泠俟俊唸捻鈴頷倉筏冷伏代昤玲俯倚涔羚
虎	虜密褫唬臢虞慮號彪虛遞膚虐溴處嗅鑽熄盧息媳琥虔
劊	副刑刊會劍劃劑剽創剩釗剎剌削刺到制判利刪列刖劃刈
惇	淳諄醇享懍哼悸悖懷孰郭敦槨墩燉廓亨惦停婷憬鶉烹塾熟
場	楊颺坦怛豚暢湯塌觴袒晝殤傷垣揚煬腸塒鍚瘍陽暘豕但壇逐堤
涌	甬通痛桶誦捅俑
曹	漕撙遭農昔苗茴曲昌曾蛐描樽遵錨嘈糟茵尊槽
儒	侖糯孺而需擂燸擾優壩倫亙嚅愈偷鐳懦灞濡蕾蠕俞
阮	沅院隔完陌元陋阿陀除陘弔阬陞陪陸陰陶陷隋陽隍隄隕際險隱阻
稞	科顆香秋果秈禾稷潘蕃番墦稍播棵稚季委課猓裸種租幡審祕和私秣
促	捉齪足蹙趴趺距跚跟踝躋跆踐踏踩趾跋跑跌跤跦跼踫踞蹕蹼跎跺踱蹂
儐	錠繽棕跎倌臏嬪檳估濱渲梡佗值仗嫁傢殯傳倥暄淙什賓佇鬢喧
臀	殿澱股疫芟殺殷投殼般段盤腎鍛穀毅毆骰毀設役
踏	足踐踢踩踱跆跟蹂蹉蹈跺蹣蹦跎躇躁踝距跚趺趴躋
疹	珍趁診彬澎穆膨諺痊疙瘉瘡癒俾衫須杉餮箄鬚修彥彩彤形
紇	給綸繪迄屹吃縲絲納維糸絃絨結絹綏綵繃紀紐純細絀疙
貌	邈藐搗笆皁脾脈篁肥皚白巴葩皆鉑迫柏爬泊杷拍怕帕把吧伯腺楷絕揩
或	怠臺國域苔笞哉名惑怡擡治始胎迨底籲叮摑三感呃冶喱幗
碉	惆砲礁調碘雕周稠砠恫峒碓硯鯛洞鵰週砝硝砧蜩銅啁硼桐凋胴綢磊確砸石
默	獸黑點墨獻哭黠畎狀黜嘿吠伏黷戾突黔黝臭犬莽黯猷
真	慎滇闐植顛直鎮填睿姐濬肺且疽癲值沛誼芾巔釁沮宜瞋縝咀
同	脰胴膈合筒峒恫洞桐銅幅周且石肝豆鹹壹咀噎
沅	阮完污元涇涯兀二仁三梡溼玩洸竺莞佞院淙皖漂潛濃濡汪汙江汗洹汀
執	汍孰丸墊摯堵軌爹勢孝熱哮夷夕九痛褻教胰咦姨疑旭汐舛外弘仇栘侈
伉	吭坑抗沆杭炕阬骯航亢僕停偯仿依返幾信般逢佩處蓬篷
竺	三二仁些芸岸宗奈言完鹹禦竿竽示元雲祟誇票祭禁嚴威沅佞
騫	搴寨塞寒騰羈賽篤馬馱媽嗎闖駢駝駟駛駒駐碼駁瑪馳馮馭
栩	翅翔翻翎翩翱翮翹扇羽翡翳櫂榻塌遢翁翌習羿翟
髓	骯骸髁骷骼骰髏體髑髒髖崤骨滑腿辭賄鬱洧侑猾宥囿餚
幹	韓捨斬斡乾輪輸舍銲悍朝廾翰焊戟稈杆桿岸幹榦捍宿趕軒
逮	卜慷迫綠迷錄康迂迸送速逃隸卞市遣叟棣迪艘逆退遝迴柿逍止碌遇歧剝近衷進
奶	扔仍秀乃氖妒孕透莠奴好妨妞乍戶娩妳誘妤作咋昨柞炸肩怎柔笮
湘	霜渣楣相沈漆淋櫬目苜淅媚親測冒淞睬廂瑁睏沐帽濺箱渺洎想湄
橡	像豫象桶杼櫓李椎根枸柏杵枚林杷杓橙栘桅梃
趣	攝越取趙趨聶躡趁起陬趟弭陡懾椰踞徒赳超洱聞走囁聱趕茸輒赴
蕉	舊樵憔礁瞧焦蘸譙醮蕪薰奮藺崔隹錐進椎淮推惟堆唯
蠔	濠壕嚎蟀蟲蛀蚪蚊虻蟑螃蛟蟲蟾蟬螳螟蝠蝸蝙蝓蜻蜢蜈蛤蛉蚣蛔蛄蛆
頓	頑噸頌頊煩碩頃頡頂頻頹頤顆顯頒須項頫頜頰頭穎
卿	唧節鯽卯柳泖鉚聊茆即櫛啣御迎抑孵仰慨溉概腳卵留昂
踫	蹼碰跚蹉蹣足踝跟跤距蹕趺趴躋蹲躇躑踞跼跡跦跋跑跌趾踐踏踩踱跆
譬	襞臂檗擘壁璧劈這警譽誓唁信蘗辯避癖薜僻闢
椎	榫樵稚雜進淮推惟堆唯錐隹崔雄帷睢碓雉雊準離集
洛	絡烙路咯閣珞骼各恪詻略賂胳駱酪鉻貉咚格客
構	耕講井冉拼購姘並迸稱苒遘鉼胼併媾阱搆勾鉤屏溝
炕	烙朵亢蓬返抗冗炫篷烽縫般伉沆坑處阬杭吭骯幾逢航肌
範	轟軛庫軍連輦載陣車輒輾軔軋輩軏囀蓮範葷暈褲漣輯運暉渾軸揮軟鏈
屑	宵肖峭哨悄捎消梢俏逍銷屎尚硝稍霄廠蔽撇趙膛噹擋鞘檔襠鏜鐺
勢	劫脅幼勇努男劣另痂熱茄荔丸觔迦劻協咖拗助伽肋叻
呻	砷坤伸神紳嘍申呷暢婁摟嘯樓褸鏤由甲屢簍哽吊
褕	偷逾榆渝愉喻蝓輸瑜瘉諭愈俞倫癒複淪掄除險徐崙侖
雲	霞霽霜零靈雩雨動霎霪運霆霰霄芸靂耘霓霑雯雪霏黴霖震霍
循	遁徜很徊律徇徉往彼彷徨役衝盾徠徙徒徵彿微徵
裕	鎔谿鉛熔溶俗鈉順豁欲谷腳褓容卻錐峪蓉榕壑慾浴
揩	階楷偕諧皆陛琵批毚棍焜混錕崑琨媲摺指鹿罷篦
攣	戀變彎巒孿鑾蠻鸞灣灤譏絃絮言礫縴絲燮訾識譙織磯縲謎謄縞諱諫謂
軋	轟軏車軌軒軟軸輒軔軻軼較輊輔輓輥軛輛軾輻輯輾
妓	吱岐技枝肢支芰妹姑歧豉鼓姥求取娶奸如梂婉嫁嬪嬸女姦屐最
蹙	慼捉促齪足踐踝踏踩躋跟距跚跆趺趴否躉蹣蹦蹟蹕蹈蹊蹉蹲躇蹶蹬蹺
柩	漱嗽木嵌簌橙框撳櫃嶔林欽材崁灸羨闕沐久炊坎疚掀村吹茨棲柄樞
譁	謨諾謊謀嘩護譜講樺曄誡諶詰謹謙詳訐計識證譚譆譙譯議譟謠謐諱謂
屜	待徠很徵徜履行律德屐薇徇覆彷泄蹤屨徐癥樅徉從徊徒彿世碟蝶往縱桁
摻	餞淺錢摭找踐殘挨參慘拚棧滲擴縿賤廊糝擡箋
汾	扮吩份粉紛芬氛分岔忿沼沿淦盆拐枴浴刀貧寡
字	孝孚孛李子好囝仔存季孕孱籽學孽錳宋孟享厚荸俘屘悖浮猛脖蜢
酥	酒釅醮酸醞酊酵醴醒醉醺醇配酴醣酩酗酉醋酪釀酷醃醜酣酬酌
蠹	蠶蠢蠱磊蟲蝨囊蠡蛤磨蚤索巖孛筒融銅強胴砷桐洞恫峒拓司
且	組俎砠姐直助疽同真恆肝誼亙具鋤疊狙蛆祖沮租阻粗宜勗咀
踐	踩淺跎錢蹈趴躁線跆蹊殘跋蹂躊蹲跺跚賤踏蹦踱蹉蹣距趺踝足跟躋箋
沈	忱枕耽泱沖鴆油津洎滿湘目巾沸洩淵湄滯潰渺
必	勿密匆心虎恬愀愧怕懊恤性鉍易蜜囫瑟泌忽祕竹吻
契	奏喫扳拆尖祆沃託大妖括楔哲扒爻艾笑叛啪鍥劣齧忝奐夭揳奧拍美折吞
睬	踩矇眨睽瞑瞬相瞄瞠睜目盹睢瞧瞎瞼眼睞睏睛眩瞞綵眸瞳採瞌矚菜睦瞋彩
穹	空究簾突窄窠挖窒窮穿穴窗窪窿窘窖窟窩窯窈窕麻痲竊竄竇朮倥控崆
裔	衣依裁裟裘裝袈袋裳裴製裂褽襞襲脫膂肓迎筒衷深探嬝
嘩	曄樺譁華哎嚥噶磺囌荊噓嗟囈蕨嘻噎嘈噥橫楛嗶喃唾甜哄咩卅葬厝豆
隘	遍陞隕益褊陪楹媼際鎰縊隔鬨港隙弔陸塭嗑溫錳慍障阱襤賽溢阻鑑溘 
餿	餽餓餉飪飯飢餡饉颼餚餃餅餌蝕飼飽飩飲瘦餾餵饅館餞饑餒餘飴飾飭
鈐	鈴吟矜黔岑鎗伶琴捻唸泠拎聆羚稔銓玲冷苓今
螂	瑯榔廊蟲蚓郎蟲蝦蜥蜊蜓蚣蝴蝌蜘蠍螻蛹蛾蛙蛭蛔蛐蛀蛄蚵蛆蚱蚯蚶
瞿	睢瞧懼崔目瞼雛摧攫催霍截僱隹離錐璀椎進淮推惟帷堆唯
雜	椎稚進樵榫離錐淮推惟堆唯誰雉雊碓睢雅雄帷準隹崔
奉	奏春俸擎輳撩秦捺泰舂捧蠢擊手摹臻榛樁湊拋挾挈棒掩拳揍
憮	撫嫵蕪無憔恢愾恰惟庶愴愎愉悔愀舞樵慍惜淡啖懺借併佯供心
蘚	癬鮮羼烊搓祥蘇差庠羋羊洋咩佯羞氧磋羣嵯嗟徉
鮎	魚鰍鮮鰭鯨
憂	扳菱後板各稷鈑綾擾返優廈恪冬反胳處陵瀲傻稜凌尤
箭	湔煎剪前簧掣制刖削刺賁製簌莉荊鬥涮刷寬算蒂菜箕薦苜弈薊痢菔升
殼	毀殿殷般段穀股投骰役殺設毅毆疫芟沒圾發潑撥及慇廢磬擊聲
虞	娛蜈誤吳怒弩膚慮虔帑努盧虜虛虐虎處奴駑瘧唬噓句
肄	建肇津律健筆肆腱鍵毽聿佈啟牧改比俺雌矢匕
臍	濟擠儕齊薺躋丹霽肪劑朋坍腿齋肚臆臃腋月腴胰胭胼朕胖胛肺肢肱肫
蜿	蟑蜢蟲蜷蝓蛉宛蛄碗螺蛇蚌蟬婉蚣蚪腕蚓蟀蟒蟯惋蜈蝴豌
嫁	稼妹棕家臏嬪檳濱渲綻梡傢姑喧婉儐妓暄淙尺佇嬸錠
廉	度牀簾盞謙庶歉席鍍摭戎蔗戒戈渡嫌拚庾弁鐮濂廝賺械縑遮兼臺庠廣
枴	拐楫叨吩杏粉汾扮份刀召紛詔砌芬昭炤迢沼招楊初氛剪分
瀘	爐臚鑪驢鱸廬蘆濾盧膚擄墟噓顱慮溫琥唬瘧虜
恕	娟急患奴忠惹思惑芯努茹怒忍忌恩憾忘絮感惠怠如悶忝恭啕息撼怎慝志恙
蓮	漣軸陣渾軏鏈運軌軍輝庫揮葷暈鰱轟褲輦輩攆載軋連車軟暉琿軒
晚	昇攙澗饞逸冕昕簡輓鏡晶間菟晌兔娩竟昨勉挽冤昆免境
瓖	壤禳攘孃嚷鑲讓釀曩璃玷斑琉玨玟襄璋琥班璿璩璨璟琯珪王
剩	釗制利劃刖刈剔剎剃削剌剋劑刻刺刮剁刪刨判刑刎刊印
誨	譙訥許謂診諭誰訟訃訖詮梅侮識訛每海黴悔晦論誡
挽	攙把揉饞逸冕挺輓鏡菟兔晚娩竟扭批勉抒扔冤免境
淤	菸瘀遊漩倣嗾鏃於枋肪妨坊仿房芳簇防旁紡放彷族旋旎旅滂施方遊
柄	仄杯槓橄本榷鈉桓陋朽柯枰林檬枉炳病桿納內極丙吶梗
歲	止肯歧芷企扯址武啃祉茂步趾歷蟲正戊滅蛾減喊蛛蛞遣槭蚱賦涉蟠瀝
堉	唷琉育梳流熾硫毓幟織職疏識培坑壕垃撤澈境墟壇壞壤朗坊址母
驟	驗駁馬驍騾騷騵騎騁駱駝駢駐駟駛駒馱馳馭駙驅聚
琍	蜊俐莉痢利班斑珠珀玨瑰墦琳珞揪愀喇啾倒鍬玖珮王犁梨禿
趵	勺釣約的灼
股	芟殺穀骰殿殼沒殷冗役投胳設毀般殳毆肌段毅疫
整	症歪怔徵証正政敕嫩焉企止嫣武肯芷遣趾攸扯址佐收仃
櫃	頻拒顆頂槓貴巨頃潰頹相頒頓頡頤遺頌框顯碩簣責顓匱頊楨貢煩頁距柩項樞矩
締	啼綿諦蹄蒂縲絃縞縴織絲紋綵綬絹綏繃綽絞統紡糸啻帝
忿	岔盆分貧芬扮汾吩份粉氛刀初紛叨券招沼昭炤迢切賴
鋪	博捕敷莆誧哺蒲輔傅搏補甫賻圃溥膊脯縛匍浦埔
尿	匯屍水取鏗屈居尼屎屏泵泉屑展泰叵匹尾汞屋屠聚屆匣沐汨沖沁叔匡
感	憾怠撼惑恕臺怡慝哉名笞苔或胎迨擡始治惠思忠芯志忍惹啕
帆	汎釩帕梵凡幡巾肌帖帳帷幟冗幀幅帽幗股幃幌幛幔幢吊布匝
杼	抒妤序野舒予澦栘預豫桶移夥橘多侈墅歿矛爹懋
痱	菲屝扉罪霏靡腓排啡匪俳徘誹非悲斐裴輩靠窕晁遣
驥	騁駛驢驛驗驃騾騷騵騎駝駁駢駒駟馳馱馴馬驟驕驍駿駱騙駐馭駙冀
紼	絲紳縷繡細紐糾沸拂怫佛縲糸絆絀組紲紗紋純納絢紀約紆紂紅維緙
幾	魏塊蒐魔幼戍槐凱饑譏愧以機樂瑰魘魂嘰魄傀幻肌餽璣磯飢鬼
攫	擭濩穫獲懼護瞧睢瞿摧眷看雙隻攜相冒苜推渺瞥篡算督崔眉省盲
尷	濫檻襤鑑艦藍籃監瞌嗑溘盞磕蓋褊遍偏涊豔尢闔盍
壇	擅澶檀羶壞壕壤坑垣坦氈墟增場堤顫璃境培堉垃卦址簑
徑	待很徵行後經痙役徐涇輕莖從得銜徨衙氫衍逕
耿	耳恥取聶耶耽洱弭聒茸聰職聆揖聘楫聯聊聞攝懾囁鑷陬椰宵居
哼	亨嚎嚷烹唁吭惇淳諄享吼圖停婷諒砧唷啃唬啗偯掠涼啼喚晾搞槁噓醇
涵	函汐汛乙泓湧泳汲汕渙漁沒乞淦洸洎洶河沸況泡沈沐沁汨沖沌汝汍汎
訣	訏塊訥詢諫許託誅缺記詳詐誰詖討訃詁計詛課訊訂快訐註訕誚決詨訑
勞	撈湧勝榮熒螢肋營鋤瑩嘮鶯縈踴癆勇澇塋犖筋勗脅嶸
泥	洱氾涊沁沼急怎泌洩沐沌汨沖洵汝池汕淦汁浸旎渥濫水範
掠	犒擁撻晾京涼抆擠撲拄攘抗佔拈驚接鯨搞掖拉抖憬璟擅景就撾摔諒偯
慌	罔葬芒盲慨惜薺魍茫肓謊忙妄忘世惘荒蓄杗亡懵懂蓑
偃	堰鼴艮腿褪根退郾垠恨銀倔痕食眼倀狠跟限伊艱
孤	孩瓜瓤孫孺似吼以遜菰瓣抓呱弧孑瓠蓀孜狐孔瓢姒
媾	搆溝構遘購講姘苒稱鉼胼迸拼併屏耕阱並冉井
鏃	嗾簇倣族淤瘀菸漩肪枋放妨坊仿芳房遊防於旁
憚	釅器闡毋慣萼巖嬋禪戰句蟬簞囂儼愕彈囊單殫襄鍔 
瞞	瞄滿矇蹣席算睬睜睛啼目蒂瞠錦瞌瞑瞳瞧滯睦瑛鈽棉帽眸眩怖佈睫鼎
杭	炕沆抗坑吭伉阬骯航亢樸槌枋返幾般逢槁檀楓朵處蓬篷
鄒	郎邸邵郃鬱邢邦耶鄙煞郝鄴祁鄞皺郊邱那郾鄱都鄘雛郡鄗部郢芻郭鄭郵
嚼	爵囉噯胛還澴褥喘將呷吋咐啁寰嚶儸嚎嚏環邏髑噪耨諍遝嗦鑼喟唷娟
寂	菽淑椒叔督寵宰寇鳥烏十逍迷滓鴣籐籐宵定鳶宋寫安卉穴寒宗水塢嗚
敞	敝撇廠蔽散敵肖彆弊敉畋枚幣瞥敢敖敗啟敕敬故數牧玫改收撒矢疾尚
主	卜文蛀王達撻遠冉住拄注六佔丹鬥下去土立柱逵往駐壬註遨醜亡上進
積	漬嘖債磧績蹟責遺潰槓簣精損匱賸臢瓚鑽價慣睛隕韻晴猜清情倩讚圓
頰	頻穎顆頂願顛頃頹頒題頓頡頤頌頭顯碩莢頊頫狹頑領額預峽挾煩須夾頷項頗俠類頜
鼾	劓鼻肝桿汗奸竿軒訐旱瞰橄岸罕幹工敢釭肛槓江扛銲幹稈焊桿捍悍刊
眠	岷泯抿氓湣民眼盹目盼眇盯睫睞睹睥睢眩鼎睨睡瞋瞭眸睛睦睬睜瞄瞎
宸	晨娠振脤震賑辰脣脣蜃宗完三佞農宇寇崇莞甚韭梡淙棕
蹲	遵樽撙蹣蹉躇踩踐跆躪蹼踝踫足尊蹶躁躅躊蹊踱蹂踏跺跚躑
磅	膀滂鎊肪啼楞徬嚨傍謗砟硫榜砧方旁螃愣磊諦
嚏	嗦脖悖肺沛芾喃疋荸嚀哺胥孛礎噴嗜喀喧婿味咕吱嘲楚囊索
世	葉葬廿卅心羊洩墟井甘並惜曲必泄虛屯皿慌牒立共碟升紲蝶噓喋冊諜屜
俐	利琍痢例側秉莉揪愀簌禿悸梨矮啾倒鍬捌蜊秧犁倭喇
衙	銜衛衍街衝術衡衢桁行徵徑徐微徹徵御徘徠徜很徊律徇徉往彿彼得待
盅	皿冊柵姍盃扁盂益盍盎孟盔盟監盛盜盥珊褊襤
貉	貂胳咯鉻略烙格洛恪賂路絡駱骼珞詻酪貓豺客
宜	組俎慎滇植砠直姐填鎮且疽真值誼鋤狙蛆祖沮租阻粗勗咀
人	什僕仙仕夥伐休仲佃囚八仄欠入久內午夫尺丘矢年隹
登	豐短痘豈脰逗嶝橙磴癸拿證蹬鄧盒久澄合凳豎瞪燈 
縝	鎮滇慎填瞋縯絲組闐緒縲繽細納紆縮綻綜糸巔癲
困	梱果捆棵睏田裸囝木因回四囚圍綑林慄猓尊森稞窠裹
拂	夢患氟揣費鬥事摟沸佛捌彿拽掀紼介抽怫弗喇剌串
菌	苗蘇蕃番萎禾莉莠稟香委審榛秋潘播墦秈和私
徹	待御徠徵徜撤徬切澈徘彷沏衢砌徐從徒微銜往轍衍黴徙
惹	若慝匿偌右艾祐諾蔥蕙怠暱慈荔落茄憾菴慕莽蕊感莢恕芯荻撼哎
鮭	鯉鮪鱷鮫鮑魷鯧鯛鰓鯀鯨鯖鰭鱔鰍畦鰥鰻鱖鯽鰱
緯	韓度違葦縮絹圍幃糸緩綻絨結縉給縞闈縲韋綵緝紂緹綰綏綺綸綜絲縴偉練
遺	隕槓貴慣績潰臢債逃瓚磧韻遣價積賡賸簣嘖賁損匱蹟鑽貢圓漬讚
瞇	謎眩迷矓瞳目睞眇遴瞧睬睜睏瞰糙眺瞭睫睹睥睢眼眠盼盹盯瞑瞄瞞瞠
菰	蓀孤遜孫瓜弧呱狐吼孑瓠瓢瓣瓤孩孜孔茲孺以
砷	呻坤伸神紳磊申斫硬嘍石砧砠砟砝砲砰硃砂研砍硝矽碰碘碑碓歌確砸
榴	瘤聊餾留劉卯櫛籀搾茆霤貿卿柚鉚遛杉泖溜柳柞
黛	岱嘿黑貸袋墨俚童鋰裡理狸浬娌埋哩代蕉裡鯉貍
狼	娘良狩養狎墾浪狡猥狠飧餐食猖獷狸狄狗狙狹猓犯狐恨癢琅懇狽狂艮
灸	久癸煞炊夥疚飛坎吹欽欠登崁發嶔凳之孓玖次柩砍畝歌撳
乖	千忠妻仟卑乘吏朱舌宙阡患燕事垂盾重侏使刮徇恬括段活俾株舐茱刊
琨	焜棍混錕餛崑媲瑁鹿罷篦璟琵昆皆琥揩階楷偕陛現玨
蜥	晰淅蟲蚓蟲蜓蜊螂蝌逝浙蚶蛆蚱蚯虹析蝶薪蜘漸慚蝴蝦撕嘶蛾蛻蜆蛙
獄	嶽誑辯罰藹誧誠詠誡試靄訣訕討計訃詼訟訛謎謝訓誦誣誚詳話誅詢詬
坩	柑鉗堪甘疳甜蚶媒煤墟某虛酣嵌琪謀壙箝塔噓璜幸芣弄芋
刃	汾塊蒐吩扮切戍刀麼槐忍愧沼岔紉券軔招忿仞叨傀份召拐分笞初韌鬼箋
利	刊琍痢剌釗制剋莉刈刻禾刮禿剿削剔梨秧判俐刪犁刖剎剩劃剃刺刎剁刑
劉	釗剎卯鉚聊則柳刷泖刎茆劃劑剷剩剔剃削剋剌刻刺刮剁制別刪利判刑
兌	剋競稅侃兗克閱鋁釦悅銳兄祝袞脫況嗅蛻說息
悠	攸脩愍敕收恩忝條倏修絛嫩鯈怒篠矢滌患疾忠慇庚矣懲藪敘做畋俟傲
橈	曉燒澆撓嬈僥鐃繞蟯蹺饒驍堯珪桂檯桔檮櫝杜
梆	綁椰邦榔槨挪娜哪擲耶爺嘟橢琊瑯邶螂躑蚌弔豐廊
估	做咕姑沽枯鈷什個古固居苦牯倨仗胡蛄骷倌湖捨葫
胤	盲牽襯目川亂兒褪相枕姐姍沈忱褸貝自中苜冒妻肓婁
爨	焚奧向釁襟噤制禁婪礎燠礬楚梵傑襖鍬澳懊噢揪愀啾秋
食	養浪娘狼琅飧癢良餐倉饗餮傖饕伐饜蒼瘡艮偃滄搶愴嗆槍鎗
覺	攪莧靦鱟黌硯覲蜆覬觀筧見規學覜覓現峴覦視
澶	擅壇檀羶濠漓淳液淬涼沆渣氈滷漣潼潭漳漕濾渲湯湟顫
諳	詣諾謀謁詢詼談謂詳謗讓諺暗訟訃訪識謫該諄註闇詰謨詨誶誡譜諒黯諜誌諦
郊	郎餃邵郃鬱跤邢狡耶邦交郝祁較鉸邱效那絞都膠郾郡鄗部蛟郢校郭姣咬鄭皎 
殤	楊例殆咧場歿洌列飧觴殃殘夙殲傷殯歹揚煬殊殮殖腸屍鍚瘍陽暘死殉
粼	嶙磷麟鱗
舢	舟舫舨舶航舵舷船艋艘艙艦艇流梳琉硫幟疏毓丹
擦	察祭蔡際棕捺淙按擰糉綜崇宗賒示控拾拴仁鬃奈
綬	綵緩綏綱綢絹縲授絲網繃組糸締線結絨絃纓細納緲
嗚	塢鎢烏鳴呂鋁侶呼咋吒叭咯莒宮唾嘀啤哦咬咳咱呱聽咚啾閭品薛呈
汎	釩帆梵凡汐洛泓汍沃泊沆夕幾汲沂弘波活派洎洫湧落
籠	膀滂鎊矓攏龐壟隴徬嚨龔傍聾襲蘢龍磅榜旁螃瓏朧籬寵
芹	斧近析昕沂折圻聽匠斯所祈斫斬新斤掀薪訢廝欣浙逝淅晰撕嘶
朕	送胼膜擲皿冊岡艾腆鄭躑柵朋姍哎血盅若罔羹
儸	囉邏鑼玀蘿籮羅環還澴寰遝鰥楞愣爵篾甍蔑夢
藏	贓臧臟宦臣臥茨臨勻蓊馮莽苔鑒腎堅茆卸冰蘑蔗豎蓆賢緊鹽茂羿扇翔
輞	惘魍轟網車軋輾罔輛輔較軸軟軒軏軌輪輜輸轅
赦	赫赤郝赭赧嚇敗螫敖敕玫數收啟敝敉效敞敢散致畋故敬牧枚改敵攻孜
鼓	嬉鼕豉技廚山枝吱肢支澎妓鼙膨嘻彭芰僖樹歧岐瞽熹喜
詩	讀待訏譙謀恃寺訣詼談持諉諍諜謂誥認譟峙誰訟等討詮計特譆識課謝試侍註訕詰誡訑 誌
滑	淫猾萵淨涓深骨窩亂渭棚過禍潸滔骷朋清受鍋崩蝸媧沉浮堝渦髁
糯	燸濡懦嚅儒蠕孺需鐳灞擂壩精糉粳粗糧擾糢糟優糕粉米蕾
符	待寸狩篌恃腐痔榭持駙奪傅廚俯咐峙傳等附筏特冠八侍蔚時府付篠
袁	袞園遠吉猿衷喜臺褒嘉熹哀呱轅裳旅售告周舐砥桔拮圯
圉	悻倖睪幸擇澤鐸報繹釋卅譯驛畢裡畦壘圃固困回因囚四園辛田哩埋娌
鬥	科拂釗痢莉荊赤刈鬨斟魁事沸佛捌前抖俐刖料鬧亦劃怫弗喇
嚇	赫赤赧赦郝赭喇咧螫嗽倒嗷啊捌哇吐鬥小鬨鬧
河	坷呵柯何阿奇苛蚵軻汀訶可倚崎椅畸錡寄荷犄琦婀啊
旋	族於旎旅施旌旗旖漩放方礎淤倣菸瘀仿嗾鏃疋簇
輕	逕涇經徑痙莖氫轟輻軛輜軾軒軏輾輛輊軻車輪輯輸輳轄轅轉軋
濮	僕樸撲噗蹼滌璞供洪淪潠溢滄渝港海洽泠汽淮瀑僎溶浴共谷
沍	互汀涇潛汪沔汗汙江河洹酒湛溺瓦涿湎源碌錄沅污溼潤濤漲彙
坑	坊亢炕蓬返抗篷壞般壤伉沆處阬杭吭骯幾逢航壇壕
坎	砍歇歉歎玖葵歐款飲欲欠次欽歟崁灸揆歜久疚炊畝軟吹歌欺欣歡
樽	遵撙蹲槽尊糟樹榭穠村耨褥遭漕嘈傳時特持恃狩峙侍蔚團
鱷	鯉鮭鯛鮪鮑鱖鮫魷鱔鰾鰓鯨鯧鯖鯀鰭鰍鱸鱗鰻鰥鰱鯽
盍	蓋溘嗑闔瞌磕監去豔盅盞益盃盔盛扁盂孟盟藍籃皿冊珊柵姍濫檻襤鑑
吭	坑抗沆伉杭炕阬骯航亢哼返幾咚咯唁般逢嚎嚷處蓬篷
奈	宗祟票祭禁禦誇示捺痞左痙痘三二不竺碳炭崇芣否齋杯壞淙仁棕滅
說	詞諛兌評誧詢託話悅誅記詳銳誣詐誰誠訟訃詁脫計課該蛻詠註訕誚詬詨
庚	賡劃唐康庸允州爪牀戒矣戎弁臺戈抓捷嘆漢店庠座牟庾悠充篠爬攸洲
氣	愾氮氤氧氟氖氨氦氯氬氳氛粥屎氫粟粱迷咪糜米邱汽
糝	縿滲摻慘棧參糠糖殘粉粕米糢糟糕糧餞粹糉精粒粗料敉籽糰
慝	惹匿暱若偌感恕右恙恭恩急怎忝芯忍忌君艾怠憾諾啕朕送
辮	薛僻辣宰滓癖鋅瓣霹梓辯濰辭辦辜避莘辨闢索紊絲薜辛喲 
傯	總窗囪傻嗯添聰蔥倭佾低佬恩僑僱惱舔偺偏傀俾便俄侏佚作伯任件仟
滿	瞞蹣席瀟滯懣漠瑛鈽湔濛怖佈漢巾蒂英滋棉啼錦濩灌蓆希
岷	眠抿泯氓湣民愍妁她吆叫偯呶氏山忘巖岫岐峭舐衹峪砥喲峒喪巖昏吳
揉	蹂鞣柔扔採播換拯操扭揪禾揆撥擔擱挽挺捆乃懋
莒	宮閭侶鋁呂營櫚薛嗚阜菩萸茴茱若茂苗苞苟苛苦芳芯芹蒐昔呈艾召葭
裒	竄鼠舀臼舂逶潟裹衰襄亢衣滔焰啗艘蹈迫遊衷閻褻舊舅臾身諂造陷稻
輛	倆轟魎軒軏輊軻軸軟軋輻軛車輔軼軌輕兩輥輓較軔輪輸軾轄轍輞
嗜	鰭耆嚀唱嘈旬喧湣味咕吱嗦喀噴婚怛嘟嘲嗯喝喋喳娼惜憎倡悍嚏喃哮
被	陂破板皰彼玻菠疲皺跛詖披鈹格皴波坡簸皮頗 
覜	規峴蜆硯現視頫覦靦覬覲筧覓莧觀覺見窺兆攪
只	叵金扣杏父吩匹古吉小六佔回丫句幟職哄公巳穴吐識咫共呆右織枳四如興口臺石
蘿	夢環篾囉楞罹玀寰維濰澴羅甍薨蔑鰥籮遝鑼爵愣儸邏還
棗	棘策刺採棚想菜採柵相肘盂孟廂箱榮湘睬粗桐稱租膝櫬孀
膨	澎彭彬樹趁珍疹穆諺診廚鼓形周須彫週惆啁脰彩衫杉彤稠碉凋鬚
核	氦孩劾骸擁賅枋垓樸雍亥梓閡臃柱駭楨杭該柿壅咳校杗亡棹槌刻枓
渥	握喔齷屋至漏姪室致到窒浸絰蛭輊倒耋臻涊潺潯濤濫緻套
決	渣塊沁袂嗓沃訣鴃筷漆淋缺池汙汕淞沫汰沖抉沐汶汁洧快沬淦汝波汨湘
色	巴艷邑把吧芭肥杷疤笆免旭間爸耙浥乙象兔皁爬挽娩梔晚扈冕葩靶搗
簍	屢褸樓鏤摟嘍縷螻髏笛屨婁申坤呻伸簫筆神砷
製	掣裂裟裁依裴裘裝袋袈褽襞襲衣裳制裔前箭刖
亂	貝猾滑萵自恬骨相窩刮括棚過目禍苜冒朋辭繃受覓蹦鍋崩媧堝渦舌
女	妒妹奴妙姐姨娃要妖妁妥妯姑耍她妃姦好妓妊如汝姅安奸妳妍亡始妞姍艮
佩	珮篩獅師倆伉跺楓颯肌毅夙咒亢冗諷飄飢凱股佈投段殷般偺殼殿躲嵐
衡	銜街衍衛衝衙術衢桁行徵微御黴徊徹徘徙徠徜徒很律徇徉徵往彼彿彷
嚎	壕濠蠔豪嚷哼唁鎬槁搞婷停吭高亭稿犒篙圖膏蒿嵩亳
皓	造浩誥酷窖魄告皈白呈皚燻衽妊任皇泉皁皖程醺飪皎的廷壬聖望皋帛
奚	拗溪窈幼畜藥玄吆黝雞關妥茲姒似蹊爍鑠縈索麼樂嘰以幻機璣谿礫
暗	瘴獐意漳憶噫諳煜幛億璋鏡樟響障昱闇臆音黯境
遙	迥敵罈陶運離罄瑤缺搖週佗淘萄鷂缸榣缶謠罐缽掏罌啕
亳	高亭毫豪膏京亮烹享亨逞嚎牽嵩蒿篙停婷搞吒槁壕濠鎬
棍	焜混錕琨餛崑楷媲鹿罷篦昆枇皆揩偕陛比階琵
駭	駐馱核垓咳馬駢骸駟駛駒馳騙賅馭孩該駱駝駁騵騾驗驢駙馴閡氦
惘	網輞魍罔惆恫慌芒忙荒肓鋼恤慍亡蓄忘綱朕胼臃懼岡崗皿冊茫背杗妄
冪	膜幕寞模摸漠莫席布糢慕摹暮墓希瞞蟆朦滿鈽晞怖佈
逝	浙撕折淅晰近漸慚嘶掀蜥斤嶄廝薪析昕沂圻聽芹匠
喋	碟諜蝶葉牒洩世紲噓喳啕保噪咆吻咻屜怠呆媒嗟嗓嗜嗯惜煤唔嘈哎橾
安	案晏按銨十妻宴女宋妥卉穴姦氨鞍宇守宅字妄它宏牢宙宜妾委宥姜宵
些	言訾貳宗禦票仁嘴芸柴此瘧貲禁祭竺三嚴紫岸奈二祟誇式底完
穎	頃顆頻煩頓須頰頭頹頤頜頡頫碩頗顏頑頊頒頌類願項頂顧顯
芟	疫股投段役般殷殼毀殿骰穀設殺毆毅沒葭凱菱冗亢槃慇磬臀聲擊鑿發
哨	捎趙俏吵咪銷屑鞘悄稍硝睄梢峭肖尚宵逍消誚噹帩
菱	稜陵凌綾蔆鈑稷憂傻廈反販鉻鋒各冬賂後返板扳瀲
閣	洛絡烙路咯珞各骼恪詻略賂胳闔駱酪鉻貉格客擱
媼	塭慍溫瘟醞偏姍嗑溢溘遍褊錳濫檻鎰襤鑑跚氳盜盧侖蘊
唉	埃挨俟矣嗷唆嫉蜘矢廠族嘛敏知吠做攸撤澈轍啟故畋枚敬倣傚傲嫩撇
匯	淮尿濰灘隹催僱摧暹準椎進唯堆惟推錐璀濯懼鐫雌攤焦集僱售崔罹藺
小	詹亦赤弓金擔澹簷膽簷奕弈瞻蟾贍帟郝赦赫譫
敖	熬啟敷疾敵嗷改玫致數矢敬敞散矣畋故牧放收邀敕敢敝傲敉遨枚贅聱赦
漫	濕鏝饅混澗慢澤曙湯縵瀆澴瀑濁涅幔渴鰻曼汨蔓
泜	抵柢胝低牴砥祗底詆氐婚衹祇紙舐氏昏邸添湣湟
蛄	蝴蟲蛞蚌蚪蛔蟲蚶蚵蛆蚱蚯蛀蚊蛙蛛蛐虻蠅蛇蜿
殘	摻餞淺殆歿錢踐列線殃殤夙殲慘棧殯歹滲殊殮殖賤死殉箋
韻	損隕圓賞韶嘖遺磧賁員韹蹟賸績積臢瓚潰價漬槓慣債讚鑽賽
砥	詆祗胝牴柢泜抵低底舐氐婚衹磊硿磋祇砟紙斫氏
流	梳琉硫毓疏堉唷熾幟織職舢澈海港漓識育涪涼沆滾濬注泣沾汴汶濟淑
肛	槓江扛釭缸紅虹訌工築槓汞攻功佐鴻巧貢項隱穩
吠	哭伏畎獸犬器獻狀默唳嗅戾突臭莽猷唉吮哺袱獄尤獎
軛	輻轟輕扼呃軏範軾軒軻輊軋車輯輾輛輒輪輸轄軟軔軸軌
祝	況祀兗兄祕祐祠祚祆祈祇社視禪祖神祥祉祁禎福禍
睄	肖消梢銷捎悄哨稍硝峭俏鞘誚帩
鸚	鶴鷂鵲鵑鴨鴣鴆鳴鳩鸛鷓鷗鵡鵪鶉鵝鵠鴿鴒鴉鴦鳶
孿	孚字仔蜢蠻李礫鑾灤籽巒譏孛鸞灣孝變季存好攣絃學艋諄彎囝戀孕
暄	渲喧萱晅宣洹皖暘桓垣奭晏棕晤梡淙旦嫁糉傢儐錠院濱嬪檳臏佇昧旺
皇	篁湟惶煌遑凰隍旺徨蝗韹白玨泉閏全皋帛皁王珀枉狂汪匡
秤	枰抨坪砰評平秋秣租科秈稍和私稈禾萍秧秩祕杯稚稞種秒穗穢香番委
井	並併姘屏拼胼迸鉼並阱耕摒瓶普媾搆溝構遘廿餅駢
飈	風諷楓飄颯瘋
楣	湄媚眉瑁帽相湘廂算箱省自篡臬鎳洎咱首目冒霜纂
遂	燧隧送逆迸立萄芯道遭達進惟迭泣拉垃迆位遘竭遵邁避辛卜意笠荀音
優	喻糯孺憂擂燸擾恪逾褕壩渝倫儒偺嚅愈偷俊伉鐳懦愉灞濡傻侵蠕榆尤俞
複	扳復板阪夜袱伋各鈑覆皈返褕冬被晷反腹褓愎候馥
恪	咯洛格烙胳略鉻珞絡賂路骼客詻貉酪駱閣咚處各
褶	摺濯擢櫂曜習穋膠耀嘐躍僇繆謬廖寥羿翰遢煽榻塌嗡瀚翼蓊翟翌翁
渝	掄喻泠瘉淪汽輸蝓癒逾洽褕諭滄倫瑜愈偷愉海榆俞
中	兒忠引川仲沖弔丫史巾由甲聿串束鬥肅初盅袂衽袒袖順裡裸
仟	侏千阡俾任件作伯傀入什佚俄跦鍛朱舌卑係倪踵佾倭緞
職	取唷聶聆聳耶聰聘梳餌聯聒流幟硫識耽琉疏織耳熾毓恥耿堉茸
酗	酉配酌酣酥酊醜酴醣醋酪酩酵酷醃醮醺酸醇醉醒醞醴釀釅酬
吐	哇嘻口哩唯噎土仕杜竈肚砝嗑嗷圭呈品堂籲吋吒吆叻叮叨呎吧叩叼吹
跺	踩蹂跦跌趴足躲跎跆踏踐蹈躁跛踝踵跪踢踱踴蹉蹣蹦蹬蹲躊躪跟距跚
賜	貝貼賄踢賠賅購賊敗贖剔貶則財賂賭賦惕易賒賻貯販賤貽錫贈蜴贍
笨	韓違葦香杯出秉秤本秋咄柔禾掘秈緯圍倔和幃番拙策屈闈五委枉韋缽桿箱租苯私偉
倚	佑坷寄荷琦苛犄錡騎婀河呵啊柯奇可仃佐崎畸綺椅何
訊	計記訐討訕託訏訑訂訣訥許訃註詠評詁詛詐訶詳話誅詢誦誚誧課誰諂
紙	組約細絀繙絢繡糸線維紐紗紉紋祇糾紀祗低縲絃紆抵紡絆紂納綞絲衹氏底紲純
信	這唁警誓譽譬訃言諒偯停諄誶讓計訕謎訖伉詮僕訛
有	餚疽宥大侑洧囿布爻月崤灰左疝疢胃朋鬱淆肓育疚肩青疤奎胄冑病疾
雷	霜糯電雨彙霎而憂孺霆需胛擂燸苗擾優霸壩恆儒亙霧嚅鐳懦腮雹雪灞濡頁青蕾蠕胭
錮	涸個箇固鈷鈿古楛鋸胡枯沽姑咕估苦居鋰鉀牯故鏍湖毋葫罟
糉	棕綜淙崇蒜鬃標噤捺襟察漂嫖膘縹鏢鰾賒際瞟驃蔡宗
俏	捎哨趙銷償屑儅鞘悄稍硝睄夥儻伴梢峭肖尚宵逍消倘誚帩
雁	座挫銼坐仄巫筮隹難癱噬仕灘攤集焦崔售二進椎雉碓淮推惟堆唯催準
藍	侖遍盞褊篇偏鎰籃艦嗑磕盆檻闔濫監臨盍襤盧瞌溢瘟尷豔鑑溘盡蓋
螫	蟲蝨蠡閩蛋蜇蚤赦蟹蜃融蝕虺蠻蟲蜘強螢蜜蠱赤蟆蟠蝴蝶蝠蝸蠅蟾蜻
幫	迫鉑席錦怖常邦希線篁怕帕帛綿腺棉柏粕蝗佈鈽綁飾蒂拍泊封舶伯滿珀
輜	錙淄轟緇輕繅獵邋臘車輻轅輾腦惱蠟軸軋巡輪輸輳輯軾轄瑙轉轍軛轔
牘	櫝瀆犢續讀贖黷片牒牖牌版竇賣堊塹蟯環珪待壯順圳亞串甲畫
霆	霞霽霜零蜓霾雨霎霪露霰霄梃雲挺霹庭霧霓霑廷雯雪霏霖霍艇
紅	絲紆絰緬糾細組肛槓釭江扛繡紜縲糸紂紀約虹紗紋純紐納絀絆紼紳紲
鮪	鮫鮭鯉魷鮑鱷鯖鯛鯧鰓鯀鯨鰭鰍鰥鰻鱔鱖鱸鯽鰱
倨	踞鋸估聖居侷伊個耳古倀仞伺做趣捨恥耿弭枯洱胡取咕姑沽鈷什倌倔
賁	貝隕慣臢潰墳寬債遺韻賡貧賸簣嘖損寶匱鑽賞圓賽漬噴憤實
姦	妄災姒巡巢女淄錙茹妥安邕莖痙涇逕如汝姜妾妻委婪宴晏案姘姨娃姻
仰	聊唧節御卸卯作卹迎旅依茆印昂抑卿啣腳係低鉚卻命俐鯽泖叩柳姬
匱	隕槓貴績潰債頤遺磧積賡櫃貧簣嘖賁損蹟貢圓漬
眇	渺緲目炒杪沙抄妙吵鈔瞠盼盹砂盯眼睥睨睢睡瞭省
瓏	朧攏嚨矓隴龐寵籠龍璿斑班玷玟玨璃壟玥鎊螃磅榜膀滂琥傍琉聾襲龔
晨	賑晅湛辰農堪佞脤甚儂振辱旺脣宸蜃昊韭娠是三晤暄戡旱暘旦誇污震
膂	肩方肪芳房肓遍枋妨坊仿旁膀邀旅於放防脣瘀菸遊裔乍戶榜滂遊傍淤
甄	瓶甌瓷瓦甕甍煙湮鋰酩西曬迺哂酉酥酣酗醣醜酒配酌酊夥醋裡互夕爹
偌	匿諾若惹借佑右哎暱慝艾僑祐供併佯知倍儀儂蹣躇智茄落
救	求裘梂球敢故畋致枚矣敝敖教敗啟敏敘敕毬敞散敉效敬放牧玫敵敷數
綠	組細絀錄絢緘氯糸維紐紋縷糾級縲紆絆緬縯紼絰納綞緣逮絲碌祿剝縝紲純
勝	滕胖賸騰謄湧捲倦肋勞筋脅畔姅拌伴鋤拋拗圈勗
躡	囁攝懾聶踞距鑷跼跎足躊躍躁躇蹶蹺蹲蹣蹦蹈蹊蹉蹋踱踴蹂蹄踐踢踏
愀	揪啾鍬鞦鰍悸秋秒稍禾愁琍俐穌逶倭播潘墦萎痿秦審蕃
抆	汶撲文玟抖拉拄拈紋蚊擠吝虔閔扯掉摘斑斐雯
末	沫抹茉秣杖枝枯木十棲楮桿杵枓梡棕植棺楠搾榕糊穗檳檸
慮	虜鱸虎廬思爐擄虞臚虛甸瘧膚虐鑪鰓瀘濾蔥處腮盧蘆虔
僂	婁樓摟數縷褸蔞
鞏	恐築霸緙築羈革鞋鞍靼鞅鞘靴靶鞠鞣鞦勒韁韃韉
痍	爻夷九胰姨咦仇究疚餚旭軌瘓希友丸痛痂疾疢染疝灰有左癡癬療為大
霰	雨撒霪霧霜霞霖霑霆霍霄雯霹露霾霏霽雪霎黴零雲
茉	末沫抹苯秣萊葉枯枝杖苦苗芯芾茸草芰昔芋艾葦廿
艦	藍舫籃舨艙舟舢船艘檻舵濫艋監航襤舷尷鑑舶艇
診	詣詔詩譙訥誘詼許趁誥認諭詻誼誰諺訟訖設詮試訛詰論誨誡詆珍詫誌
朽	巧兮粵污圬誇娉聘桿杯枉虧槓柯柄枰垮胯耨騁本
邱	邸郃郵鄞丘卸邢鄧祁邦那邪郎鬱耶鄭鄴弔嶽氟乓乒
紋	絲絞紡統細綽絃縲糸紗純紐納紂紀絆絀組紲紱約紆糾絢維緒繡締縞縴
耨	褥辱耘持樽撙特時恃峙侍耒縛磚遵潯膊詩溥搏傳博傅將狩待耕耙榭咐
等	待寸詩狩恃寺痔榭持符奪廚峙咐特對籌塒侍時府樹封 
都	諸署堵屠楮鬱渚邦耶睹嘟箸郊者暑賭緒郾郡躇煮褚鄭奢著
悻	倖圉睪幸擇澤鐸報怯繹釋卅譯驛恃悽悼惟恬恤怵坩忸畢辛心苦芰芾弄
聿	羊律勤毽甲束史半肄筆手肇瑾弔健建鄞年中牛津由用肆耒羋腱僅鍵串
焉	政徵扯肯企懲址逃整遣啃狀証證祉歪步嫣芷怔止武歧盡症正
畸	坷寄荷琦苛犄錡騎婀河呵啊柯奇可倚崎綺椅何
逢	洛終扳烙路咯板阪珞鈑蓬皈返峯恪篷叛蜂烽降縫胳鋒處鉻疼咚客格略
鉻	咯賂胳烙格洛恪鈑鋒酪路骼絡珞客貉詻駱閣
姒	似以吆玄拗爍鑠瓜姦奚畜茲藥黝呱弧幻絃嘰機璣嬤礫窈麼樂關
唧	卿鯽節即啣叩迎抑腳仰櫛昂御柳聊慨泖溉概鉚
詭	詣詩詔誘詼諂桅誤誥認記詻證語誼脆訖詮危試譫訊跪訕詰誇詆誡詫諒誌
楓	颺穀亢板飈颱颯瘋颶飄冗佩躲颼跺杭颳珮格諷肌咒嵐風
颱	颺颳颶颼殆風楓瘋嵐飴迨胎治擡怡始冶颯跆貽諷笞
績	積磧漬嘖債蹟縲責絲遺潰槓嗉縴繃賸繒綵綸綬繽絹綏損給纓絃紛紜紇
友	又夷九仇奴旭咦姨桑胰痍反叉丸疚瘓廷沒究夜怪建疫候隻啜雙
瑤	玥陶珊班搖淘玨萄斑榣琛瑁遙缶謠掏啕現璦琿
唏	晞烯稀希幕怖佈鈽布啼吊爻崤帑俺哎掩淹醃駁嘹咦叻咖巾常餚幣另冪
齟	齣齦齪齲齜齬齷齡俎齒詛砠沮姐咀齧蛆組粗租祖阻狙疽宜
魁	科塊蒐斗麼槐魍愧斟魅鬥瑰魑抖魄蚪傀幾料魎斜鬼斛枓
夙	歹例咧屍洌風鳳幾列死殆殉殘篛斃朵歿殃弱殊
佝	拘枸鉤齣苟狗他夠駒句跑雊包估佔佃夥伐休仲咆抱泡仕代仙炮胞什僕
躬	身躺躲窮軀兒倪臼鑿睨啗焰幾陷舀閻肌滔諂潟餡臾反凡舂裒朵霓冗亢
拚	摭擴擡械找挨戒弁摻誡度庶拭渡遮撼鍍庠蔗措描壙曠拔捕搪我席蓆廣
榣	遙搖瑤謠淘掏啕陶萄缶缽缺缸棚罈杵罌佗相鷂罐桐罄
榛	臻樁棒秦湊揍輳痿舂奏矮捧俸痢禾稟菌蘇楔播秋秈和私揪番泰春香委
鯽	唧卿節鯧即鰻鰍鰱鯉鯀鮪鮭魷鰓鰭鰥鮫鮑鱷鯨鯖鯛鰾鱗鱖鱔鱸
適	滴摘嫡嘀鏑謫卞商六這逍迺述汴遲滾交卜遊脊冥
驀	摹莫暮慕墓募幕蕞蔓葛荔驚闖篤駑馬馱媽嗎騫駕昔萌駢駐駟駛駒碼駁
矚	矇遲眨睽瞑瞬瞄囑瞠睜目盹睢瞧瞎瞼眼睬睛眶眩瞞眸眇屬瞳瞻瞌墀睦
叢	鼓取揖益聶最鋸巽娶寨楫暴鎰趣鬨業港陬撮搴蕞樅支從共耳寒芰聞溢塞衆縱茸
樹	廚櫥榭膨澎樽咐鼓村桔時持恃峙侍等痔謝附遵撙蹲彭特蔚奪符府
鬆	鬍鬚髯髮髡髻髭髦鬢鬃鬣崧淞彬榭射鬆杉麝箱衫
近	斬斧拆祈訢斫聽晰逅哲昕新淅浙斤沂析逝掀圻所芹斯折欣匠
靖	菁晴清情倩睛精猜蜻請鯖青債漬嘖積磧蹟立端績責音妾
奏	春輳矯秦祆沃嬌泰舂添妖笑舔臻榛僑樁湊忝揍夭橋吞奉
漣	鏈鰱蓮轟渾連運暉揮褲暈葷琿攆車軋輝庫軍軸軟軏軒陣軌載輩輦
仔	好俘子囝字孚李籽你存孝孛季孱屘錳孕乞仍休浮猛蜢享孟厚學
捶	垂拆扳甘甜錘託棰陲括扒抓插箠 千擴抵綞箝拍睡折搗郵唾
鑒	臣宦臥屢藏申臨臧買腎堅婁贓順坤呻伸鹽鏨賢罵緊置罩眾罟留罹薨篾
腆	碘典朦胼朕朋皿冊岡脫膜菜罔冪散脯柵肺姍肚深探膳膿臚腳胴鋼血月
紗	組少約細絀妙絢緲繡糸維紐紉紋糾紀沙練縲抄紆紡絆紂紙納炒絲紲純
陝	浹挾峽俠狹莢夾陡阪愜弔陣陴陳限陌阻陂阿防阱阡除隋險附
瀋	嬸藩瀉潘審濱沱鄱濘滓溶渲淙汁番播墦稞蕃幡沬翻
餓	餽飪飢餉餿飯餅餌蝕飩飲餞飴餃餚飽飼饉餒餡饑
骯	骰髓炕杭沆抗坑吭伉骼阬骸航髒骷髁體髑髖亢
灘	雌難歎艱僱暹瀟匯攤催坐淮癱濰藺嘆漢濯摧滿 
戊	威鹹茂戍成戌戚牟吮城減喊滅戈竹庾參幾歲槭
息	媳熄臭忌贊鼻虎想態兄侃沉怨憩唬溴嗅思怎忝忠芯志兒兌克免見兇先
熹	喜嘉嘻嬉僖臺袁吉禧壹京豆譆培售告品周鼓桔拮圯
睫	眺鼎瞰盼捷睹目盹睢瞧瞎眼睞眠瞞眇盯睥瞿睡瞋
拒	攝扣矩渠掘巨撲找凹扎手摒苣局櫃鉅凸握捲侷挪距挈炬招
朵	幾跺躲冗亢閑肌子夙杭剁風李咒染梨槃凰反凡伉沆抗坑吭炕鳳
鵑	鳴鵠鴿鵲鴨鴣鴆鶴鳩鵝鶉鷂鷓鷗鴦鳶鵡鵪鴒鴉鸛鷹
頃	頻須頒穎傾頂頑頓頊頌煩碩頡頤顆顏顯項頗頫頜頰頭頹願顧
汽	洽渝淪佇汀泠何丁荷行海貯滄薴佺偷河邱打叮仃釘例氣氨氤氧氮
峒	胴恫洞桐銅筒磊巖硼同石崩壹喊碉恰哈拾洽脰言答
查	楊渣香坦怛杷碴桓袒晝旺糧杳昊稈桿根旱靼但暨喳旦疸
拄	注柱住撲主拉拈往抖抆蛀駐擠撻註扯掉摘抗掠接撞擁
厝	昔借惜措醋錯厲莫萌晉寞草音芭暗豆墓慕摹暮三厥妍摸漠模膜曄
逗	脰短豈痘逼登豐豎豆逕言這愷遣磋豉戲壹詹凳
揮	漣渾鏈運軍輝庫葷暈鰱轟褲輦攆蓮軋連車暉琿
號	唬琥虎饕噓噱璩侃沉遞彪墟褫據擄遽濾瀘臚爐鑪驢瘧
帖	貼點店帷雨幀沾幅幃佔拈帕戰幛幟霑玷砧帆黏幢粘站巾帳
非	誹菲徘匪罪悲排靡俳輩斐徊北兆屝痱啡靠霏裴腓扉
毬	梂毛球毯求毽尾救耗娓撬橇耄裘牝氈髦麾氅屘牯技岐湃牛支毫看
支	鼓取救梂最十球娶屐豉技撮山翅蕞枝吱肢妓芰歧岐水求
聚	驟眾鄹醫樅傘匯縱蹤慫從鏗聳尿卒來巫夾坐滌儉愜淮淬濮俠俎
潑	撥醱廢發澄殼沒睽揆股投澱疫芟穀嶝燈橙骰毀殿瞪磴殷般段役歌欽畝
縐	純趨芻縲絲絢紲約絀盹糸繃繞綵絹綏結絨絕絃紇纜細紀
吏	使史妻宙事乖丈刊悽捷淒棲萋中大十耽陝軸睫鞅駛薇
敢	橄瞰幹故畋枚玫敞散敖救教啟敘敕敔敝敬敉敵數政致牧改攻斂孜收矢
摧	隹懼雌僱擢暹匯揣扎催攤睢瞧雛璀攜崔推攫瞿
喙	緣篆蠡噱豚逐叭叨豕豢吳隊啄碌咳豬吆叫據吩璩遽邃豳豭墜危
麻	痲糜魔空麼崆蘑搾戎嘛潸述挖靡麾摩磨倥朮穹穴嬤腔怵硿控
慕	芭募意漠墓昔惜膜厝糢蟆措摹草蕞莫摸萌模錯借寞幕暮冪驀音蔓葛
鏍	縲漯嫘螺騾累嗦嗉絲細潔綑糸纂縈系繙綵絹綏結絨絃紛繡維絢絆組絀
窘	窗窟窮簾窄裙空窩窈窒尹伊窕窪究窖穴穹君突竄窠窯竇
藝	褻囈熱芸蔭魂茗勢冽薹蓋夢莞爹苓雲苑丸執藏薔甍蔡蓊壽萼菱莽茅苒
蹴	就躂躋跤趾躑踟跳跡跋跑蹄踐跆足蹤蹼蹕踫踝踞跼跟跦距跌跛跚趺趴
蠱	蟲蝨蝙蜢蠡蠶蠹蠢螻蝸蜩蛆虹蟲蠣蠕蟒蟈螟螂蝓蜻蜥蛹蜆蛐蛭蚯蛉蚶
曾	鉀漕迺遭哂增昔醒繒曹昌晶鈿層杳酋僧憎西酉醋鋰曬嘈贈鹿槽
氈	氅耄毽毛澶耗顫牝羶尾麾毬髦毯毫擅壇檀娓撬橇
舊	蕉藺閻奮奪崔難錐進椎淮推惟堆唯瞿截僱隹臼雜離礁蹈瞧雕樵稻鐫樁
悼	綽悽獐惇恬漳憧卓罩憶怕悍草昧幛璋掉樟忙章悻障退早怵悴恨棹懍桌
滲	摻餞淺減錢踐洲浚滅殘渡參慘棧縿賤廊滋糝治箋
擴	壙曠獷礦拚摭廣擡摻挨找械拭蚶鍍撼遮渡捶甘箝戒弁
赧	赫郝赦赤赭嚇螫亦逮棣叩倒到鬥小弈帟奕鬨跡鉅卻坤卸卹即印卯鏗聊
界	疥芥尬介囚串佛畋甽仲患泅胃思田弗袖釧伸圳川
齧	齒齜髭疵齦齪齟齣齲訾契齬齡齷此穢雌上逃挑兆
病	仄疒疾餚疢奭鈉疽陋疥爻疝疳痙瘦奇灰疚炳療左內奈有瘟疼癢丙吶痞柄套症布
忽	勿惚刎易囫吻惕物錫匆蜴賜踢必慇剔態懇懲筷怕泌豹愧鉍
蓄	畜蓑荒芒玄鉉炫弦蒿萃眩藥蓮絃慈茲慌舷罔蒂菩孳蘆薺蓬茫玆惘
霖	霞霽霜零靈霾雨雩霎霪露霆霰霄淋雲霹霓琳霑雯雪霏黴震霍
疋	胥蛋婿楚旋漩礎走足進嚏久欠迄弦定夜卒是赴迤促捉陡途閔
磺	璜橫簧黌磁磊磋碰碘黃磴礦磧碾譁碳碟礪硿砠研石
頂	頃項預頑頓頊頌煩碩頡頜頻頭頤顆顯須頒頗領頫頰頷題願顛顫
塊	魏埤坼蒐魔訣戍麼垢槐缺愧魅魁瑰魘魂魄快傀幾餽圻決醜鬼刃
薪	新晰淅廝芹蜥逝嶄撕嘶浙析斤漸慚近斯昕沂折圻聽匠
篌	猴堠喉侯筏篠符八答簽籥篛夜籌天籲癸昊乞黎葵疙儔跪揆健迄你屹吃
談	詼譙誚諒誡誌謂詰訟讜誼請諉諂諍認誥謀諜諾諳詫試詩詣詮謨詔譜識
韉	革鞍靼鞘薦韁鞣鞠鞋靶勒韃鞦鞅鞭靴韆緙霸鞏
以	似幻姒樂幼吆瓜玄幾呱弧狐弦炫鉉爍鑠糸奚畜茲藥
爻	餚痍希痂大崤疾樊駁左灰有尖艾疝疢瘓療唏烯晞
閏	潤閂開門玨旺閑間閒悶問閃閨皇全閔閎閉閘閩聞闐王枉汪匡
牝	批比指能仳沘妣枇毗牛庇屁昆牡叱化牲紕此牠北牧物牯毛匕皁尼它看
啾	愀揪鍬鞦鰍秋秒稍諉禾稟琍俐和穌逶倭墦播潘萎愁痿秦審蕃
襲	聾龔壟袋袈襞褽裴製裝裟裘裁裂依龍籠龐寵衣矓瓏朧隴攏嚨
樑	樑搔淺治粱牀溥溧渡爍騷鑠淋漆滲滅嗓渣減浚礫灤浪浦泳沐樂藥栽蚤
晷	偺咎閣客咯各略格烙胳鉻恪洛反路珞皈冬愎絡鈑腹詻貉賂酪複板咚返
穫	稼利秋稔程秈禾稷穢擭稱獲和濩移稀稚穡稻護穗稈隻嵇攫雙穠稜私秒
憊	恿傭用內鈉掬吶應想您思甭忠芯志肉甩丙掏拘
畜	玄蓄炫弦鉉眩絃奚藥吆關茲舷姒似爍鑠麼樂窈玆拗嘰以璣機幻礫
醱	潑撥廢酩醮醺醋酸酷酪酉醴醞醒醇醉醃酵釀釅醜酴酣酥酗配酌酊
枳	只識織職幟
庸	鄘傭慵巾匝席吊布康唐市央允殃盅庚劃帷帝帥鈽帖帛帕簾怖滿希佈州
邶	北枇沘毗批妣仳此兆比紕琊雌螂能昆庇屁陀佻砌洮挑姚逃桃挪娜哪梆
辛	卅薛僻辣宰滓癖鋅瓣梓辯辭立辦辜避莘辨闢薜辮 
禦	宗奈禁票祭祟示行竺三碳滅二不桁阮崇炭些齋芣蝨否韭襟棕淙捺徑杯
咕	姑沽估枯詁鈷古固居苦牯味吱胡蛄骷湖葫做瑚糊罟
富	輻逼幅福蝠宣宗完豐匐害合蔔副噹擋檔襠鐺痘拿豈賓鹹言宇同石士
肥	杷把吧巴芭疤邑笆耙爬靶爸浥色琶朋梔冥扈葩
並	異井拼拱姘並迸普鉼碰胼併供踫哄共烘餅恭基屏洪
辣	悚薛僻宰速滓癖鋅瓣梓辯辭辦辜避莘辨闢薜辛辮 
泳	法淺沁泠脈涔涵浪永漾泛浚樣河渡沸樑汕汛汰濂沖沐詠丞汝汎汨汐浦治
蟹	蟲蠡蝨閩蛋蜇蜃蚤螫融蝕解虺蠻蟲邂懈螢蜜搔強
嬝	衣婢依妨裊皎娥姓妖妊妒迎梟鳥島裟裝裁魄鳴娘媳逶婚激檄繳白竅裳
乩	佔佔拈沾諸店巳帖玷砧站訕惦選圖圯叱咄貼點包京亮
虹	蟲蚵蛭蚜蚶蛆蚯肛釭槓江扛蝠蟲虻紅蚊蚪蚌蛄蛀蚱蛙蛔蛐蠕蠣蚓
瘧	據噱遽廬蘆墟噓璩疸些虛虐琥擄唬濾瀘爐臚鑪
瞎	轄睛害瞋睫睹瞄睬瞪瞻瞼眸盯目瞌瞑睽瞠瞞瞟睦睜瞳瞬瞧矇眩眨矚睡
醣	酬醜酌酣酥酗配酊酩酉酴醋酸酷醞醒醇醉醃醮酵醴酪醺釀釅
硝	捎哨砍碘俏砠銷碓研讜硯鞘悄砟稍砝砰碩睄砂砧梢峭肖碼逍消誚噹帩歌磊確石
伏	吠畎偽袱伐犬獻代狀默戾突哭臭莽猷獸俟今跋傭尤筏獎器
甍	夢薨蔑甕蘿寰瓦篾籮澴環還瓶爵甄遝楞愣儸鰥玀囉邏鑼
貯	賊佇賭貝貽賤則薴貶賂賒賠賦賻贈贍貼賄販敗財賬
噩	喪王瑕吉鱷匡琯瓖玷旺枉玨玥弄汪全再玉器璟襄瑰瑭蜩銓瑚碉喜單斑
鈣	沔丐釘釭鉉錠亡下鉗鉅釙銀銬虻錶忙鍔鎘鐳芒肓杗忘妄
綏	綵綬緩縲絲絹纓組網綱綢絃糸結絨繃縴細納糾緲
嘎	戛廈夏咱噢自嗅賤眸呃洎算篡臬眉省嘖楣喱媚湄唔鎳首員纂
恰	儉恫石險搭籥洽撿閤瞼哈蛤給拾簽臉檢愉合塔鑰磊愴答 
炎	傑少無黑魚尖焦淡火煤疢談竈焚榮啖熒炙灰灸毯羔夥燒燄痰烤災氮炒燻塋然燃
嗦	索嗉縲縈嫘漯鏍嚏絲纂潔螺騾喲糸絹結細絮累系
進	椎淮推惟堆唯錐離雜暹隹崔霍雄雉雊稚碓睢帷準
嬈	撓澆僥曉橈燒鐃繞蟯蹺饒驍堯珪娃嬉圭翹畦桂哇掛卦佳壅奎
豢	豳豚逐豕券據豬噱遽邃卷豭璩眷拳半叛判篆墜煬隊揚喙
睨	倪霓兒睥睡盹眇睢眼盼盯眨目睫睞睹瞋眠瞭睬瞄眸睏見身瞿
錘	垂釩捶鉑甘鍛鈑甜棰陲銑箠 千鎢鉗鍾綞睡銖郵唾
殷	般段殼股毀殿投役穀骰毆殺設毅疫芟沒所浸侵搬澱鍛乍戶戾房槃慇瘢
鎳	臬洎咱自邊癟睬楣首導算貧省眉錦鑠湄媚鑽道睞睏篡戛
奕	痢父尖跡荊莉蠻赤刈螫錡鬨巒小市交郝爻艾鬥變奠前症帟赭鈽奐鬧亦詹戀弈赦
噙	擒禽喻吃嗆唸哈吟漓咻儉璃魑吶喉咿撿檢臉斡於唯僕
尾	娓耄耗撬橇髦麾氅毛氈毯屘毬牝毽挈牛毫刀扎解
定	是錠綻靛堤提隄緹宇家下室寅士匙宸寇宗完宣富賓
邐	麗欐曬灑儷驪鹿鑣鏖麓麋塵麂麒毗麝比麟能枇沘批妣仳昆庇屁
渦	洛淫剮猾滑萵淨深骼骨窩亂咼禍過沼沿滔朋淌鍋沮蝸媧浩涪浮堝撾沉洞治
陳	陂弔棟隅陣凍限陌阻阱阡東陴陲陡陝阿防阪除附
組	約細絀絢絹緲且紅繡糸緩維紐紗紋誼糾紀縲紆絆綵綬紂綏祖絰納絲阻宜縝紲咀純
宦	臧臣臥藏臨贓堅腎鑒臟緊賢鹽豎宙叩卯官家宋寅寓安卉穴屢茆昂節聶
騾	驛鏍摞駁累馱漯駝嫘馳螺騎驗馬駟驢縲駱騵駒駭驥駛駢驕駐驃驍駿騷騁驟
齣	齟齦齪齲齬齜齡齷佝齒鉤枸拘齧狗苟駒夠此兆逃
淡	啖炎痰毯燄談氮漁潟消炒沙燃燻熒蒸淌洸鯊恢妳糕夥水火莎疢炙傑灰
任	妊衽荏壬呈廷件作伯仟傀飪浩造燻告皓入望窖聖
腥	惺猩醒星鏟旌生隆牲性姓笙腸產甥猜甦晴拜冥
縵	鏝漫慢鰻幔縲緹饅蔓絲繒織線繹細糸縮縉繙繚緩締繪綰綿綵緇綬續纏
比	仳沘批妣枇毗庇屁昆能紕匕化切叱牝北此頃尼它旨皁
墦	播潘幡繙蟠審蕃番稞琍逶倭禾矮悸透穌鍬啾愀揪痿萎秦
咐	附咻府符駙付吋侍咿樹傅傳寸喉榭吟峙恃持俯時磚蹲痔等奪廚
鈾	袖迪柚油抽岫妯鏤由笛宙釉軸鏽胄冑鼬釗丫鈿聘娉曳申婁
誑	詮逛詼誕訛謎謝訓詬誰詛詐訴註訣訢訐訕託訏訃計訂誌誥誇
艋	艦蜢錳猛舟舵舷船航舢艇艘艙舶舨舫孟褊遍磕瞌隘溘楹嗑濫尷偏檻襤
雹	抱砲雷刨霜糯雨霎苞而孺皰霆需劬燸泡炮胞跑儒匏咆鉋包霧嚅袍鮑懦庖雪濡飽蠕
麗	儷灑欐曬鏖塵麒鑣麓麋麂邐麟驪麝鹿毗比庇紕枇沘批妣仳鍋蝸過滑渦
茨	次嵌恣姿諮藏羨崁嶔簌闕資葵勻懿瓷芝久柩掀漱嗽撳歙
鵪	鴆鷂鴨鳴鳩鵲鵑鵠鵝鶴鴿鷓鴣鴛鶉鵡鷗鴒鴉鸛鴦鷹鳶
讀	請詩諾譙謀講牘談諉謂贖譟諳瀆犢誼訟譆黷識譚諒續謨賣譜櫝譯諜誌諦
鯈	攸脩絛倏條修候仇鱉爪仲魚悠傲傚做倣敕收漁俟魯
喚	觼喫澳湧襖瓊噢嘴邂懊瘓煥懈嘮踴哎啗勇吹奐渙燠換
鍍	渡踱錢公度鐮械拚戒弁遮賤摭鬆忪獷擴壙曠誡礦賊貽鋪鈸蔗庶翁庠
史	吏使中大駛央袂陝墮薇右甲由矢夷天太夭兇尹弔文父犬聿尢巾丫串丈
要	粟韆腰亞覆賈惡慄女價堊婁妥妯耍褸遷由啞袖溧串
粱	樑屎糜米迷咪粟蚤氣粥麋樑憐燐遴粒粕粗掬璘料敉籽紂磷轔鱗
湔	箭煎濛剪前滿瀟滋漠濩灌涮刖溢溝測削刺制掣
贏	羸嬴瀛崩硼員盲肓舜受圓貝贍賸臢噯賊損棚娟則朋
聒	活括恬蛞話舌聶颳聰甜耿恥取刮耳耽舐耶舔聊闊
贗	贊賃貴責貨贅質資賈貲費賀買貸貫貢員狽賢貿廁濺鋇測惻側
汰	肱太宏汍洧閎浹淆雄叉篡沁沐汨沖沃汶決汝汕汐法汁淦釵淹滯潦水
萍	平枰抨坪莎蒲蕩秤砰蒞茫範藩藻菠落蔆薄芣評
堇	謹勤
娌	埋哩浬俚裡鋰裡狸理姻鯉嘿童黑貍姆喱量墨黛
旱	竿捍悍桿焊銲旦幹桿肝汗奸稈罕趕昊旺軒橄是岸查疸但怛坦刊訐袒敢
酷	醺酪酩酥醜醋醮酉酵酸醇醉醃醒醞醴釀釅酣酗醣配酌酊
丙	柄炳病陋內仄吶鈉肉巫傭蒙佾俎俘胥準納訥雁筮榷確憊
茵	苗胭姻咽茴氤恩嗯曲因萬艾描錨曹男菌囿若芯昔薯更囪廿瞄
嶺	頻顆令貳齡頓拎頡蘋頤擷癲頌玲澦傾頰贛鄰碩噸鈴頊巔頫頑領籲憐鬚預煩瀕昤冷頁伶頷頜
指	脂批詣牝旨能比昆毗枇沘妣仳庇屁揩叱化紕匕尼它
曰	日昌旦明杲旬汨昔杳晶巴白早百艮門旱旺昊昇昧昨昱冒晏倡娼唱暗
呈	聖逞壬妊任衽程誥告浩造望窖薰廷皓燻吒咋叭郢酷
膀	坊滂鎊矓攏龐肪枋楞徬嚨妨傍謗房磅榜芳方旁螃愣籠朧仿寵
扈	邕浥滬邑吧乍戶怎房肩葩梔笆僱扁戾巴所咋笮疤芭扉唳殷絕昨柞炸杷
陶	淘掏啕萄搖遙榣瑤謠缶陀院除阮缽缺阡弔陪陸陰陷陛陞階陽隍隄降隘
戶	妒作窄廬扈爐僱扁笮砟房炸肩乍驢乃成戾方咋祚昨所怎柞
蒼	瘡傖槍滄搶愴嗆鎗倉艙苓莓茶荼荃養食蓓葆荷創
脹	爭畏脈淨肪悵漲刁脤煨叼賬服掙胚肋肝胱喂肛胯朋膿肚萇帳張崢長倀
妖	奏妒矯襖祆姓沃嬌添轎笑舔契娥僑湊妊喬驕忝夭婢橋躍媳吞揍
柬	揀楝煉鍊闌練瀾攔欄爛蘭籣東諫斕棟柙畔梱魚棵番
嬋	彈憚禪蟬簞闡單戰襄囊鍔愕孃儼毋器娟釅如嫗萼囂巖
鐲	燭濁獨躅觸髑蜀鉀鐸歜賣曙澤擇鑼胛柙狎押呷閘曼匣
怪	奴又忸挺梃庭隻雙恪愎廷馭涎健腱蜓鍵筵沒建候毽艇夜堅痣霆燮壑
嫗	嘔嶇樞軀奩驅區操橾櫺闆歐品甌鷗嬋毆噪娓妮
寇	冠莞完梡皖院玩元宗宸頑沅定崇宣淙棕阮寂寤寅家室宇富賓兀敲糉
單	簞嬋彈憚闡禪蟬戰器哭咒囂毋實嚴慣區襄獸貫囊巖車儼
膛	嫦捎哨黨擋俏螳掌檔銷撐償常讜棠瞠悄當鐺鏜襠儻堂梢峭尚逍消噹炯
奴	馭努怒梃又健挺庭恕吳好怪隻腱弩帑妳雙鍵妞娛
板	洛扳烙版路咯阪珞飯鈑皈返峯恪舨叛皮烽降反胳鋒販逢鉻疼咚客格略
縹	嫖鰾瞟膘標鏢綜漂驃縲緬絲紜蒜縉繪經紆紅繒繙糉纏給絃絰細糸票
浪	娘狼琅食養良飧癢餐艮浦泳淺治濕餮饗根退恨垠汨汝銀濂渡滄樑痕饕
闊	閣閔閒恬闆甜刮括閨門閏聒閻閘間開閂閑闕閎問活闢閭悶閥聞闖閉舌閃
裁	裘褽專哉襞袋裟依製裂衣襲袈載裔裝裳惠栽裴截
吸	洛扳烙喀閣咯板阪路唆各伋鈑殼返恪及汲冬岌反胳級圾啗鉻極咚客格略
靛	錠綻提堤定靜緹隄是臏青擂晴清情倩菁儐稼瞎濱嬪精殯檳靖睛暄嫁貯
具	植懼姐直颶琪且脤疽值棋箕冠淇其祺沮期二欺宜俱咀
臃	擁壅雍甕腋妊腿亥眩骸臆膀骯鉉逞造淫炫弦臍核垓咳肪壬望罔
倘	趟淌徜儅躺俏嚐儻夥償尚炯堂掌棠當伴趙膛噹擋檔襠鏜鐺肖常黨
死	屍歹殊殉庇斃歿殃殆殘列比殖殯能殤殮仳沘批妣枇毗屁昆
豚	逐豳豢豕豬據噱遽邃璩豭腸塚隊喙篆墜肝揚場煬楊暘塚鍚劇瘍
彩	踩櫛脈脾彬箄豺榭彰彤趁穆射物彪睬彥彫修杉疹膨彭採須睥衫菜貉桁珍影形嶸
恫	胴峒洞桐銅筒磊恰惆硼同石壹惘喊碉拾洽哈脰言答
芯	芍苟荀蕊苞菊萄葉廿恙恭葡蔔心昔忠苗志思艾遂
穿	芽呀蚜牙琊訝空邪雅窒窄窠鴉突穹簾究倥控崆腔
擾	優擂憂扳燸懦濡孺嚅糯儒蠕鐳恪投擱灞壩抗披反蕾處
翁	蓊嗡塌遢榻煽翰蹋瀚廖羿翌習翟翠翼摺褶濯擢櫂曜
歐	砍歇歉驅歎漚玖磴款證飲欲嘔區次欽歟軀毆炊坎嫗鷗畝甌嶇軟吹歌欺欣樞歡
參	摻餞淺盞朗郎鄉錢晉殘瑯慘棧滲牟縿榔鹹戊廊螂糝箋
茅	橘矛譎霧矜務茗多苑懋栘侈芝舞爹予移夥茂序騖蘇苓夢夕杼抒妤
迦	咖伽茄痂加叻脅另肋力男劾助劫幼協架勇荔劣
書	晝畫坦在昌垠昔杳晶場堤瑁塒耆曹春音香曾替間旨曰日倡娼唱袒琨汨
副	刨別釗刊割剋劊劍劂剛刈列幅刮削剖創到則剽逼匐刷刖剎剩劃福剝剌剴刑
咖	伽迦叻另茄痂加脅肋力品男嘉助劬劫幼勛協勇架劣荔叵
蜜	蚤虻蛔密蛀蟲蛄螢必虺蛇蚌蚱搔蛐閩蚣蛙蚶蚊蚪蚓蛆蠡騷強蚯祕蝨
隅	遇偶耦寓禺邁愚癘藕陳阻陣陌限阱阡弔陲陴陡陝阿陂防阪隋附
笆	疤芭邑巴肥杷把吧爸耙爬搗琶皁白絕靶貌葩藐扈色浥梔邈
合	侖捨會儉仁佞丘伺石搭同洽拿閤哈翕給拾簽全盒命豆鹹塔恰凳餘籥何答登 俞
崗	罔剛峒血腆柵魍茁睜山胼厥鋼皿岡睬塑逆闕惘溯崩綱冊朕峴盅崢崙朔
蛛	蟲蛞蚱蛾殊蛄硃蚪蚌銖珠株侏蟋蟠蜊蝌蟲蛙蛔蛐蛀蛆蚯蚶蚊虻蜂蝙蝗
噬	筮巫靈誣聽咯叭雁噢嗥嗅唳砭咚唾斫呱咋吒喊呈
訶	訂訐訏評詞証詁詛詬訝訌訕訊誣訃計註詠詐訴詳話詢訣訥許訢記託討
譙	誰談詼礁詮諭論誨誌診訖許訥護謂諒誡誥詩詰訟誚註訕計訃訛
惑	感摑幗國或域蟈怠憾臺撼惡怡惠恣恕慼思哉忠芯忍志應名笞苔胎迨擡
怖	佈鈽希布恢唏晞烯惰稀滿滯巾帑棉啼瞞錦蹣席幣
之	眨永泛芝貶飲欠次欽灸歜久炊疚孓坎吹乏今砭閃
亞	堊惡啞氬串片工要慄蜇患介粟慄溧腰遷融而蟲弗正斤止版槓汞肛兆圳
漯	縲嫘鏍螺騾潔累嗦嗉絲細濰綑糸縈纂系綵絹綏線渭結絨絃繙維絢絆絀
舜	瞬受憐遴燐愛桀璘朋磷傑轔鱗崩棚胴舛麟硼鵬
苜	冒莧目相眉看省盲眷算督瞽賁瞥菜篡渺瞄懼瞿廂箱寬纂首貝自盹眇盯
代	伐玳弋伏拭式岱今念偽傭弒試軾袋筏貸黛伶俟傖膩令含忍食倉惠
冬	各反疼咚返扳板終逢鈑客鼕阪叛咯恪洛皈格烙胳略鉻
昭	韶炤迢招沼紹貂超詔召叨照初刀分暘解賴切忿券岔
浙	拆薪聽晰哲昕淅嘶廝斤沂析逝掀嶄蜥圻芹漸慚折近匠撕
逼	違言富擋這蔔迺檔蝠脰迂逗逅謂幅同遣鐺輻襠匐遷副課上噹詹福逕石
黷	續櫝黠瀆犢贖讀牘竇黯黔點黜默黝墨賣黑嘿壎
麂	塵鏖麋麝麒麟麓鑣麗鹿毗皆冗亢庇躲儷灑比邐欐曬
巔	癲顛嶺瞋蘋籲闐貳鎮噸填慎傾滇瀕擷縝鬚贛澦
拖	迤施他拾拴捻也拎掄捨搶撿擒牠迆弛池她地撫扶推馳夫
儼	釅巖嚴鍔愕萼囂禪嬋彈憚靈襄器蟬臨侯佞仁囊闡簞哭
刪	刑刖剛剴冊皿刺制劃削刈釗判利刷刊剎剌則剖剩劂劑
魯	魚鯧嚕櫓漁鯊鰭鱉鱟鰻鮭鮪鯽鯉鰍鰓薊魷鮑鮫鯨鯖鯛鱷
囀	轟轉糰連載庫軍陣範輦轄輯車輩團專輒輔輊軒軔軋磚傳軾
拇	姆每毒母侮悔海晦梅莓押誨黴敏毓嗨捆找撲摔撤摑育
拴	掄捨遑王湟痊班擒拎銓捻玨玲搶撿瑜斑荃拾全詮拖煌隍潤推佺珍惶栓
俞	侖喻會瘉仁輸亭癒逾褕拿渝倫瑜愈偷盒愉合寧榆
倩	請猜精績債蜻磧情菁積睛責清嘖晴蹟鯖漬青靖
卸	啣御丘邱叩即卻印嶽乓乒卹卯仰腳臧蚯頤泖迎抑柳唧鉚孵兵命昂茆節
牯	牛枯沽姑咕牡估鈷湃牲拜牧牠牝古苦居固物蛄詁骷犄犒湖看葫
闐	鎮瞋滇慎填縝巔癲真聞閏開閒閂顛閨閩閘閔閑間閎悶閉問閃門
貪	鋇貝令側貸含偵賊員債賀賬念廁貨吟費價賡財貧責賒賤貽鈐俟岑伐伶今負
欄	蘭攔澗鍊們櫚爛嫻煉柬簡揀燜閑籣憫僩捫斕潤瀾楝閉闌練
寬	賁莧髖寞筧覓苜見覬峴能它卉墳噴憤硯視現規比
矮	倭痿逶萎諉秦委痢矯矢短榛潘播悸幡墦知俐透繙蟠雉矩穌仃揪愀啾鍬
械	棧拚戒弁櫥梭誡村私寸庶度渡摭遮鍍庠蔗腑俯鬆樽擴壙曠梂肘忖吋付
璘	燐遴磷憐轔鱗麟璨舜玨粥班玲鄰斑桀璣璟璃璀瑁瑜琛琦傑琉珪珞瑰瑣
舷	玆舫舨艙艦炫舟舢玄船艘弦舵眩絃艋鉉航舶艇
味	妹沬昧未魅咕吱宋哮朱喃嗜嘲阜呆守侏咪吐吋籲株硃銖喧嚀口品茱寐
瘟	侖遍盞醞氳褊媼藍篇偏籃嗑塭溫皿盆盜闔跚慍錳蘊濫盧冊溢尷溘盡蓋 
戌	戊威鹹崴減喊滅箴茂戍成後斥斤牟竺竽竿緘卮戚鹹
抿	岷泯氓眠湣民扣捉捐愍拐抵揖攘拈抱拘拓括拽找託妁她吆撲叫扎搪偯
饅	鏝飭餞餾飴餃餚餉慢饑饉縵漫餌餵饒蝕幔餓餡餿餅飾鰻餽曼餘餒餛蔓館
垂	芋朱捶奔甘某煤甜錘棰陲卉疳虛箠仟 千芣卑鉗柑媒綞箝睡坩舌郵唾阡
釗	剎則劃刖刈釧剌削刺制剩判利刪刑劉刊劑剖剛副剃到刮剁刷別刨劃列
萵	窩過渦堝鍋禍蝸滑菩菜茗苔骨猾亂撾蒿蒙啻苜迥炯朋
增	漕遭場倡坦繒鯧曹娼唱曾墦湮煙鈿層錯僧憎逵西醋嘈曬糟壇贈鹿堤槽
揣	掄湍拂掃而需瑞擂耑燸擾扎儒耍耐顓嚅端攜懦踹濡摧惴指撬喘
粉	汾吩精扮氛糢岔紛貧米枴盆糞忿粕份拐分糟寡糕芬糝
窒	室穿空致崆屋蛭到緻倒侄倥穹握輊腔至突喔耋絰渥姪控
屘	尾籽好仔季孱娓毛孝孚孛李存字囝孕牝猛艋錳毽子學
螢	蚤蛔蛀蟲勞蜻榮熒蛄搔營螟閩蛐瑩蛙蚶鶯縈蜩蜜蛆蠡蝴強塋犖騷蝨
佾	趴叭扒俘倩僩八倭偺偏僑僱傭作伯佚件任仟傀內入
蠣	礪蟲蝠蠕蛐虹蟠蟆蝶蝸蝓蜻蛤蛭蚵蚜蟲蠔蟻蟾蟯蟬蟀蟑螳蟒螺蟋螃螟
妮	呢怩屁妣尼能妃枇批毗沘仳紕昆庇沱佗娓比匕屍
鴨	鴣鴆鳴鵑鳩鵲鴿鵝鵠鵪鶴鷓鴦鳶鴒鴉鶉鵡鷂鷗鸛鷹
船	舟舵舷航艙舶舢艋艘艦舫舨艇鉛沿迨幟釦向蚣唷胎銘噢鍋丹
像	橡豫像你仔億俑伋仍乞們佰伯佝伕他代仇傑侯侈健
喬	矯犒蒿稿沃嬌向鎬妖嵩轎笑 搞僑膏篙槁驕忝高夭橋癌吞
漬	嘖債磧積績蹟潰清責遺槓損匱簣賸慣睛價隕晴情倩瓚臢鑽圓賁
逞	程呈造淫誥壬聖哀告荏京浩郢衽妊任梃挺毫高庭亳亭亮豪享亨
杲	桌曰日晰昌閑木採牀宋呆旦森晶林昧杳昊昇杗柔某柒旱昱冒釆栽朵樑
猛	猜遍猾猙蜢狩褊偏柵鹽盂猖孝皿盆季檻狷存錳盒狙艋監猓孟
和	程禾秈私秋委香番科秣租祕稍稚稞杏秧秤秩稅秒利稠季禿黍
迫	遑柏泊拍怕伯鉑白珀帕粕舶腺泉湟棉惶煌嗥錦韹葩亢篁
奮	奪雉雞蕉崔隹錐椎進雄堆唯惟推淮舊截瞿僱癱樵憔榫離雜雒睢碓稚雊
卯	泖柳鉚茆卿聊留溜榴遛瘤叩印卹孵劉貿籀即卸卻餾霤
杯	枰壞不芣示枉桿否痞秤本槓柯柄朽棕平丕宗奈甭盃禁
褫	密褊虎襬侃襖裨唬衽先號必彪川遞膚鉍袍熄杉泌衫衹沉媳琥祕兒
幀	楨偵禎貞帖帽幟帷帕幛幢巾帳帆貝鋇幅幃幌幔幡幗雨貴員帝霜
鞠	鞘革菊鞋靶勒麴鞅鞣鞍靼鞦韉靴韁鞭韃韆緙霸
翩	羿翻翔煽扇翎塌翹翱翁翅翌翳翟習匾蓊翮遢栩羽翡榻
鮮	鰍魚羊磋蘚鮎你搓詳洋咩癬徉鯨羣氧祥羼烊差穌嵯嗟羋蹉庠鰭佯
竊	呼窄乎窮悉窖蟋竅窠窗簾潸釉窺窪窕窈突空穹究釆竄窯窩搾搾
頤	頻頡顆顓碩頊頒頌頓煩項頂頃顯頰頭頹頫頜頑須顧
窕	簾窮眺窄窘窟佻跳洮窺空菲竊逃桃窈窒挑靡窪姚究北窿穴兆穹屝痱突晁窠
挺	馭淫蜓奴荏程毽霆涎梃健又投庭誕延廷怪筵隻壬腱逞雙鍵艇
孑	孔孜孤孩孫吼孺了乳菰蓀遜孓閂危亨侯弱互予承沒桅脆弼閏開溺預壽
夷	九旭仇姨咦胰痍友丸究疚鳩為汍染軌大弓孝弩瘓鄭
祉	扯址芷企趾啃武止禎肯祈祠祖神社祁歧禳歷祆祇祐祕祝祚祀祥祺祿福
傷	楊儉場觴儈殤倫揚傖侮偷煬份腸鍚瘍陽暘但佺伶
迅	汛訊通遐卜卞築迂迆返迪迫述送逆迷退迴迸逍連速進逮遁逢逸邂鬥亢
酴	酣酥酊酗醜酌配醮酉醣醋酵酷酪酩醇醉醃醒醞醴醺釀釅酬
玷	貼點玥王班珊玫玖璨沾理玨佔帖拈瑰戰璋斑瑭砧璿琉黏璟粘玟站瓖璃瓏琥珀
輊	轟室軻軒軏輛姪軋軛輻車輔軸軟軔軌窒屋較軼蛭絰輥軾輕耋
溥	搏膊博傅縛賻浦補脯鋪捕埔哺莆圃薄匍簿蒲潯輔甫
憐	傑令磷粥咪齡迷屎籽遴拎燐轔舜粱玲舛鄰桀愾鱗鈴領璘冷掬嶺伶麟
推	準隹帷住離碓唯雄維雉挫睢淮堆稚惟椎錐崔雊摧雜進
洞	胴恫峒桐銅筒磊洽沮減湲硼同石壹喊碉拾恰哈脰泵言答
磯	礫磊譏嘰幾碌砟砝砂矽歌碑碓硝砧砠研砍斫璣機磁石
瘀	菸淤簇倣於芳房嗾肪枋鏃妨坊仿旁防遊方漩遊族旋旎紡旅施放彷
例	冽琍側咧殆汽歿洌列殃硎殘涮斃裂殤夙測倒惻歹捌蜊烈俐殊侈屍死喇何殉
醮	醺醋酷酴酉醞醒醇醉醃酵釀酪酩醜酣酥酗酌配酊蘸
斡	榦幹翰乾廾朝戟韓斬鬥斜枓抖蝌擒噙於魁斛料蚪科僕潮嘲廟
輾	軸展軏輜輪軌碾轟轅軛軔輕輻軋輯輞車軟軾輒軒
咯	恪洛咚格烙胳略鉻詻路珞絡賂骼客貉酪駱閣各
蟲	蚤蟲螻蠶蛋蛭蟆螢虺螺虹蟠蠱搔閩蚣蚶蜃濁蝕蜜蚓蛆蠅蟀蟒蠡蟈蜇獨強蚯蝨
堵	諸署屠楮曙渚薯睹箸嘟豬者暑賭緒都藷躇赭煮褚儲奢著
依	袋裁衣袈裟裘裝裂製褽仿裴襞襲僕伉裔裳位住佔儕迎倣
晰	拆薪聽哲昕新淅浙嘶廝斤沂析逝嶄蜥圻芹慚漸折近匠撕
痕	艮根退狠恨垠銀疤眼限疸很跟艱奢良偃堰腿褪齦
胄	冑由胃宙笛婁迪柚油抽岫妯袖鈾曳申渭喟賈軸裡釉裸
昕	析近折沂圻聽所斫祈斬斯芹匠新晰斧訢掀斤欣浙淅逝
乙	乞函吃屹迄疙挖涵山弓紇訖色龜九了七丁幾匕又久兀夕子小尢己已巳
朝	韓斬斡撤乾肺澈沛廾嘲翰甫潮芾朋戟脯嶄廟幹胡轍榦漸慚明宜輞
框	凰劻遑玥王湟木痊班銓玨拴櫃旺匡逛斑林荃材眶琳筐汪沐枉煌隍潤村棲佺柄柩惶樞栓
舛	夕外多名舞汐侈栘桀摯弘移傑夥爹舜矽麩飧銘憐遴燐甬歹丸凡令宛茗
庵	菴掩淹俺醃奄醃畚希鵪由鹿笛冑疣胄宙布尤犬晞烯袖唏柚迪鈽鈾岫怖
的	釣約迫杓鉑趵皋皈皁妁怕勺皓帛灼昀白豹柏魄芍皚皖皇泊拍泉伯皎酌
逆	岡送迸朔溯厥立道遂鋼崗闕泣拉垃位遭辛音茁笠昱妾
晌	昇制迥澳日楣襖餉自嚮向血眉噢昕曰媚懊昭晷映響晚星昨高奧炯明湄燠
橢	隨鄴墮隋槨椰榔梆郭婀啊鄭鄱陝耶鬱郎祁邱邢邦那
方	坊防旗滂施肪旅枋旌妨傍菸彷倣旎旋放房遊訪於榜芳旖紡旁族淤仿瘀
崎	坷寄荷琦苛犄錡騎婀河呵啊柯奇可倚畸綺椅何
分	汾吩炤扮切刀氛粉沼岔紛昭賴貧券盆忿迢叨份召初芬招
郵	垂笛捶郎邸邵郃鬱邢錘邦耶陲鄴祁鄞邱箠迪柚那都鄱油由部郢袖廟綞抽睡鄭唾
霍	雨霄雯雪霽霖黴零霓震雩霑霆霜霪霰霎雲霏霞霹霾靈
跳	佻逃桃洮挑姚眺晁窕趾兆蹶足踟躑趺趴蹤蹴躂跡跟距跚跑跌踝蹼躋跪
鍊	煉楝揀練闌諫柬瀾攔爛欄蘭籣斕東鈹鈿棟銷鋰銖鉀鈾鈔棵釦陳針釙畔
繪	燴儈給膾檜綸紇縲維絲納繒縮縹細糸織繚繙繽縵纏續縉緯線緩緹綻綜
謎	訃諒譴諄誶讓註謫課誚該詨訪訣訕訑訏討計諦諳談識詼
資	鋇側貸貫賃貴恣賢贊員賈賀廁貨質貿費贗賡瓷次責貲姿貢諮買狽贅
鐺	襠檔擋噹鏜銷儻當讜膛黨瞠嫦儅尚螳償福幅棠掌堂
懿	諮恣姿諮資茨壹瓷噎次脰磴愷恫登證蹬瞪磺橙燈嶝澄磋磁誌認短逗戲
叔	取沁籐督寂迷鳩鴃椒菽鳥烏汕鎢鴆塢淑沖汁沐尿嗚淦逍汝鳴汨水冰
油	軸笛岫洩泱沈胄聘冑婁沸迪妯鈾津柚娉沖淵由申鼬曳袖廟淹抽釉郵宙
躇	諸踩踢跎署堵薯踐睹跆躪蹊躑蹕者暑賭踫緒都蹲跚踴藷踏煮踱蹉蹶蹣足跟蹼著
星	昇猜拜姓旌醒笙牲腥甥生牛產性隆晴惺猩甦鏟
瀛	嬴羸贏濠淳涓汛茫瀘濬漳滾漓滂溪涼液涪淬娟流沆沾氓淑
抽	拂軸笛岫胄聘冑掩摟婁迪妯鈾娉柚宙油由申拽曳袖廟釉郵鼬
泉	白腺皇皋帛皁泊線箔柏迫拍的怕伯鉑魄皈皎皓
罷	擺襬篦崑鹿錕媲琨焜棍混能餛熊態皆楷階揩偕陛
夢	環篾囉楞玀寰楚移婪林澴茗薨甍禁蔑夥鰥栘蘿遝侈爹鑼爵愣儸邏還
淚	妒遍褊作袱偏煽僱戶笮溪砟蚱炸編溴蝙捩乍邀唳嗅戾咋牖祚昨滬犬柞
勒	革靶鞅鞋鞘鞠靼鞍協鞣靴鞦韁韉鞭韃脅勤肋功叻韆
董	腫湩鍾種慟踵懂重衝動茱蒐萸芹蓮葷蔥蕃薰裡千
呎	尺叩叨叼咫嗎呢嗷吹吶吐咋叭叻啄唯拐枴喔揖楫囑哪嗾嘔口品家
叉	釵又太閎奴宏汰肱友反廷沒夜怪建候隻雄雙夕及皮冬弘各吳扳投延弩
棋	樺旗植湛甘棕橫某琪堪麒甚樸梡芸具檬箕淇戡祺其柑期簸欺俱
薨	甍夢蔑葬蘿寰篾還澴遝籮爵環鰥楞愣儸玀囉邏鑼
莘	宰辜梓鋅闢辭薜薛辛辦辨瓣辮辯菩滓辣癖僻避
氾	妃杞範已己厄犯泥洱紀卮危忌卷記配汕改扼呃凹
癆	撈嘮勞痰嶸熒榮塋瘓犖肋營縈螢瘠瑩勇筋痂燃
逍	梢消捎悄峭哨俏銷肖屑宵霄稍硝趙迷誚鞘尚邇膛擋噹檔鏜襠鐺撇蔽廠
噴	鋇貝嚀嚶喀貫隕賊員墳寬苜賁嘖貯損髖賞貽圓賽喧憤實
躂	撻韃躋跤趾蹉足蹴躑跡達跚趺蹄踟跳蹼蹕踵踝踫跟距跌趴蹲躇蹶蹺躊
咚	咯終疼恪洛格烙胳略逢詻路鉻返冬鼕珞板扳鈑客
嗤	蚩缸蟲工啞釭虺聽槓肛扛江喘汞蛙蛔蛐蚶蛄蛆蚱蚯蛀哽蚊蚪蚌虹虻咄
荀	苟葉菊蔔洵苞芯詢絢怛昔耆徇旬蕊葡筍芍恨殉
弈	痢莉跡荊蠻赤箭鬨巒小卉市郝湔鬥奕戒變錯弁煎前帟芷薦鬧止亦詹薊弗戀錨赦
燃	撚然燻痰燠煥恢爾疢灰燦煖淡啖彌邇炯熒炎燄撈嘮談燼詼毯瀰肖癆勞
待	詩徠很徵行後律恃寺痔持徇徐峙徉從等徊特徒得侍時往徨街 
畏	偎喂煨猥餵衰簑褥辱表長娉佞耨聘胃思萇農圄畫甚辰田瓦牙互倀悵張
慣	貝貫隕槓臢潰績債瓚遺磧韻價積賡惻貧賸賁嘖損匱蹟鑽賞圓摜漬賽讚實
脰	逗短豈痘登豐膈同壹胴幅噎豆豎桐洞恫峒銅筒
娃	褂捱鮭涯嬈卦閨奎哇掛圭鞋佳窪畦桂蛙崖堯封
焚	傑噤痳秋火棟煤森淋爨楚婪林材禁燒梢襟麓杪烤災炎楝礬梵村秒
傍	膀坊滂鎊攏龐肪枋楞徬嚨妨謗倣房磅榜於芳方旁螃愣籠朧仿寵
逾	掄喻瘉淪輸蝓癒褕諭渝倫瑜迄愈偷途迤愉榆俞
條	攸脩倏滌篠修絛鯈仲候爪休搽附佻褓付俯悠介
罪	痱菲扉屝霏徘靡腓排啡匪俳誹非罹罩罰羅羈置買罵眾罟
萎	魏菌莉秦揪禾鞦愀諉潘蕃逶矮啾墦播鍬痿莠委蘇穌倭審
紛	汾細吩扮繙絹繒紹絕粉糸線絨結紉紗紀縲絃綵份緝分綏絲芬
莖	葬蕨薑淄錙巡黃經勁芸痙頸涇輕巢姦芽三災萇氫徑蕾陘逕
徊	待御徠很徵徜行律德彼徇菲徘彷匪悲非役衡徐排循徉輩從徒彿微得銜往徨霏衍黴徙
巢	災繅淄錙邕勦剿緇輜巡臘邋獵窠惱棵腦裸蠟姦裹鬣果猓瑙稞踝髁
撒	撇散霰撤擻蔽澈挨廠敵敞敝遨徹橄嫩嗷瞰傲邀做攸藪
潭	撢罈蕈譚覃漂漳樟璋湎標膘獐瞟幛嫖障蟑鏢早瘴
高	犒迥蒿稿京鎬亭嵩搞亳毫膏豪篙鄗喬槁亮享敲亨
炒	紗杪沙抄妙吵鈔炎眇砂少炸淡啖痰燻省劣莎熄燠渺緲
獅	篩師珮佩狷猴獺帥狎狙狗狐狄狂猩猜獄猶猓狼狹狸狽狡狠犯猿猾猥獗
確	榷碓磊礁歌碘硝砠砝砍碉石碩碰碑硯硃訥砧砷砟砲砰砂研斫矽吶硼砸
眷	胖畔倦盲督看豢謄相緲半蜷眉目苜叛拌瞥冒纂賸券省卷篡伴判姅攫渺算瞽拳譽
履	御徠很律復屢屐薇徇覆蹤屨縷徐癥樅徉從徊徒微得徨往衍縱桁徙屜
攙	庇儳屁饞枇逸冕比妣仳讒菟揩兔晚娩毚批勉纔擺毗挽沘指冤巉昆免
淄	錙緇輜臘邋繅獵巡惱腦蠟巢瑙災鬣涇邕勦剿姦
脊	益育月閒骨背胄肓冑棚潸鋼肩鍰瘠嫡朋摘銅胃肖受膊脯崩期有青炯錚明滴商
祆	祚祈祇祕祐社沃妖祗祀祖祝祁祥視夭笑祉祠神祺祿禎添奏
榭	謝射麝樹杉彬樽村待咐附彩特狩等符樅駙桁私撙傳耨褥遵時持恃峙侍
貨	鋇貝貸側貫賃貪貴贊員賈賀賬廁資費贗財測惻貧責貲賒貢濺買狽贅負
甫	博捕敷莆誧哺蒲戎輔傅搏補葡賻圃鋪溥膊脯縛匍浦埔
糾	絲縲細綠繡糸紅紀紂約紆紋純紐納紙紗絆紼絀紳組紲絢維緙絃綏緇
欠	仄砍之玖煞癸芝閤撳飲嶔次欽灸崁久疚坎炊孓畝閥吹歌乏柩人弓歡閃
塢	嗚鎢烏埠塊垢壎坼埤圻薛垃叔壞坍圯墦阜塘鳴啟逍師迷城垓帥坷坪坡
膠	櫂瀚羿餃僇煽擢廖跤狡穋塌交褶翁郊翌效翠翟習嘐絞寥耀蓊嗡曜繆謬校濯遢翼摺躍咬翰 榻
羼	蘚搓庠烊洋咩佯氧鮮磋羣嵯嗟祥徉差羋羊蹉詳
韋	韓度違葦本掌緯圍梧幃拿吾悟諱闈笨捂豆晤韜韌苯圄偉唔
赭	赫赦郝赤赧賭褚堵嚇楮渚諸睹箸署著暑屠奢豬緒
嶄	斬薪聽晰昕淅塹浙嘶暫廝斤沂析逝蜥圻芹撕漸慚折近匠鏨
觔	角斛劻動肋觴觼勇脅劫助叻勸觸勉勃勒劬勛幼功勳湧男努另
奐	澳尖湧閒央喚胰噢厭爻肋艾肱邂懊瘓煥懈踴燠解勇觔醃奧渙然角負換
臬	自鎳洎咱省眉算首楣戛導箱篡癟目湄媚睞道筧廂纂狽相睏湘睬嘎邊
鼴	鼬鼯堰偃鼠竄褪腿退艮銀跟眼根限狠恨很垠裒痕
鑑	遍盞褊藍偏鎰籃艦嗑磕盆檻闔錳濫監臨盍襤瞌溢尷溘蓋
瘤	聊餾留劉卯奮褊籀瘋茆霤畚奄貿笮卿榴痿鉚遛痺泖疼溜柳疫
荔	茄協脅男另力肋叻苣勇艾劣痂迦勒勘咖勤助劫伽幼
貸	貨貲岱員惻貴賃責貫贊鋇費賀買資袋貢贅廁側狽
敵	敞散離敝獻畋枚數敬敦敢敖敗啟敏敕效敉故政放牧玫改收撒撇撤澈矢
梃	挺蜓庭艇廷霆涎筵健腱誕鍵延奴程怪毽淫逞壬又荏隻雙
仳	妣批沘枇毗紕屁庇昆比能化傾花靴訛佗匙偕砌牝叱它尼皁
懈	邂解蟹煥換湧渙喚瘓踴觼勇性瓊挈奐尾懶屘忸惺娓怪牛刀忿
徽	緻繳黴瞰邀擻徹撇撤嫩澈微傲傚做倣攸俟廠檄橄激燉撒墩遨嗷維納嫉
憑	馬駒馳螞篤闖駢碼駟駛駐瑪駁媽嗎馱馮馭罵駑駕騫駝駙馴騰
酉	酒醮酥醞酊酵醒醉醺醇配酴醣酩酗醋酪釀酷醃醜酣酬酌
液	掖腋淬夜淳沆濠涼漓澶浸沒迄洛濩汶健漣涪悴浚流漳滾潼潑濾泣注波
橇	撬耗尾毛耄氈氅麾毯娓髦毬拙牝毽梔梳棉嵇格柢杉欖槐屘秩柏柞材扎
協	荔男另勒動茄幼助諧伽肋叻迦劣劫偕蘇辦咖痂力勇勃脅
鴣	鳴鴿鵠鴨鵑鳩鵲鷗鴆鵝鶉鶴鷂鷓鳶鴒鴉鵡鵪鸛鴦鷺鷹
咧	冽例殆歿洌列殃硎殘斃裂夙倒歹叮捌蜊烈屍死喇殉
襞	臂檗擘壁劈璧譬蘗裘裁袈褽襲製裴裟裝裂袋依
徬	滂榜傍膀磅螃鎊謗彷旁往徙徹楞復徨愣得從徐待後役行徜徒肪
僻	避薜癖闢霹闢辦辯辨瓣辮薛滓辛壁擘檗臂辜鋅梓劈莘宰蘗
薯	曙署藷著褚躇者儲箸煮暑屠奢楮渚堵賣曼萬諸睹都
荸	脖悖孛芾孳孽浮俘孚厚享渤勃肺沛遊學字子悸
敗	賄貝販財貼賭賒賅賬賺貽賊賤則賑貯貶賂賠贈
碴	查渣
轔	磷遴璘燐鱗憐麟轟轉軾車轍輾轅轄輻輯輳輸輪輜軛輔輊軻軼軟軔軌軋
摒	屏拼掘搆並井握耕胼迸鉼姘併駢招拒阱捲掃溝媾構遘碾輾攝攬瓶餅並
胼	迸拼姘併鉼並井屏耕阱朕餅駢溝搆媾遘構購皿冊岡
蝌	蜊蟠蟲蚪蛞蛛蚱蛾科蟋蟲蝴蝦蜥蜓蚓蛄蛀蚊蚌虻蝙蝗蜂
貶	眨泛砭賂販貽賊賤貝貯賒賜敗財則乏賠賦購賻贈贍贓贖貼賄賅
瑁	帽琨璟冒玨楣瑤琛湄媚璃璀琉瓚頊瑣現玥班王
斐	裴悲輩翡靠非雯菲屝痱腓排啡匪俳虔扉罪徘閔霏靡蚊誹玟抆汶
暫	斬斧祈斫聽晰昕塹淅浙斤沂析逝嶄圻所芹漸慚斯折近欣匠鏨
熾	織幟職識梳堉唷流毓硫琉疏炫育焙黯炕燦煜暗爐焊統母晉
餒	餞飴飾餵餘餡飭饑餅餌餉餚飩餽飪飲飢館餛饅饒餓餃蝕飼飽飯
旭	夷九仇姨咦胰鳩痍間友丸究軌色疚汍汨澗為昌染晶簡
上	此卡齒迂雌柴疵穢卜一言迺逗訾逼些延訃計訕戚慼齜齧
擡	拚怡治始胎迨找撼冶挨摭苔臺笞殆貽跆摻擴拮飴颱搪或怠
捨	捨拾拴撿掄搶幹捻拎拖擒捍搭儉偷揆倫恰洽哈佺儈檢臉鑰舒估
朗	郎盞育晉參朋淺棧錢鄉榔廊箋明堉唷餒瑯螂濺幽鹵
荊	硎莉前刑薊型華痢妍廁罰開蕨鬥捌倒研琍洌咧俐喇冽例嘩樺曄
剛	刨別釗剌利制剋劂刈列刮削剖剁到則鋼岡刷副判剜刪綱刖崗剎剩劃刺刎剴刑
腰	溧慄遷要價粟慄賈覆袖肛婁膈醃脰澴還環褸韆胴亞
蒲	藩博捕敷莆範哺輔茫傅蒞搏補葡蕩甫莎薄圃鋪萍溥藻簿膊牖脯匍浦埔
奭	宿佰百弼陌貊洹萱暄喧渲左疸宣晅桓垣症瘍奈誇
雄	截雖太進椎雉淮推惟堆唯準錐雊稚碓睢帷雒維離雜雞隹崔奮
印	叩卯即卸卹剩卻吒託宅仰抑泖迎柳鉚孵昂茆節
撮	蕞最娶揚捍捏提揭取揖技攝陬措捫把趣叢耳支
烽	峯鋒蜂烙絳降終逢絡略格胳洛恪咯咚鉻駱鈑叛板返扳
舀	陷鼠身脈脾裒舂蹈冗閻滔艘舊臼腺稻焰腴樁啗竄韜肌臾舅潟
挑	眺佻跳洮潰逃桃遺遣窕排俳姚簣北兆覜匱頫晁啡腓邶揹
牽	犖毫望眸犛肓牛胤亳壅盲牢牟牲迭牡件邂畜看亥玄雍特湃牯拜牧物犒
糠	糖慷康糝米粳粒粕粗料敉籽糢糟糕精粉糊糞尉迷咪糧粹糉糯糙糰熨慰
偕	媲混崑焜琵篦諧階仳皆揩陛棍琨楷毚錕餛鹿罷協
沐	漱渣沁木嗓森漆淋池汙框淅樑汕淞林沫材柒沖汁沬淦村汝波棲休決湘汨水柄柩
該	訥諛許託垓謎諳亥讓詐誰訃訪計識謫核咳註訕詨誶諒刻
匣	甲呷押柙胛鉀狎曼閘賣申屢擇澤濁獨曙燭薯鐸鐲
漸	瀚斬薪聽晰昕淅塹浙潮嘶暫廝沂斤析逝嶄蜥圻芹撕慚折近匠鏨
屏	摒並井姘拼併胼迸鉼展耕阱媾搆溝構遘駢並餅購
紱	絲縲細紋約紂鈸拔緘絨纏糸絆絀組紲絞絢絰紗純紐納紀紉紆糾緒維繡
拜	牲牯牡牛牧物牠牝生性姓牴特犄星看笙件惺腥犒犢犧湃牢產牟
躓	質蹟蹣踹遺潰價槓嘖跺債趴躊臢瓚躁躅蹶蹬蹺韻蹦讚蹈蹊蹉蹋賸鑽績
祐	祆社祀祕祠祖祝祚祥祁右若神祉祇祈視祺祿禎福禍禧禪禳惹
局	侷跼巨叵拒炬苣鉅凹凸加矩伽咖協架茄迦痂荔區渠距闢熙
蛐	蟲蚶蛔蟲蛙蛀蛄蛆蚱蚯蚪蚌蚊虻蟆蟒蛟蛭蛛蛞蛾蚵虹螻蠅蚣蝶蝠蟠蟻
傖	儉蒼飧艙食滄儈搶倫傷倉嗆槍白侮偷瘡鎗佺伶愴
圈	捲倦蜷踡卷畔券勝胖姅拌伴扼騰半已己絆軛桅脆範苑呃滕範賸
嗶	蹕畢哩咽呷卅喃喟嗯嘿嘩喂嘆噗啤哺哂哄咩味咕呻吱吐噹幸辛口當單
連	漣軸陣渾軏鏈運範軌軍庫揮葷暈鰱轟褲輦輩載蓮軋車軟囀暉軒
紫	細訾繫累紮糸柴此濰貲羅縲絮蘊緊素辮索紊絲繁些系喲
楝	煉揀鍊練闌棟諫欄柬林瀾攔爛蘭籣斕森棵柙材村梱東
捍	悍桿焊銲稈趕揚提旱捏撮幹揭幹岸捨袒怛坦但桿肝汗奸竿旦
啤	碑埤婢俾脾裨陴睥痺箄牌卑鼙顰咋吻吒叭千唾哦咱呼聽彫呈箠
櫂	曜濯擢耀躍穋褶膠摺嘐僇翟謬繆廖寥榻羿翰煽遢塌嗡瀚栩翼翠蓊習翌
呷	押柙胛鉀甲匣呻狎咽哩曼閘賣嘍喟譯嗶擇澤濁獨曙燭躅鐸鐲副申薯
砍	歌磴吹矽磊欲證歐石炊玖坎次欽碓砭砂研砧砝破砠砟畝欣硝款欺碌確
晅	桓垣宣暄旦渣喳洹渲喧暘量萱晤袒怛坦但旺百疸查昊旱奭
室	屋窒輊耋姪至倒絰蛭致到喔握渥緻臻宇定家寅士蛙齷
律	待御徠很徵徜行彼徇徘彷徐津循徉從徊徒彿聿往徙
釆	乎悉呼米釉竊屎狄咪迷蟋牀宋呆採朵杲柔粵森林釋
閨	門閏閑間閒悶問閃閂奎闔聞閘閔開閎閉畦桂掛娃哇佳
耗	橇撬尾氈毛耄麾氅耙娓毯耒髦耕耜毬牝耦耘毽
堊	惡亞啞氬壯蜇莊片慄要塹串班珪牘患粟型墜圭介王工慄溧腰遷圳融
草	章昔早覃瘴漳樟芭蕈障獐幛璋萌莫蟑厝卓借措惜錯
沸	拂泱洩洌氟沈費涮鬥事測津佛油沖淵彿紼怫弗喇剌串
讒	詣詭儳訶攙誘諂諧誤譏饞診詻證諺訟訖設訊譫訛諄毚諷譎纔詰誡讚巉
炸	少妒淚遍作窄褊偏煽僱戶笮砟蚱詐編肩捩乍邀唳咋祚昨炒怎篇柞
奇	軻訶坷寄琦苛何錡騎河呵阿柯蚵可倚崎畸綺椅犄
模	樺慕募橫漠墓昔惜膜糢蟆措摹藉莫摸錯檬借權寞幕冪暮謨楛槽
褸	樓髏屢螻數簍僂要順呻坤摟川婁縷屨砷嘍鏤申伸裸袖蔞裡神
層	增憎僧曾繒贈匹鹿醋鈿曹西槽遭嘈漕曬魯醫晶酋酉屍鋰糟鉀迺哂
蚊	蟲蚪虻蛀蛟蟲蚌蚶蛄蛆蚱蚯蛙蛔蛐蟀蟑蠔蚵虹蛭蛛蛞蛾蠅蚣螃蟆蚓蜘
詛	詞訏訴訶訥訢評詢誧訣許託記詳誼詐誣討詁計課狙訊沮訐訌註訕誚諼詬訑咀
抵	氐邸柢舐泜抑昏砥胝拭婚祇祗牴低紙衹詆氏底
詠	訏訶訥脈詢誧訣許託永泳記詳詐誰誠訟討訃詁計詛課訂訊試訐諮註訕誚誡訑
恭	共基益巷異烘拱洪哄供斯巽芯鬨寒塞搴寨暴並港
盔	盃盅益盍盎盈盟扁盂監孟盡皿冊柵姍盛盜盥盪珊
讚	鑽臢瓚諉誥詐託譜謐謠諧謂談請諂諍誼誌誡誘詰詼詣詻詫詔詆設訟訖
魏	塊蒐魔槐愧逶魁巍機矮瑰萎魘痿魂嘰委魄傀幾餽倭醜鬼
悌	娣涕梯銻弟剃阡第悅陴阪陞郝陲降隍忪弔悚郊怕忸愧防引陷陀阬憎窿
帷	離巾惟推堆唯淮椎進睢錐霍準雄碓稚雉雊帖帕雕雖雜雞難隹崔瞿籬
珞	咯烙格胳略洛恪路鉻絡詻賂酪骼貉駱客閣咚各
戎	庫麻廟朮求甫戈十戒弁牀臺莆怵匍述捕浦埔圃哺梂脯絨補賊鋪魅
官	咕十宋吊古菅居倌估刮卉耜唐姑苦管枯穴琯綰固宮沽胡安舌寅棺館宙
眯	米繼斷迷
耳	聊攝取揖聶最鋸娶楫居聳聆耶聰聘陬弭倨餌聯聒懾椰職耽洱戢聞恥耿囁茸
楷	媲庇混崑焜屁琵篦諧枇階比妣仳皆偕揩陛柏棍琨毚錕批毗餛鹿沘罷昆
怵	述朮術匍麻勾勺摩慷慵怡嘛憾戎穴勻葡麼磨糜魔
敉	枚敘教敦米敝敕畋敞料故敖啟敔粒粗粕籽敢散牧玫改敬粳收敵數矢疾
璃	漓魑瓖琉斑琥玷玟璋璿玨璀璨瑁琛玥班瓏王瑤璟璩璦瑞琿瑛瑜珪瓚珊
遼	燎暸潦撩嘹僚繚療寮瞭逖剎顯逛迦文選暹遭遮遏遑逵這逢銀源逍送退
美	姜羔恙義羲善羹對鎂羨奘艾苒爻窯糕膳尖羌漾樣儀繕曦犧鱔
釁	爨奧向鉅制真廣分筒襖鎮燠澳懊噢滇慎填狙睿芬氛忿岔闐苣召具兵西
酈	鬱邱邢鄴鄭鄧鄱鄘鄞鄙鄒鄗鄂郵郾部都郡郢郎郃郊耶邵邸祁邪邦那
燠	澳懊噢襖奧煥燃少燻筋省向熄渙換喚烽烙炸炒制瘓爨
迷	糜粟磷繼粥咪屎籽遴謎燐斷粱瞇米乎粒眯粕璘憐逍料敉掬氣粗
姨	咦胰仇夷九痍軌旭究友丸嫉弩疚姻妞妖好如汍奴鳩為女姦染
螻	蟲褸鏤樓摟嘍縷簍屢髏蛔蛐虻蟲蝨蛙蛀蚶蛆蚱蚯蛄蚌蚪蚜蚊虹蚓蠱
曠	餞飴曄甘鍍壙摭蔗戒獷渡拚曝暗擴蚶弁礦鉗械戡柑餅遮踱暘曬誡坩廣
纓	瓔櫻嚶嬰綏縲絲綵綬緲罌績緩絃組綱纜繒繃縴縊縐締絹結絨紛紇絀網
懲	待很徵律悠德彼徇怒狀恩證役癥歪循徉徊慇徒兜微屜焉忝往徨黴忽息懇症正
梧	違葦寤圍齬桓桔語吾悟鼯五捂韋檢晤圄極伍格敔偉唔
皈	板返扳鈑叛阪舨販飯魄洛恪咯烙胳格咚略逢鉻客疼閣
駙	驗馱馳馬馴駐駟駛駒駢馭駁咐駭騙駝駱駿騎騷騵騾驍驟驅
癒	瘉愈痊俞偷疙褕瑜榆逾渝愉喻輸蝓瘡崙疹諭倫
哲	斬斧拆祈斫聽晰昕淅浙嘶斤沂析逝掀蜇圻所芹斯誓折近欣匠撕
椒	督木寂迷枋櫬樸梳菽鳥烏梓林樟叔淑榜柱楨杭柿槨槁核校逍檀棹槌枓
胝	柢泜抵低牴祗砥底詆氐婚衹祇舐紙氏昏邸腔拭胳股腺脈肌舀些冗懸
親	櫬襯覽欖雜相攬湘霜箱廂纜想孀目出盹拙咄楣督苜茁冒盲屈
瓦	瓶瓷甄甌甍甕互夕歹弘沍妤外汐舛多名矽畏辱
岡	罔剛膜血腆柵茁胼厥鋼皿逆闕溯綱崗冊朕盅朔姍
儡	壘佃疊偎僵個侮俚每儈僧偶人彊儂儉疆僮鰓傷傯儸腮傖儻喟渭偷晦梅
郾	都郡耶邵那婀部郢鄙鄘鄭鄱郊郎鬱郃邸邱鄴祁邢邪邦
崁	漱嗽嵌簌玖嶝撳峙嶔欽灸羨闕久疚炊坎掀吹茨柩歡
摑	幗蟈國惑捆域或撼擡拇押畎描感臺錮涸個搪拓拈拘抽找扣籲打叮撐播
梢	傑捎哨膛趙俏擋檔銷屑蔽棠撇鞘悄稍鐺廠硝睄鏜襠峭肖尚宵杪逍消誚噹帩
殫	彈 憚  
涊	濫認忍尷檻襤鑑泥添艦藍籃淚渥沼濯洱氾弋監
毗	枇沘批妣仳紕昆庇屁比能砌牝叱化皁尼它邶訛傾靴雌齜死此北指沱怩
鯊	漁鱉鱟娑裟魚魯嚕櫓沙莎燻鰍淡蒸鯉鮪鮭鯧鰓烙
通	誦育桶湧俑遴舞遐傭外逸涌蛹弘名邂舛甬迅恿捅栘夕用痛侈逍汐多
月	孚爭育脊冉且背肓冗同目丹肋肝妥皿岡炙朋胃用肖受膊脯肚內刖採冊巾有肌肘明周
氅	瞥彆弊幣斃鱉尾耄麾髦橇撬耗毛氈廠蔽撇敞敝
鬣	獵邋臘蠟髻鬢鬃髯髡髮髦鬚鬍鬆髭錙緇淄繅輜巡
啼	吊怖錦嚨常謗締帝棉磅瞞啻滯佈鈽蒂蹄蹣滿砸諦
詼	詣詩詔請諾碳譙謀諂談諉謂誤諍誥認詻誼訟灰訖設詮炭試恢詰謨誇誡詫諒諜誌
蛉	伶鈴泠拎冷蟲聆羚蛤蝓齡苓蚯零蚣蜘蟲蜈蜿蜢蟒螺蟀蠔蚓
營	呂撈櫚勞莒鋁榮熒螢侶瑩嘮鶯縈尚癆宮閭塋炯犖嶸
懷	壞還懍邏遝環澴愣悴惇寰懵儸囉憧慢鑼遇悽怫甽忙羅罹蘿蓑籮罟
癱	奮隹懼雌雁難歎艱僱暹罹匯蕉雄奪攤催坐雉濰藺嘆羅座璀漢灘摧籬銼 
欖	攬纜覽櫬襯親楣相檻橇枕杞湘箱廂櫻槓睬掘崛倔楨盹櫃睏框柩目出屈
陀	庇它陣院跎屁枇駝佗蛇妣仳鴕沱舵批能毗沘昆
熄	媳息溴嗅臢鑽虎少燜焜燻瓚燠侃沉讚炸炒臭煌琥烽唬烙兄鼻贊忌
預	澦頂頌煩予頑頓頊頒須項頗領碩頡頜頃頰頻頷頭頤顆類顯
肚	周角月塑塋朋惆啁週土臺竈杜吐仕裯榷檯圭薹
燎	嘹撩暸尖熔燴隙潦瞭燦顯煜煙燜了僚鐐烯煬煌療煮炎燻剎寮熾繚遼爆燃燠
硬	埂鞭砍斫砠碓研哽硎粳砟砷砝砰矽碩硝砂礪砧便更歌磊甦梗石
刺	刖制削刷棘棗剌利刪劃釗刈剁剎則判剛刑刊剩劑
斧	芹昕析近折沂圻聽匠斯所斫祈斬斤掀新訢釜廝父欣浙淅逝晰撕嘶
韆	韃鞭鞦靴靶遷靼革鞠鞘鞋鞅勒韁鞣鞍韉緙霸腰溧慄鞏賈粟慄要
扯	址祉企芷趾啃武止肯歧歷撲歲步正抆抖扛拉拄拈怔涉擠賦逃焉症
湖	咕牯葫古涓居瑚估鈷沛潸姑涸潮苦鬍枯汁固糊沽胡做蝴
克	兢剋兄侃況兌古兗宮祝嗅悅脫聖銳鴣固估咕姑居沽枯胡苦息舐稅鈷舔
卉	奔寞寒賁塞寨搴十廿弁穴安宋戒寬垂它字宇守宅宏弄牢宜宙宥宰宵賽
件	佚俄牛牟牢任作伯仟牡傀湃入牝牠侏牧牯牲俾跌旌失我生毛看犁
泯	湣抿岷氓眠民況澠涓愍沁汝泜浥澡呶泌河沽泥沾洩泡活派洶洩洵沐沌
枸	拘佝鉤苟狗杓夠駒齣句雊包林杏枯炮胞泡抱咆杜袍樸札鉋木苞庖森煦
虧	圬污誇聘娉騁佞巧朽兮垮仁鍔跨愕胯惟萼粵雩些三二
掉	綽扯擠抆撲拄卓罩抗拈草掠接悼拉摘章抖早擅棹摔桌撢
爰	湲援媛煖暖鍰緩諼天助塚勗同且胴肝鋤昊胚肛脰
哎	艾嘩嚥噶諾囌哄咩豆偌喫喚嗟嘈噢囈若嘉嘻謨朕送嘆噗茄匿
嫣	焉正歪政怔止症徵址扯遣武肯芷企証娠姪祉歧妍奸啃逃姚步盡整
勛	勣償助劬肋叻員脅觔劫幼咖賀勇另勒勘動勤賄勉勃勳劾劻勵功勸損隕
忝	夭吞添舔恩笑妖沃喬怒奏祆契悠慇懲老揍湊忠芯思怎志息愍嗯僑嬌橋
候	假攸仲侵夜健倏條脩又修刻暇煆瑕絛遐劂劍蝦鯈沒寢
瘍	暘煬腸楊揚場鍚暢陽疸颺豕傷查殤豚逐觴暮晝豢痕疤春旦奭刀湯袒昭
橾	操樞闆櫺噪嶇嫗嘔奩森權保軀梱區品杏燥澡譟楫枴林槌淋驅痳呆
餘	飭餞饅飴饑塗餌飲徐餵除飪饒蝕餡飼途餅飾餽餒斜敘飩飢館
福	祠富禧擋祈檔紜蝠社幅禮祀禍禪祐禱鐺祉逼祗輻祝襠副祖噹禳神
怫	拂沸佛彿紼弗氟費事剌喇串鬥怏忱惻患惴慄懷介夢
蠕	糯燸濡懦孺嚅儒蟲需蠣蝓蝠虹蝸蜻蛤蛭蚵蛆蚜蟲
輒	轟輯軋軔輾車軒軏軛聶輔軸軟軌輓較輊輥軻軼軾輻轄轉範
客	咯閣恪洛格烙胳略鉻珞絡賂路骼各詻貉酪駱疼咚板返扳逢鈑
惆	啁週凋碉稠綢蜩調鯛恫周惘裯肚雕彫膨吉胴頡懼塋背
妒	淚遍作窄廬褊爐偏僱戶妨妖笮砟蚱詐房炸肩編捩乍驢邀唳妊咋祚昨奶怎篇柞
丐	沔鈣下亡妄忙忘杗肓芒卡斥玄妃朽盲孩虻茫荒
餐	飧餮癢饗饕食養瘡良狼浪娘饜琅蒼璨燦傖倉夜鎗槍滄搶愴嗆假
茁	屈出拙咄絀黜倔掘崛微祟窟逆朔岡苗苜芯芭昔莧艾蕨廿
溫	侖遍醞褊氳媼偏鎰淪嗑塭盜檻錳慍跚濫泅襤盧溢瘟鑑溘 
迪	軸笛岫胄聘冑婁鈾妯娉柚宙油由申曳袖廟逮抽釉郵鼬
桀	傑舜舛憐燐遴璘磷舞夕轔鱗耒弘牀多名摯栘汐外鄰麩瞬麟
茂	戊苔減喊滅芝莆薦威鹹莽歲戌戍成槭戚牟蔗蔑
囪	窗傯總因爻咽姻恩胭茵惱腦囿男餚痍嗯媲傻瑙蔥篦
夥	栘移侈爹多令銘酩矽汐麥茗宛夕夢舞苑橘夠杼舛外果名
穌	蘇鰍繙囌鮮禾酥潘播墦逶倭鍬揪愀啾蕃審痿萎秦
衛	銜衙衍衝衡街術衢桁行徠彼徵徹微徘御徜很徊徇徉律往徵彿徑徐待
札	杵杯杓木秈森杷相杞扎枇紮樸仙山乩枝汕林材柱枉杖桿杪村枕枚杜兒枓
偭	湎緬麵面靨靦儈會僵倆便佰侮檜燴膾何伍偷倫佺儉仁劊毒命餘每企全
蜴	錫惕蟲賜踢蠍蟲蝶蝙蝗螟蛇蟑蟋蟆蚣蟠蚱易蜿蜻蜢蜷蜈蜂蝠蝸蝓蛤螃
輳	湊揍轟轎車奏轄轅軌軋輻輯輸輪輜輟輾輕轍轉軾轔軛輓較軸軼軟軒軔
蜓	蜢蛀蟲蝦霆梃蛹蟾蝌蜂挺蚱庭蛙蜊蚊廷蚓蜥螂蜈蜘艇
粟	慄要賈覆腰溧慄遷價粱氣屎糜粥袖迷咪麋米憐璘燐遴磷轔鱗
仙	化催人山花仕札什僕夥伐休仲扎汕佃兒仳乞嶽
鉼	迸胼拼姘併並井屏耕阱購鉗餅駢遘構溝搆媾錯錨
恩	嗯茵忝胭姻咽因怒思氤悠男老囿忠芯志愍慇懲更囪添傯
幛	漳獐障幢樟璋蟑瘴章臆幟暗億憶噫帖境鏡黯霎草音
載	轟庫軍輦連陣褲範車輩軋轉囀惠栽哉蓮葷暈運暉軸漣渾揮軟軏軒軌鏈
柝	拆坼訴斥析梔柏柞材槐淅晰下株板才林樸新柢杉彬蜥
掏	淘啕陶搖萄榣遙瑤缶謠缽缺掬缸罈摔佗罐罄罌
妗	今貪念吟
匕	比旨化切叱它尼仳妣屁庇批沘昆枇毗北此牝佗皁呢妮怩沱花指脂能
鐃	燒橈曉澆撓嬈僥蹺蟯繞饒驍堯珪鑄圭翹基鏗鐵贖畦桂掛娃哇卦佳窪奎
矩	短荔拒啟疾巨玫矢伽敞散敖雉矣畋矮故苣牧櫃鉅敕仃敢敝敉距知枚炬協
凍	冽凜準柙棟迂勻馮東煉柬圩凝鈞棵揀次昀於臧籲冶凋茨均冷楝陳冰凌
寤	敔戕壯蔣妝梧鏘將狀吾寢悟捂寐晤莊衙牆圄唔
跎	佗沱陀足跆跺蛇舵踐踏踩蹂鴕蹈蹦趴跪踢踡駝踱踹蹉蹣蹟躇蹶蹺躁躡
刈	劃刖剎釗刊刑判利刪別刺制削剌剩劑列刎刨刷到刮剁則剖剛副劃
愧	魏塊匆蒐魔恬戍麼槐魅魁怕必瑰恤性魘魂魄傀幾餽醜鬼刃
線	終絡淺細繙絢錢絹絳踐繒絕紹糸縵殘絨結紗紛編綿腺繳總縲絃綵綬織賤紙綏綞絲箋
斃	屍鱉彆氅瞥弊幣死庇洌咧例夙仳昆屁紕能毗枇批沘妣
箠	錘捶唾綞睡陲垂郵箄卑箕痺笙笮笑箝裨脾婢埤啤俾
縫	終絡統綽絳蓬綾緲緞峯糸紐篷紗絨蜂紋紕締鋒縞絞繳級縲絃紡絆織逢綁絲縴
訟	誡試詩詼詰誌認談謂譜識訖詔詫詣詮誥誨誼諒請諉諂諍謀諜諾諳謨譏
闕	闋嶔閥厥崁羨嵌茨開閃門闊簌闢閨聞閘閔閏閑間閒閎悶閉問閂關閻閤
鐳	擂蕾雷電燸濡懦嚅儒蠕糯灞孺擾壩錨優鏢鎘錙釘需
琉	梳流硫疏毓堉璃斑琥玷玟璋璀璿瓖玨班瑁璨王
罌	嬰嚶瓔櫻纓罄缶遙榣搖萄鋇瑤鸚缽淘陶掏啕缺缸
樵	憔榫瞧礁椎蕉譙醮雜稚焦鐫錐進淮推惟堆唯隹崔
聲	罄磬馨聱聶聞茸疫芟毀殼弭股投聳爺燬穀殿般殷洱段
採	踩探捐揉揮榮掙搖援搏捆睬撚操綵採肘菜膝授彩
抒	妤杼序野舒予澦預豫多侈栘墅扭歿移夥矛爹舛扔挽投拎矜捻夕了茅
泖	柳鉚聊茆卯卿溜留榴遛瘤迎抑仰御劉貿籀唧啣腳孵餾昂節霤
答	言儉籥搭洽撿閤 哈蛤給拾簽臉檢八合塔恰筒鑰磊石
徙	往彷徒律徵徠很徊徇徉彿徬徘徹徜循彼得從徐徨行御微衍銜
喝	褐藹曷竭謁歇蠍揭靄吧噫噶唱羯暍惕碣渴邑錫愒遏葛
瀨	懶獺癩籟漱賴瀏嫩嗽喇速悚初淞辣沼汾束簌湘淋淅剌敕沐
厄	卮危呃扼己已氾妃杞配卷桅脆軛忌犯紀記跪範凹改詭
暹	進摧催遏隹璀曜僱懼雌匯藺籬遢錐離雜椎推惟淮堆唯濰攤灘罹焦集崔
累	騾細鏍繫摞漯紮糸嫘螺濰羅縲綑絮素索紫紊絲繁系喲
圍	偉葦違幃緯闈韓韋拿圄韌笨苯韜本缽吾困晤梧唔悟捂衛諱
奪	痔奮侍等雉時峙恃持集寺特對雞封待蕉舊崔符府傳詩椎進錐雄堆唯惟
徘	誹御徵徹行律菲彷匪罪悲非徐排靡俳輩徊徒屝彿微痱啡銜往霏街衍腓扉徙
妁	杓灼釣芍的約她豹酌勾勺怡喲民氏忘勻如均昀鈞婚女姦
蟠	蝌蜊蟲蟋潘播幡墦繙蝙蝗蛾蛛蛞蚱蟲螺蝶蝠蜂蛇蚣蛔蛐蕃審
翠	翌翼翟習羿瘁萃遢翁榻碎醉塌淬濯擢悴櫂曜蓊廖寥粹煽摺嘐膠誶嗡僇
彝	關糸繕縲縊縑緙絲絃縈紫絮紮累素系蘊練嫘綱嗉祥紲細紂
嘮	撈癆勞嶸啖榮熒塋肋咖犖噢燃喚叻瑩縈螢營筋勇另
阱	隘弔併拼姘迸胼隊鉼阡阻限陌耕陳陲並井屏阪防阿陂陣陡陝陴隅餅駢
幔	鏝饅帷慢幌幅縵幃漫帖帕幛幟幢帽鰻巾曼幡蔓
濟	霽涉齋儕擠涼薺沾臍漓注齊泣流滷劑淑汶沆滾汴涪滴躋
召	詔汾吩炤扮邵貂切刀韶紹沼岔昭枴券忿迢叨份照超拐初芬刃招
閥	閃閤門筏闕閑間閒閎悶問閂藺闊閡閨閩聞閘閔閏開閉欠闋闔關們伐
野	杼抒妤序舒澦予墅預豫裡黑墨多歿栘夥侈理狸浬娌埋哩裡俚鋰移喱嘿
挈	招券解潔尾刀牛娓拐扮召分箝屘拒初叨懈邂拳奉牢牟忿芬岔我失生毛
礴	搏博傅薄縛
稜	綾稷陵凌菱傻鉻後鈑鋒販板瀲反廈憂賂格秒穡穫皈返扳蔆各冬
停	婷偯亭信伉佔搞槁嚎壕濠鎬僕偷犒稿高嵩蒿豪篙
胖	滕勝賸畔拌姅伴謄騰半炙絆拳倦捲圈胱蜷踡判卷券眷
凜	懍稟冶凌凍迴冰冷準次凋馮凝啾冽臧勻稿諉醇壇擅澶檀逶翠茨
箔	泊湟泉白篁啪簿腺楷鉑揩偕柏迫拍怕伯笆皋皆皇帛皁凰線魄諧階粕舶
謂	請諍譎課諼談誼謠誌誡詰詼譯訟調諦謀諾諭諳諜諒諉諂論講謐認誥誨
秀	利香秋仍誘程秈禾穢禿繡秒番悸移透氖季莠乃委稻奶秩扔祕和私鏽孕
冑	胄由胃宙笛婁柚迪妯岫抽油袖鈾曳申喟渭賈軸裡釉裸
催	隹懼雌僱暹匯唯仙攤雉坐仕睢淮瞧堆癱濰惟椎雛璀錐攜崔灘推摧瞿進
山	鼓岫出尢扎技仙乙目疝巖己兀枝屯肢汕支已巳巴炭峭崔七崩兇匕札歧岐兒
拈	沾佔撲佔店帖玷砧站掠拉拄抖抆乩貼擠點搞攘
誼	組請訏咀訥謀誧詼許談且謂諍訟訃詁詮計詛試訊訂訐訕詰阻諼誚誡詫宜誌
厥	仄厲蕨佻劂橛厝鱖茁催獗鋼岡塑一逆闕兆屹崔三溯綱崗岑二蹶妍朔
妯	娉岫抽油柚迪袖鈾鼬由宙笛軸釉冑胄婁姊聘曳申
附	褥腐榭駙符奪陬險弔傅俯陡咐除傳陝陰隧滌侍府付陳
屈	絀窟出厄咄屁掘崛倔凹杞茁忌黜拙己尼已妃笨微氾屆祟
銀	退根恨垠艮痕眼限狠跟艱很齦腿褪堰偃良銲宴
特	待詩狩恃寺褥痔撙榭持牲牡符奪搏耨犢牛峙傳等犧樽遵對侍牠時封 
成	妒作戍戶笮蚱炸誠肩蝙茂乍城乃牟盛咋方祚昨戊戌怎柞
藻	度噪藩蔆燥範蒲菠茫譟躁蒞澡蕩葆莎操薄褓萍呆落
薰	燻醺蕉呈荏壬衽妊任窖造浩廷蕪燕蒸蘸聖望羔告皓飪
曳	拽洩由思抽油岫宙妯柚胄冑迪笛袖鈾申囤腮裡裸
內	俎訥俏月媼榷婿鈉侑傭陋胥塭溫佾盜憊肉俘跚慍炳病納丙吶柄確人俱
租	粗稱稻穩稠禾秋秈稍狙沮姐咀和私秤秣秧祕祖砠科俎阻稚稞且疽香番
極	杯槓本仁柢查吸梧桓及朽汲亟柯標枰級圾枉桿三丞拯柄
劃	剷副釗剌刷到刑劃刖列刊刈劂劍劊剽劑割剴剩剖剛剝剎剃削則刮制剁
琥	唬號璩虎琉璃瓚斑墟玷玨玟琨璋璿瓖班瑁珪遞璀褫侃璨沉現瑰珀瓏王
住	倍準蛀儕偵依企拄禽注維主佔仕僕堆位柱僮伉往駐推註仿偯
遑	煌湟惶隍徨蝗韹篁凰皇迫逛珀旺斑潤班腺嗥銓棉錦栓拴佺鉑柏玨泊拍
芙	夫扶伕鈇替羋羊趺失麩攆庠差輦窺菁佯洋咩烊羚推
謀	請詩諾議謙講諶某煤詼談諉謂諍譟詳諳語誼訟謊詮護課試媒詰謨誡譜譁諜誌
靈	霞霽霜零掃雩雨霎霪露霆霰霄櫺雲霹靂霓霑尋雪雯霏黴霖震霍
果	困顆彙木田捆棵稞睏巢夥課猓裸窠梱裹尊踝髁
針	鎔釣鉀金鍵十鉑鏈鎮錢鈉釦鈷鐵鈇釙鈾鉅鈿欽鉍銀汁鉗銨鈍銅鈔銬鉤什釘鈕錠
攸	脩倏修條絛鯈倣做傚傲嫩俟候收仲敕悠擻族矢
坍	丹冉玥臍彤堝再苒壺垃舟雨土圭壹坊址坎壞地圯圩坩坼帖肪垠垓珊舢
奩	嫗嘔嶇樞軀驅區闆操橾櫺痂品歐加架癖茄毆噪甌迦咖伽鷗
鯧	鰻鰭鰓鯽魯鯨鯖鯛鯉鮪鮭鰥鱔鱖娼唱倡鮫鮑魷鱷鰍晶
險	隄陪儉際隔僉陋洽弔籤撿閤阿瞼阮除陌驗哈簽附拾蛤陝陰臉鹼檢殮恰阻答
外	夕舛多名汐侈栘弘移夥爹矽飧銘歹丸凡令宛茗麥夤
憶	噫億臆憧意暗樟漳璋幛境獐障鏡黯瘴音諳蟑竭章
滅	減槭喊威鹹碳戌戚禦茂滲淙戊不禁祭票祟宗奈
原	仄迫鉑願鳳箔皋隙皁怕鳥習帛白騵柏三笆皇示二乒拍泊泉伯源旨珀
祇	祗紙衹底祆祚舐胝柢泜抵婚低祈牴砥氏昏氐祕祝社詆
蛞	蟲蛛蛄蛾蚱蛔蚌蚪颳活括恬蟠蝴蝌蟲蛙蛐聒蛀蚶蚵蛆蚯蚊虻蠅蜂蝗蝙
從	待御徠很徵徜行後徹律復德徬徇彷蹤役徐樅徉徊徒彿微得往徨衆縱叢徑徙
捅	甬通痛桶誦俑涌
薹	檯臺薔蒿蓋苒啁肚塑吉葫周碉桔拮藝髻菱菜善苔圭園黠壕嬉嘻遠僖結
咫	尺只呎保家谷促侶敖俗峪侃浴吩傢嫁裕僎稼褓興容堡僱葆肇熬聱贅鼇
淇	棋箕琪祺其期麒簸湛欺旗洪酒洋滇甚具芸堪俱戡漢淙港湮溢沅濃污濛
侈	傑夢夠令泠俑舞拎飧外麥名宛移哆舛矽酩茗夥鈴苓栘夕爹苑汐伶多銘
燭	濁鐲獨觸躅髑蜀歜繹驛曙澤擇釋鐸鉀柙胛狎押呷賣閘曼匣
兩	倆魎輛帷雨巾師佩篩霍匝吊珮佈雪雯獅漏際霄瘺霖霽
止	涉扯肯企址逃遣啃祉趾賦步焉芷怔恥歧歲武症歷正
吶	咻咿哨喻訥榷唯鈉傭呎吟噙咐嗆吃啣哈肉吐瘸叭炳唸納內吹丙柄確咀
訑	詢諜訐討訕訊託訏記計訣訥許訂訃註詁詛詐詳誅誚課誰諫
磬	罄聲馨磐磊碧巖疫芟毀殼股投穀燬殿設般殷段拓司
蹼	跤撲璞趴樸躪躑僕蹕踫蹲跚躇噗跌蹉蹣趺距踝足跟躋 
終	絡絳咚綾疼烙縲絃烽線繙絲逢綿編駱總縴級紙返縫糸鼕
嫂	搜叟瘦艘餿媳遝婚妊妖妒颼臼滔嬌潟鰥婢娥姓呶裒曼舀
墨	黑點勳焦鯉竈黠默理浬嘿黜壎埋壘畦黛俚羔量黷娌野黔鋰黝喱裡哩童
袂	決抉快缺訣鴃被筷裸兒川中衽袖陳初裡褚襟史忠樊
崴	威戌鹹喊減滅箴簪戊眸戚畏茂巖嶄猥峻辱竽竿耑岌牟卮兮炭底竺簑表
甜	謀嵌甘恬闊煤話舐刮括疳聒虛舔蛞蚶鉗活柑媒酣坩舌
罄	聲磬馨罌缶毀疫芟瑤殼陶股投萄燬罈穀遙榣骰殿搖缽淘掏啕缺般殷缸
撫	憮嫵蕪無撚摭掄拴拾拖推扶夫舞庶撿擒搶攆捨捻拎挫揪
銓	佺栓拴痊荃詮鑰全斑班鈐玨王鈴遑瑜煌潤隍湟惶鎗玲珍錐框筐谷
吒	託託宅叭咋呈印聽呼咱哦啤剩呱唾嗚鳴咯詫噢啾呂兄亳筍
振	賑湛辰捺農圬拓堪佞脤甚儂打抨辱扛脣巧宸蜃韭捂娠三戡濃晨噥污震
奄	笛岫刈希胄冑爻疝迪妯鈾柚庵油遷由菴袖醃淹鵪俺抽掩布宙
砟	詐咋磊硃斫碑唳石砂炸柞昨妒作砥砭砧砝破砠祚研砍蚱矽硝硯碓歌碼
徐	待御徠很行律復徇塗荼徉除從徊徒得途徨往餘徑斜敘
傢	嫁稼家佇儐倌佗什傷僱倥錠喧棕渲傳暄梡淙儉嬪濱檳臏值估仗做傲尺
糙	粒料粹造糊槌粕米瞇糖粗敉籽糕粉杭告謎糠鵠粳迷糟糝糢糧糉精浩糞
魘	壓饜靨厭蒐幾魄瑰魔魂槐愧塊傀鬼餽醜魅魁
存	薦字孝孚李孛季學子好囝仔孕孱刈籽猛屘蜢錳
唳	妒淚遍褊偏僱笮砟詐吠炸溴捩邀嗅戾咋牖昨柞
嗝	哥歌鬲隔融
諄	諒讓誶訃謎諳識淳惇醇諦詰譟詨註謫訪譴誼談請諉諂諍誌語認誡誤誥
咳	氦孩劾骸嘀擁賅唬垓趴雍亥嚎閡臃駭叭該壅吭嗚核咬喙亡嚷刻
岸	炭祟豈崖三二幹竺悍捍桿焊銲旱竿桿肝奸汗仁稈幹趕
佇	貯薴傢儐汽什佗丁行倌倥倚何叮打汀仃釘侵估盯仗軻例午士氨
伶	令零泠儉齡聆拎蛉羚吟玲儈倫鄰傖侮偷鈴苓領侈憐鈐冷岑嶺佺今
污	湛垮涯仁圬佞聘萼朽涇娉沅挎虧巧胯愕三兮濃二溼誇騁鍔跨
柳	泖鉚聊茆卯卿榴留溜遛瘤迎抑御仰劉貿籀唧啣腳孵餾昂節霤
混	焜棍錕琨餛崑媲鹿罷篦昆沘皆偕揩陛楷比湯階琵
貓	菌貍霾墾豺貂刀貊苗瞄簧描豹解貉懇邁芬錨襪屜
拼	耕井構拱姘並迸遘摒鉼措胼併媾描阱搆駢餅屏溝
睽	瞪揆葵闋癸嶝澄燈橙眨瞻瞄睛睬瞧磴瞼證蹬睢盯目瞿
戍	戊鬼幾蔑篾麼魂嘰機茂傀愧塊槐蒐璣磯餽戌成刃牟笞箋
撰	潠僎選巽巷拱圯損起鬨祀撕共巳戴糞捐撲烘洪抱供扣搴冀基異恭
鳶	鷹鴦鴛鳴鳩鴣鴨鵑鵝鵲鷓鷥鴆鴒鴿鵠鶴鷺鳥鴉鵡鵪鶉鷂鷗鸛
懾	攝囁躡聶鑷輒弭聾聞茸餌恥趣椰陬耳聱爺聰楫揖聒耿耶取聲聳
殲	懺讖籤纖殮殤殘殆殯列韭歹殖殉殊殃歿死洌咧例屍夙
她	地弛池他迆也牠妁訑馳拖迤忖快悚民氏忘柒如好妹施婚女姦
析	斬斧拆祈訢斫聽晰哲昕新淅浙斤沂掀圻所芹斯折近匠
帟	亦弈奕簾跡帝帛帑吊布幣啻帥匝巾鈽鬧席希蒂赤帖帕怖帷佈啼滿錦
杪	炒沙抄妙吵鈔眇砂傑紗梢秒少省劣莎林炸秋渺焚
乞	疙吃屹迄乙紇訖仔你函仍仙侯挖夜人伋侈俑健涵傑像
浮	孚淫渾淨子湲深荸脖孛悖悸溪滔渤遊厚俘學沉享
粗	租米祖沮姐咀粒粕組砠料敉籽粳俎狙阻且疽宜
爆	異焜暴拱爛普鯧縵煜供曝燜哄糞瀑鑤焊共煬緹烘魯鰻恭熾基洪
殉	例殆咧洵詢絢歿洌徇列殃殘殤夙殲筍殯歹殮殊殖屍死荀
越	趙趨堤卦趣踐趁起垓垃趟跆陡跋代伏徒壤赴琉赳超踱走伐跟堉趕壕進
杵	午枚椎許什榫榷榣缶林估仗栓樵來枝枓杜杖桿枯樸札梅榆槍漆膝檢檜
蒐	鬼槐愧塊傀幾瑰魄魔魘麼魂魏萸茱芹戍刃魁魅醜餽
琦	犄椅畸崎倚錡綺騎寄奇玨荷坷斑婀啊可柯河呵何班苛
悵	張倀脹帳萇賬長漲虐刁叼怩慨畏悽恍恨恆性忙偎愕喂煨佞伺懾愜表心
鄉	榔嚮響瑯廊饗螂參箋晉朗郎魏雍刻濺州劃川滋兜鬼幽慈巍麼
軌	轟軋軟車軒軏軻軸較軔軼輊輔輓輥輛軛軾輟輻輯輸輳輾輒
頒	頃頻頌煩須頤頓頊碩頂頡顆顏顯預頑項頗領頫頜頰頷頭頹穎額題願顛
勻	釣慷怡準凍杓妁惦慵勺鈞灼憾次筠昀芍勾贓怵冶凋茨均匍冰藏
市	匝簾帷吊央席啼肯怖希帖帕迪帛帝柿帥佈啻庸鈽鬧巾逮蒂止盅滿布
款	炊歌砍玖坎次欺欽畝欣吹燈飲欲歇軟歉歐歎歟歡疚示
嫉	疾癡嫩傚埃唉挨俟效矢族擻攸藪轍佑數畋枚知收傲嗷撇撤澈撒做遨倣
顯	願煩顥顆頻頤頡碩頓頌頊頃頂顫類題頰頭頜頑頒項須
篆	喙緣蠡豕豚逐豢豳墜危豬豭據噱璩遽邃隊系篛筏瘍互劇腸煬楊暘鍚陽
躲	身朵窮穀楓亢殿殼躺股殷射冗役投躬毀跺般麂軀肌咒段
豹	豺貊貍貂貓貉的釣灼杓妁霾酌約芍懇墾解忽射惚喲刀屜忿
蒸	拯煎蕉蕪燕薰丞淡茗莎葵菟庶鯊蘸荻薊蘇永葬蔗痰氮薴蘭茅苑蘚廿漾
尚	哨捎黨膛擋俏掌檔常嘗躺屑棠趟削悄當鐺鏜襠堂梢裳肖賞峭宵淌敝消倘噹炯
浹	挾峽俠狹陝莢夾愜頰洧汰淆涿汍淬灘洶渚淮淦俎泱沁決沐汨沖沃汶汕
羌	兒美姜羔恙允禿苒亮善對赤坤兕圳充義羨漾窯樣儀羲糕膳鎂羹曦
縣	鯀係孫遜蓀系糸懸絲細潔累索維繡絢絆絀組紲紗紋純紐納紆紀約紂祇
彊	晅薑會僵票仁鱖幅桓疆黃阮沅逼垣耘閂儡量疊竺彈殭三二喱強福韁弼彌
匹	屍層金叵四匝司匡匣穴尿淦鉛匠屆公尼忪屈居鬆沿屎屏屑展針釙釦鈿
砠	詛咀磊硼硯碉石研硝沮姐砰砧砝砟祖租砂砍粗蛆斫俎硬矽狙阻碘碌碓
曆	歷瀝壢香靂稈杳黎馨湯秩季查禾才穆種稞酥桿秣祕豺秒
鬱	遙榣搖缽缺謠瑤睥彪彬脂能杉佗萄疹覓麝缶膨跎棚淘掏彩彫啕衫珍彥
舞	苑茗侈舛多栘爹夥移宛無麥汐桀夕銘傑矽摯茅名舜令酩麩撫外
訝	訏呀評訶訐訌訂誣訣証詛詐託討訕訑計訃課語
暈	漣軸陣渾軏鏈運軌軍輝庫揮葷鰱轟褲輦攆載蓮軋連車軟暉輞琿軒
沏	切徹砌
扶	掄扣夫芙窺撲找撫拎扎捧扒鈇替佚拌膚輦攆拾規拖迭伕推失趺麩拳拴挫
己	倦厄呃扼改範杞凹桅記忌脆尼紀已卷妃屈圈危氾卮犯捲屆苑
葡	莆芍匍蒲芾甫芯補脯鋪浦捕埔圃哺荀苟薄荸怵
皆	媲混崑焜琵篦諧階篁比偕揩陛棍琨楷錕餛鹿罷
昀	均鈞筠勻的勾勺杓灼妁冰釣暍易曷芍旺明昕曬次凍準怡冶日曰昌旦晶
徨	隍惶湟煌遑蝗韹凰篁役皇得徐待行循很徇往復徬從徑德後徙徒徊律徉
璣	機嘰譏饑幾瑰玨斑班爍礫琉珪玲後鑠磯魂珀王茲
噯	曖璦愛硼朋受嚼授棚啁崩嚎綬喟娟捐涓胡咀胴舜骨
囁	懾攝躡聶鑷楫揖輒輯緝弭洱聞茸餌趣椰陬耳聾聱爺
譽	言與倦這警謄諂謎蜷讓券譬嶼歟訃卷計諄舉唁信訕誓誶詹諒眷
環	夢瓔篾囉班楞玀寰理玨壞斑澴薨甍蔑不鰥蘿籮遝鑼爵愣儸邏還
節	唧卿鯽即櫛昂茆迎抑仰廄鉚啣柳泖腳概溉慨孵聊御卹印叩卯
訴	訢詬詐託註詛話誅訐訕訏計諛訂訃評詞証詁訶詳誠詢詨訪訣訥許訌記
撩	捏嘹春暸捺潦捧措顯撚了奉僚鐐療拋挾剎寮繚燎遼掩瞭揍
祈	析昕近沂折圻聽斫所斬斯芹匠祆祚新斧祇訢掀斤
兢	克剋兄況侃鴣祝咕嗅競古宮兗鈷稅詁舐故枯牯胡姑沽估熄舔媳楛唬沉
橛	厥獗
珊	玥玨現琛王弄柵姍琿瑤璦班斑玷珀玟玫理玖琪頊瑣瑰瑾璞再皿冊盃盅
蝦	遐瑕煆暇假豭葭蟲蜓蜈霞蚓蠅蚊蟲螂蝴蝌蜘蜊蛔蛟蛀蛄蚪虻蜂蟬
睿	濬璿啻旁帝敵龍離獻真蒂籬同滇慎填啼鎮些三闐龐寵籠貞且膀膈榜瞋
閱	銳稅脫悅蛻兌說閭閉問閨聞閘闆閔閏開閑間閒閎悶閃閂門
凱	芟楓亢豈颯殿脰殼逗股殷譏冗巖覬投設躲跺般毆皚吭珮幾愷肌凳咒段飢剴
紹	絕炤紛結紉絡絹迢昭沼招縲絲緝紀糸絃絨給貂超綏綵韶線繙纜細紗
轎	輳矯犒輾軼稿輜輪輸嬌鎬輔較轟轅軛轄輻轉搞縞僑喬輯車槁驕轍軾橋 
瀆	櫝犢續贖黷牘讀竇賣濤澆澤澴濁漫溘涅演法甲
劣	另男脅勇省力肋叻努勢茄痂荔劫助伽幼劾協咖勉迦動勳
楨	偵幀禎貞相貝鋇樸榜槓員賄貼敗校狽財柿柱盼枕枓楣損賊貽賤遺則櫃
麓	鑣鏖塵麋麂麝麒麗麟鹿毗焚梵婪庇儷灑邐欐曬枇比
廟	韓瀚斬麻笛斡乾肺庫戎霸朝廾嘲甫迪柚潮油戟由脯嶄袖幹蝴榦慚抽漸郵
集	隹焦售隻雙奪椎雋崔進淮推惟堆唯錐榫樵侍仕
舌	咕牯古恬居闊甜亂話估舐刮括鈷聒舔仟千姑蛞苦管枯箇颳活固沽胡
鬼	魏塊匆蒐戍麼槐魍愧魅魁機瑰魑魂嘰魄仞傀笞幾魎刃箋
石	磊泵司矽拓巖砂研砍砧砝砠砟硝硼碓歌後言洞洽斫拾恫恰峒哈砰砷砸
鈸	拔跋紱髮突公犬鋪錢爻畎吠伏鐮鍍鬆忪鈿猷鈞鈑鉸釵釦釣釩針釙餚鎂
殺	殿段股投殷殼般毀骰役穀疫設毅毆芟弒沒澱臀
陂	被彼波披坡玻破鈹跛皴疲詖皺阪皮陳降菠皰陵
淨	掙崢錚猙睜靜箏諍爭深浮淫滔沉渾湲溪滑洞渦沮
員	鋇貸貝側貫隕賃貴贊賈賀廁貨資費測惻責貲嘖損賞貢圓濺買狽贅
哪	邵郃梆邦耶嘟鄙嗎弔躑擲瑯啊椰那郾郡爺部榔槨琊郢綁螂挪廊邶叩娜
匙	題化仳比昆此北能毗枇妣批沘是屁庇死牝叱紕花皁
輸	軻喻軏瘉輪軌蝓逾褕諭渝轟瑜軛轄輻愈偷軋車愉軟軾榆俞軒
蔽	捎哨幣鱉撤俏敵氅銷屑霰澈敞散弊撇鞘悄廠瞥憋藪撒梢峭彆宵敝逍消
羯	揭暍褐竭碣遏渴愒喝葛謁曷羋羊噶羚羶歇羞差
籣	蘭爛欄瀾攔斕闌簡柬嫻閑鍊煉楝揀閉藺燜練澗僩捫們
堂	嫦黨膛擋螳掌檔常嘗棠敞削瞠當鐺鏜襠儻裳肖賞尚敝淌倘噹炯
織	統細綽紜纏絢絹繒糸縵線絨縉結紋幟締職絞縞識縲絃只紡綵紂緹枳綏絲熾縴
翮	翔翅栩翱翩翹翻翎扇翡羽翳融褶遢榻塌嗡翟翕翌習翁羿
軟	轟軌軋輓車軻軸軼軏軒軔較輊輔輛輥軛軾輪輻輯輸輾輒
凋	惆冽凜調準裯凍雕稠碉勻馮鯛鵰週次臧蜩啁冶冷綢冰凌周
圻	聽折沂昕析近所斫祈斬斯匠芹新斧訢掀斤坼欣垢浙淅逝晰
翼	櫂瀚羿煽擢塌褶翁翌翠翟習蓊嗡曜遢濯摺冀翰榻
闖	馭騖閒駁闊駕馱瑪馮媽馳門驚駑螞罵馬駟駒篤駛駢悶駐聞閉碼閃
薊	前莉荊鮪鮭鯉鯧鰓痢廁魚鮫鮑鯽魷鯖鯛鯨鰍鰭鰥鰻鱗鱷
愴	傖搶滄嗆槍鎗蒼瘡艙倉悔恰愎愉飧創食飾飭餘伶懺
琿	暉運渾揮輝轟暈葷瑤琛玥軍褲璦攆漣鏈蓮珊玨車
瞭	睹眼眇睢盹盼盯燎暸遼潦撩嘹僚目療寮瞋睡睫睞睥睨眠瞧繚瞄睦睬瞇
異	糞戴共烘洪拱哄供巽鬨冀基恭寒塞搴寨暴港龔溢鎰
跡	蠻跦跤踐巒跼趴跆跑奕跋跛蹕趾變踫跚踞跺踵跌跪躂亦蹄距趺踝足跟戀躋蹼弈
雕	礁調準裯譙帷稠碉難離碓唯雄鵰維雉雒睢淮瞧堆誰稚惟椎彫錐凋雊推雞雜瞿綢雖周進
矇	朦檬濛瞞瞄蒙睬算瞼瞧睛睜睢盯目瞿瞻瞳瞪瞬瞠瞟瞌瞑瞎睽睦矚眸眩
謹	誦請訏諾謀謙諛勤諶誧諫話詳瑾誣誰誠訃計謫詛課訂堇訐訌僅訕誚謨譜譁
桓	晅垣宣渣喳查極洹旦桿渲喧暄檀萱耘梧梔楊標杯枉桿槓百本奭
笑	夭沃妖奏笮忝吞添舔笙箄僑嬌橋矯契箠喬卑勿湊揍轎驕
新	薪析近斯昕折沂圻聽芹斬斫祈所匠訢斧晰掀淅斤
晝	書畫坦疸查袒旦堤怛但暨靼量瘍三昊旱在桿焊晅捍悍湯陽隄暘垣旺
懣	滿席愚英蓆瀟瞞漢巾蹣患恙恭忠芯吊布蒂灘滯瑛怖匝
狸	裏貍狎猥狠理浬猶埋童暑狄狗俚狙娌猓犯鋰獨狂裡哩著
鏤	褸樓摟嘍簍屢髏螻縷鈾屨婁鉀申坤呻伸鏽神砷
蹬	嶝橙磴躁跆躪證蹂躊跺踴澄踱凳跪蹉蹶瞪蹣燈足登 
廷	呈蜓任霆衽涎梃又建挺庭飪延筵妊薰造壬燻浩艇
愕	鍔萼胯垮誇跨憚儼鄂巖釅雩嚴顎囂彈嬋污圬襄誇
鷹	鳶鶴鸛鳴鴦鴛鷓鵲鵑鵠鵝鴿鴣鴨鳩鷺鷥鷗鷂鶉鵪鴒鴆鴉
蔚	尉熨慰廚符府褽駙撙遵樽紂冠屎奪等痔團寸褥樹榭傳特時狩持恃峙附
睪	澤擇鐸圉繹釋悻倖譯驛幸署甲蜀報鉀鴨胛柙押呷匣
站	倍貼點店竭意焙沾垃泣佔帖乩拈培拉立粒章位砧玷黏藷笠音儲涪妾靖童
飽	抱刨餞飭饅飴餃餚餉苞飯泡饑炮饉館跑餌飲咆餵包飪饒袍蝕餓飼餡庖餿餅餽飾餒餘餛飢飩 
膝	漆採黍採黏肘菜膊睬椎枚杵榮踩滕綵樵榫腺栓榷林朋來月槳愛森受
唔	悟捂晤梧語圄鼯齬吾伍籲五品韋唁咯哈敔偉喱呃伺詰路違遣噎噤噪嚅
髁	骷髏髑骸骯髓骼骰體裸棵髒髖踝稞猓骨課滑果裹窠彙巢
輟	輳輾輜綴輪軌輸轔轎輓轟轅軛轄輻轉軋輯桑車掇軟轍軾啜
保	侃呆褓葆噪谷堡棠俗傑澡橾燥休吋佑喳僎操躁促侶咻褒
歎	難艱漢嘆歇歉欽欲欣炊坎吹灘攤癱歌欺飲軟畝砍歡玖次葵疚
數	政樓啟疾敵改玫擻僂矢敬敞散敖矣畋摟婁故縷牧褸藪收敕敢敝敉攻枚蔞赦
蒜	蔡齋崇綜糉漂嫖膘標瞟棕淙捺鏢察賒際噤縹襟驃鰾
維	組約準細絀絢純繪繡糸紐紗結紋堆濰紀糾給羅縲紆絆紂絰綸納推紇絲紲住
儈	檜燴膾繪佺儉偷倫會傖侮傷伶僵偭僧僭仁佰劊覃
碰	踫碘磊並磋磺普研磁磴石碑碓碩硝歌硃確砰砷砧砝砠砟砲砍砂斫矽硿
昧	沬妹味未魅早晏宋朱卓杲草暑守明株侏銖暄日曰昌茱晶寐
趾	跡扯跳跦企跤踐跼址趴跆跑啃跋祉蹕踫跚踞跌芷躂止蹄恥趺距踝足跟躋蹼
匡	框筐玨眶王全汪旺枉司弄狂玥皇閏刁劻屋班斑
灼	釣約怡杓火趵竈勻炮妁勺鈞的昀豹芍勾炎均喲酌
鍰	煖暖湲援媛緩諼爰鋤銅錚助鋼鍋鎰塚鎮胴天勗脊
毀	殼殷般段股投殿穀役骰毅毆殺設燬疫芟沒躲慇磬罄聲馨
瘺	漏雨霍霄雯雪霽霖霎雲霑霜黴零靈霓震雩霏霆霞霪霰霹孀櫺
萊	睞來徠莢苯茉萃葉菊萸茱苗芝芙芥芯昔芋艾葦卒巫夾坐廿椎俎杵枚
踱	踐跆鍍渡踏跋足踩蹉蹣跚蹂蹈蹊蹦跺蹲躇蹶蹬躁躅跎躊躪踫踝蹕跟蹼
孟	盈蜢益盟子扁柵鹽盂皿盆盜錳盒艋盃監盍冊盔盅猛姍
咒	毆冗亢器哭單囂幾肌設凱跺朵芟疫嚴嵐瘋咚佩股咯吭投段殷般飢殼楓
苑	茗範舞怨多栘侈宛爹移夥茅脆桅汐範麥鴛夢圈已己夕矽倦捲扼呃銘
蜘	蟲蚯蝸蛤蟲蝴踟蚓蛔蛄蚊蝓蛉癡蜓蝦蛟蛙蛐蛞蛀蚶蚵蛆蚱蚪蚌虻蠅蜈
籬	離籠敵帷懼暹僱癱龐寵罹藺蒂隹璀摧雌匯催進啼
皎	校狡姣咬鉸絞蛟跤較餃鮫詨傚交效皈郊白的魄皋泉
貴	鋇貸貫槓賃贊員潰賈賀遺貨資費責簣貲匱貢買狽
架	叵加男另保茄駕嘉奩賀伽癖肋叻檗袈迦痂瘸咖呆力喳
鎮	滇慎填縝瞋闐真巔癲顛宜針鋪鈷鋤直銬植值鎔鍰錠銨銅且睿
切	庇徹炤屁貂頃刀枇沼沏岔比砌妣仳紕昭券忿迢叨分初批能匕毗沘昆旨招
漲	湛湧泓悵沒刁涎浸潛脹賬溉瀰溺汛沍渥萇帳汐張長倀污
薩	剷蔭產窿鏟邢防阬笙鄧隆鄴隨橢鄭鄞郵部婀啊耶郎鬱邱祁那邦
柢	胝泜抵低牴砥祗底詆氐婚衹祇紙舐氏昏邸梔極
窩	鍋萵過渦媧堝窘窖禍蝸潸窯窟空穹簾竄竇窠窒窄突究窪竊猾滑
譏	請諾譙議謀謁諂談凱諉饑諜謂諍譟機諳誼讓訟謊嘰識幾譎肌謨璣誡譜諒飢謐誌
伽	咖迦茄痂加劾叻佑另脅肋力男劫助幼協飭劣勇架荔
搭	捨荷褡郃擭拓洽措撿荼搽摸荃哈給拾描瘩鴿合塔恰答 頜
樸	卜槽異橫寨拱撲璞補僕供棋濮林哄模檬共噗榕柑烘恭基洪楛蹼 
郝	赫赤赧赦赭嚇郢郊郎鬱耶邱祁邦那邢鄘鄭鄴郡部郭都郃郵郾邵邸邪鄒
捻	唸稔拎搶念鈐吟羚拖伶岑掄捨拾拴鈴泠撿擒黔今
淘	掏啕陶萄搖榣遙瑤缶謠缽缺缸沁罈淬沱佗沌罐罄罌
孝	字酵丈哮孛孚李存教季考學子好囝仔孕孱籽猛
摟	拂樓髏屢螻擻數簍僂呻押坤婁縷屨砷嘍褸鏤申拽伸抽蔞神
烹	亨享京哼亭亳高亮膏豪毫淳惇逞吼襄了郭遐景哀熟廓圖佔涼掠孰停晾
鑠	爍礫藥樂鉉麼窈機吆玄璣嘰姒似茲畜奚饑鏍譏嬤綵後以幻拗關牀
充	允亮統棄兒迨卞率述遮玄禿育庚母卜唐庸康劃州流梳
惱	瑙腦淄錙緇輜臘邋巡繅獵蠟媲巢災鬣邕篦囪姦
噸	頓擷傾瀕貳澦嶺蘋巔籲癲頹頡碩煩頑頃贛頁鬚
賒	漂貝察糉噤崇貪賠際棕捺購賊蔡敗蒜賀賬貨貶財賂貧標責賦貯賜賻嫖賤淙貽綜膘鏢負瞟
祭	察碳際宗票仁蔡佞滅標禁擦賒不竺三示奈二祟禦
榔	瑯螂廊郎椰梆槨鄉棧橢挪娜哪擲綁嘟琊邶躑弔參晉
寡	煩囂碩頓頒頌頊頡頻頤頂頃顆顯頗領預頑頫頜穎項須頰頭頷頹額題類
旦	晅日坦怛查桓湯袒悍曰昌晝旺垣一閂昊量焊宣是桿旱擔暘曬二但晨捍膽疸
噱	據璩遽豳邃噓唬豚逐豕劇豢豬豭瘧喙擄墟濾號琥
搗	貌拍把啪邈笆藐皁託扒白巴括拆抓扳折皚指鉑插捶耙柏迫怕杷泊肥吧
滴	摘嫡嘀適鏑謫滾商濟沾泣注汶汴六漓潸淑滷淦涉溢滂濠濬涼涪瀘流沆
馭	馱馬馳駐駟駛駒駢駱駁駿駭騙駝騎馴駙騁騷騵驃騾驕驍驛驗驟驢驅
勿	忽刎囫吻易物惕惚錫必蜴賜踢泌剔鉍卑怕笑笮愧
萱	暄渲喧莞薴宣蓿洹菅蓉奭桓晅垣崇荸蕙著苦芰芾宿蕩百棕淙梡
蘸	醮蕉醺薰酉酴蕪焦譙礁樵醋憔酒藺舊薑燕廣蒸蒙煎醫西醣醞醜瞧醉酷
蠻	蚤螯跡融蟲鑾灤巒蛋鸞虺蟹灣奕閩變蜃攣孿蝕彎蠡蜇亦戀弈蝨
迎	抑仰昂泖柳唧啣鉚衣衷節卿聊御腳鯽依姬茆褒
肪	旁枋妨坊仿防膀芳房彷舫紡訪傍滂榜鎊倣淤遊方菸瘀遊
相	霜盲懼督看楣柵眉櫬棚目苜親冒睬廂睏省篡楨箱枕渺湘算想眷
饑	餽機嘰餞璣譏餒飴餵餡餘飾飭餓飪飢饒饅餾館餛餿餚餃餌餉餅蝕飼飽
垃	倍陪潼焙漳憧憶噫泣鐘接億璋菩撞暗培樟拉立粒位昱僮站臆笠音涪妾境
糸	絲縲細糾紀紂約紆紗紋純紐納絆絃絀組紲結絨絢絹綑綏綵維繡
剔	刨刊利釗剌制踢刈刮削剷劑惕易賜判刪刖剎剩錫劃剃刺刎剁刑
嗣	祠詞飼盒司伺萇砠卹叼哈銅桐胴峒恫洞冊皿石刁筒磊
未	宋沬妹味昧朱魅守侏株茱銖木十寐珠硃宇字狩案栽殊蛛跦辣
蓊	嗡翁遢煽榻塌翰瀚蹋羿廖翼翟翌習摺褶濯擢櫂曜
盃	甭盔盡不盅盂否扁益盍孟盟監盪皿冊珊柵姍儘燼
跌	佚趺趴跦迭踵跺足距跚跟秩踝蹼躋跋跑跛軼跤趾跼踫踞蹕跎跆踐踏踩
斕	蘭攔吝文澗閔鍊們諫欄爛嫻煉柬揀燜閑籣憫僩捫潤瀾楝閉闌
套	肆屋瘺刁力喔握渥左雲爻痂叼病疳疽彗疣疢虐奇疝男乓有灰另癖芸壽
盡	燼儘盃侖蠱盔蓋盞瘟篇盧藍盆籃貴蜢蝙褊襤闔盅皿冊磕溘溫溢慍遍隘
思	囤腮慮曳田囫恩蔥心胃忠芯志拽洩勰鰓急怎畏忝恙恕恭息忍患忘忌男
涯	澆捱褂湟王珪卦娃汀奎哇掛圭汙佳涇沅窪畦湮桂蛙崖汪堯潤溼封污汗
棻	芬盼分菜茶忿岔頒汾扮吩份萎剪葉寨盆蕃藥蘗粉
賈	價慄要粟費貴買責貫貢員覆資貲貿質貨贊遷鋇
括	拆扳捶古恬闊搗甜託亂話舐刮扒聒抓舔插千蛞管颳活拍折舌
又	芟扳奴夜板各沒友股返怒叉及建冬投庭反權吳延廷怪桑隻候弩侵杈雙皮疫
偎	喂煨猥餵佞畏佃儡儂僭倀個衰簑娉侮僵俚辱聘佺耨褥表長畫每
逖	逛荻狄誑漪迦猓狸狠狗狙狎狂犯猖狷文猴猶狹狽狼狡狐猜猛猙猥猩狩
泗	泅涸渭四浬淦漯鈿沿溫澴水捆梱錮油沁沐沖汨洪佃汝汕汁汾浴淄潘澤
袈	架裁依袋賀裟裘裝褽襞襲裂裴製駕裳衣癖裔加
陌	陣防院陂限阪奭貊隔陲佰陋弔怕陡帕阿阮除陝陴白阱柏弼百隅隍陽阻拍泊陳伯隊陘 珀阡
級	組終絡約細絀伋吸絳綾糸及紐汲紗紉岌紋紀圾縲紡絆紂紙紼納極絲紲紱純
旁	膀坊防滂鎊舫肪枋徬妨傍菸彷謗倣房遊龍訪磅榜芳紡方螃淤仿瘀
齦	齟齣齪齲齜齡齬齷跟齒艱退銀眼根恨垠齧限狠很痕
盧	膚慮廬蘆瀘爐臚鑪鱸虜驢瘟慍篇盡藍蓋盞籃盆侖虛濾溫遍媼塭顱
駿	馭騾酸梭駁唆馱駙駝浚馳痠騎竣驗馬駟駱俊騵駒駛駢驕駐驍騷峻
鼻	劓鼾息臭贊畫虎斤熄劃溴媳嗅猥唬侃沉哲畏芹斧蚩兄工煨睏琥晰斯喂
猩	惺腥猖醒星猜鏟隆旌狠牲生笙性姓產猥狷狙狂
湄	媚楣眉洎湘帽瑁算省渺自箱篡咱首目廂臬冒纂
誌	詩認譆讀誡誥詮談詫試詰詼諜謂訟譙誼諒請諉諂諍詣謀諾謁諳詆詔講
擱	喀落閣捫露攔雒櫚扳燜憫潤澗嫻僩鉻略格烙胳恪洛咯投們客各
葦	韓度違本緯圍梧幃拿吾悟諱闈笨捂韋缽晤韜衛韌苯圄偉唔
加	叵荔架另男茄幼駕嘉助奩伽賀肋叻勰迦袈劣劫痂咖力勇筋協脅
訏	訐訂語訌訝評訶誣記討訕訊託訑訣訥許訢計訃註詞詁証詐詛訴詳誅詢
制	刖刺削刷刪利劃釗刈剩掣刻刮剁判剎剃剌剋則刑刎剔剛刊劑向奧
繽	臏檳濱嬪儐綜綻殯縮綰縲縯絨縝絲鬢緒糸續繪繚繒繙績縿縊縉編線緩
奔	卉寞奢痲莽寒賁塞寨搴瘩爻大希薴豆晏疸痘痣痰瘁瘓寬瘟瘴癘疝疢戎
劬	包刨咆抱泡勉叻炮胞袍鉋庖苞脅肋砲勛另劫助劻功幼觔勒跑鮑咖拋男
馮	媽嗎瑪碼螞篤闖駑駕罵馬騖驚馭馱馳駐駟駛駒駢駁
錡	畸椅崎倚綺琦犄寄騎奇荷婀啊可柯河坷呵何苛
假	霞芟夜瑕蝦沒浸股遐健又葭豭投促般煆候侵暇疫
翌	羿習翟翠翼翁塌遢榻蓊嗡煽摺翰褶蹋濯擢櫂曜瀚
妣	批沘仳枇毗紕屁庇昆比能妮砌牝叱化皁它尼邶訛傾靴雌齜此死北佗呢
牛	牡牟牝件牢牠牧牯看牲毛生失我物拜特湃牴犄犒犢
麾	魔摩麼磨糜尾靡耄髦氅撬橇耗蘑毛氈嬤麻嘛毯娓
輿	車連庫軍軋褲輦鏈蓮範漣實轟較載運葷暉暈軸渾揮軟軒軏陣軌
一	二仄三左旦丁刁下上於兀士幹不天王且丘本甘石百
誕	誦誹詭諛詢諂涎話誤謎誅詳詻誣訓誑誰誠詖訃蜒設延課謝訛筵譫訊誚詬譴
蔥	聰蕙蕃惹思慮慈萎薰蒐腮傯蕊莠芟董萸茱芯芹懂
毫	蒿京亭毛嵩耗烹牝氈尾嚎牽搞亳毯豪膏篙迭亮哀高逞婷犖臺娓襄停享亨
魷	就鮪鮑鮫鮭鯉疣鯀鱷鯧鰓嵇鯨鯖鯛鰭鱖鱗鯽鰍尤
卮	厄危呃扼配卷已己氾犯妃杞桅脆記軛忌紀跪範範改梔詭
鈹	被波披坡疲跛皴破玻陂彼詖皺皮鈑皰菠簸頗板
噓	墟虛唬噱濾瀘爐臚鑪瘧據擄璩號遽琥驢鱸甘箝廬蘆
吹	嗽砍歉歎玖磴歐飲欲欠次欽灸久疚坎炊畝軟歌欣歡
蒂	啼締蹄帝諦啻席常滿瞞希蹣蓆幕籬巾鈽滯棉錦砸怖佈
汞	工貢攻功江巧槓肛扛釭項佐築紅缸虹訌槓鴻蚩
趺	跌趴足距跚跟踝伕蹼躋趾跋跑跤跦跼踫踞蹕跆踐踏踩蹉蹟踟
噥	濃儂膿穠農嘈澧槽遭漕禮喂醴體樽遵撙糟蹲甚
掩	撩捺怖唏希捧奄摟庵由烯拽佈拋鈽菴醃淹晞鵪俺抽揍
竹	麼八少臼禾白戊必乍牛戶夭壬升才千鬼匕刀幾入
甦	更牲性姓梗埂哽便笙星硬粳產鞭生隆猩惺猜腥醒
托	託
埠	阜塢薛篩墦埤啟垢塊帥獅師坼圻呂宮域培堝榫坑墳追侶味咕吱鋁壎烏
絀	絲細純紀縲糸組紲絆絢紗紋紐納紂紆約糾維繡繩繃紕
乾	榦幹斡廾戟朝斬翰韓麥麩嘲潮廟麴慚漸嶄你仔麵您乞
嶽	獄誑誡荻言漪誧試誠詠逛訕狡訾諮諾謂謨識談課誰獐誌認誚詳詩詼詢
帚	婦掃帶歸刁帝尋啻蒂而叼啼耑耍虐彗雪需慧巾侵伺浸匝
嗎	馭騖驅駁駕馱瑪馮駙媽駝馳驚駑螞馬罵駟駱駒騫篤騰馴駛駢駐闖碼
泣	倍潼焙漳沾垃注接菩暗培拉立粒位昱汶濟站汴笠音涪妾
紕	毗枇沘批妣仳能昆庇屁比絀絲縲繃纔糸緲紗純細紀
嬰	罌嚶櫻瓔纓鸚鋇賽貝贊員賄臢貴責貫貨圓賞賁貧負貞頁賺購賸鎖贈賤
襯	寸霜守盲出孀攬相胤櫬過盹目川親廂討欖對覽時纜村箱付雜湘想
恤	洫血卹懊怕愧謐皿冊盆恬性慍必盪柵姍惚愀惘扁盅向奧
赫	嚇郝赤赭赧赦螫倒鬥小測惻喇琍涮側洌咧例亦鬧鬨廁薊帟前
讖	殲懺籤纖詮譙諭論誡誨試診訟訖誰訥許讀譟譁譜識證譚譏謨謠諦謀諱
障	瘴蟑防陪獐子彰漳憶噫草幛億璋鏡暗樟響章隧阬臆音黯境
壢	瀝靂歷曆賦址止武啃趾祉歧扯歲肯芷企墦穢垣圬怔焉正症
夕	多外名舛弘汐侈栘丸凡歹令宛矽爹茗移麥夥銘
百	佰奭陌宿弼洹曰日一宣垣厚桓晅貊厭渲喧暄萱蓿壓
醋	酣酉醒醴酷醞酩醮醺醜酥酗配酌酊醇醉醃酵酸酪釀釅酴醣
淌	黨膛徜擋掌檔躺常儅嚐趟棠當鐺沙鏜襠堂肖尚消倘噹炯
梱	棵捆睏困綑森棟柙林稞東果番楝樽橾淋痳糰裸彬琳柬木
慫	聳聚傘從慾愆眾恣樅憊應愁筮您悉悠息怎忝忽卒縱蹤俠俎佾驟扒叭八
孵	卵卯鉚卿柳泖即茆聊卹印叩節唧卻卸劉御鯽刷迎抑仰貿留昂孚
御	啣徐卸從微衍銜律復徘術街徹徵衡黴衢徙徠徒很徊徇徉徵往彿彷得徨
嗓	沐嗨泵樑噪沫決淋喋喳渣漆唔湘淞呶口菠品呆
鴒	鵝鳴鳩鴨鴣鴆鴿鵑鵠鶉鵲鶴鷂鷓鳶鴉領鵡鵪鷗鸛鴦鴛鷹
攘	孃壤嚷鑲瓖禳曩讓釀搞掠襄擁拈擅摔犒掖抗撲
蛋	蚤蛔蛀螫蟲蠻融蠶胥楚蛄虺蟹蚱蚌蛐閩蛙蜃蚶蚊濁蝕蚓蛆蠡蜇獨強蚯疋蝨
鄙	鄗部郡郃邵鄱郢啊鄘鄭鄴鄂郾郭都郊郎鬱耶邱祁邦那邢
疲	陂破板皰彼玻菠皺跛被詖披鈹格皴波疼坡簸皮頗 
士	宇十一完佇宗定宣室薴家寅富賓演宜空宸軏軒崇梡淙莞喧傢棕渲嫁暄
阿	婀啊河坷呵柯何蚵奇苛陌軻訶可阮隔阻阪陘陋倚崎椅畸錡弔荷寄
歸	掃婦帚浸侵伺叼帶虐慧彗雪諦啼啃止刁蒂啻帝肯
軀	身窮驅闆躺漚奩櫺歐躬區操躲毆嫗鷗甌嶇橾品嘔兒樞
鰭	鰍魚鰾鱸鮭鮎鯉鱔耆鮮嗜鯛鱖鯧鮪鰱鯨鰓鱗鰥鮑鯖魷鱷鯽鮫鰻
纏	絨縿縲絲結絃紱細糸織繒繙縛綵綏絹紜緘維絰紐紂約綑
迨	胎治擡怡始冶跆遮苔笞臺殆貽飴颱怠或迢造域過遣銘哉名
缺	塊袂罈陶訣鴃瑤搖淘萄缸榣遙缶罐抉快缽掏啕決
浬	娌埋哩俚裡鋰裡狸理鯉潼嘿童黑湩貍渭泅泗喱量墨黛
鈇	扶伕夫芙趺替窺麩錶攆失推鍥輦鈉欽鈿釦規針釙迭錐佚金承
池	弛她地他迆沁也柒牠沌泌洩洵訑馳沐泡洶拖迤
邂	懈解蟹踴煥湧渙換喚瘓觼迢牽勇通迭瓊挈奐尾
弧	呱孤狐瓤瓠瓢瓜瓣菰以姒似弦系係蝨孫吆弘幻縣鯀玄樂關懸
培	倍競陪賠焙垃噫泣接菩璋暗拉立位昱笠涪黯境
靶	靼革鞋勒鞘鞅鞠鞍靴鞣鞦韁韉韃韆肥爬杷把吧鞭芭
侏	跦株銖珠硃茱殊蛛仟誅朱作伯件任俾傀未千俄佚狩倭入宋
膊	博捕敷莆哺蒲輔傅將搏補甫賻圃鋪溥脯縛肘匍浦埔
牖	牌版片牒牘褊淚捩唳蝙遍偏補甫編滬膊僱溥搏博傅鋪誧輔脯蚱浦砟
醃	醃淹掩俺酉醋酵酷酪酩醞醮醺酗配菴庵醇醉酸醒醴釀釅酴醣醜酣酥酌
剎	釗則刈劃刖剃削剌刺制判利刪別刑剩刊劉劑剋刷刻到刮剁剖剜剔剛剝
枚	敉敘畋教敕敦矢矣疾牧玫故改收敝敖啟敞敢散敬敵數
鹿	崑錕篦混焜棍罷琨媲餛塵鏖麂麋麓鑣皆庇毗琵麝偕陛階揩楷麒麗儷灑
犛	釐犖牽牢短眸枚件牟牛敉牲牧牡仃痘奈誇三犁看左湃教敘特牯牴拜物
仿	坊防舫肪旅枋妨傍菸彷倣房遊訪芳紡方旁淤瘀
疣	尤嵇就魷稽疝犬尢爻太蹴畚痠畎吠倏伏疤疢突疾餚臭戾套奄哭痍宏奢
澳	懊噢燠襖奧渙洫洎沃添筋向潘潟溴煥湧湄換喚淚浩洛泊泱制瘓
湛	辰農諶堪佞甚儂斟洋芸勘沍膿淇戡濃其噥污洪
程	逞和呈稱稻秒穢禾稈淫稿穗穡稅稚種秩祕秋秈私梃稠番聖香委秀告
望	呈牽淫妊聖肓造衽任盲窖薰壬浩皓廷燻告逞飪誥酷醺
瀝	涉厲扯曆肯勵企潘址湯啃祉趾靂賦壢澀芷止武歧歲歷
牙	邪雅鴉呀芽穿蚜琊訝辱才撐褥耨材畏表長杗佞柏柞案閉偎喂煨槐
拌	胖捎畔倦勝謄半蜷叛踡賸券卷圈伴抄絆判騰滕捲姅拳眷
害	憲瞎菁割倩情清拓晴嗉嘖轄富合青猜債睛靖漬精蜻豁鯖
糞	戴冀翼異糰米糢糟糕粒粉共糠糖糧選糊潠撰精僎粳粗粕烘料敉籽
廄	發瘢搬緞澱燬鍛飢轂疫芟飯股投節廢殼殿殷般段
釭	肛槓江扛虹缸紅訌工築槓汞攻功佐鴻巧貢項釘蚩
拗	吆姒藥湧勝似礫幼勞坳勢爍窈機鑠茲玄渤奚鋤慟劫嘰畜力幻拋黝筋勗脅
墅	野序予杼妤抒多疇墊夥預舒豫栘侈歿型圭墨爹矛澦移埋矜
蝸	蟲禍過鍋渦媧堝螟蛆蜘蜩蟲蝠蜻蜈螳蛤蚣蜆蛔蛄萵
使	吏仗什佬估史午仲值佇佗倌倥做妻傘侑侏杵便俠佛佃伸夥伐伊伏休倖
偯	停佔僕信伉倍嚷壤孃攘瓖禳鑲儲掠涼晾依住位儕佔曩
良	娘養宴浪痕飧餐饗食饕垠狼銀退根餮釀恨癢琅艮
側	鍘鋇例貸貝貫賃貴賢贊員債賀廁貨資費則賡測倒惻責貲俐貢濺買狽贅
莉	痢俐琍蜊萎蕃荊前莠利薊梨蘇禿簌犁菌秉悸秧喇
居	咕牯葫鋸古湖瑚罟估蛄鈷倨劇姑苦骷枯聖耳固據糊沽胡做
櫻	嚶瓔纓嬰罌鸚鋇相槓楣楨櫬湘貝賽箱廂臢贈欖賸鑽榣滾賺賬賄棚櫃贊
緘	絲箴鹹縲紱絨細組紗紂約紆縿給纏糸緬綞綠維縝縯絢絰繡絆統絀紲繩
狡	餃獐跤交郊較鉸效狄絞膠狹蛟鮫校傚姣詨咬狽皎 
率	卒卜瓜育跎應迨卞碎敏矣瘁述母充遙缶畜豪膺蟀淬逢什遮悴棄午萃摔
泡	抱砲刨沁苞皰劬炮胞跑沌匏咆鉋包袍鮑庖雹飽 
皋	嗥白泉皇帛皁皎皈的皖魄柏迫皓泊拍怕鉑伯皚
蒞	蓓茫蒲萍蕩莎藩範藻位落蔆菠薄倍菸菩僮億泣
癥	徵薇屨履屜屐懲覆樅微桁蹤縱黴往徨循徒徊律徉徇很待彼役
眼	目根退恨垠銀眠眇盹睹睢狠限盯瞭艮痕盼睫睞睥睨跟很睡瞋艱齦眩睬
竣	酸竭菱蔆梭颯意唆鈑返浚痠反鋒立端俊販章竟站鉻音駿妾凌靖童峻
恿	甬痛桶通湧俑蛹誦憊怨用夕舛惠悶急感態忍多名懋舞掬掏栘侈傭汐弘
饒	飭餞飴澆橈嬈繞撓蹺曉餵僥飪燒堯餡蟯飾驍餘餒鐃飩
昱	暗笠煜立拉泣垃位音妾菩倍接涪培粒焙意瘴陪漳僮樟撞憧潼億憶噫諳
眸	牟眩睛目眨睦睬睜瞄瞎瞌賤瞞瞬瞧矚睥盼眇牽戛看犖
個	涸錮箇固估佃古楛做倨枯胡咕姑沽鈷偎儡苦居捨
濤	檮法淺澆泠鑄弱濩瀆壽禱湮瀰溺躊沍疇涅坎儔籌蟯潤琺渥燾堠汐溘治
塚	塚琢啄涿壹豚暖煖場堝媛援湲鍰胴壺蒙塌琿瑤琛稱噎緩堉諼璦填玥坍
崩	朋棚受硼骨崗愛崢朔胴峒舜瞬授溯滑亂睬繃蹦鵬
懍	凜稟懷惇迴悴悸愀啾憧稿逶憶憾擅澶壇檀諉壞羶惦逞悼悅忙禾蓑裹菌
娛	娟奴咯婿努虞茹誤怒又嬋駑氓孃吳好姦絮如弩蜈帑妳始妞呶
徜	淌倘徊躺很徇律徉往徠徒循彿彷趟徙彼徵從徐徬待行徹徵
貫	鋇貸貝側賃貴慣贊員賈賀廁貨資費測惻責貲貢摜濺買狽贅實
弄	王瑛璜玨璞玥珊琪瑾班斑全汪玖旺枉匡玫玟玷珀珪理琳瑰
篾	蔑籮寰夢薨甍還澴遝楞玀愣爵蘿戍環鰥儸囉邏鑼
斫	聽訢昕析近折沂圻祈所斬斯芹匠磊砟新硃碑掀斤
錙	淄輜緇邋臘繅獵巡腦惱蠟巢瑙鬣災邕錨勦剿姦
墳	噴憤賁貯貝賽苜賊髖鋇寬實貫員瞎賤慣損貽填賄貼敗狽財盼則貞負頁
摭	遮拚蔗擴擡找挨庶摻撫械戒弁撼渡鍍拭誡搏踱獷壙曠礦搪捕拔鷓庠度
畚	庵犬畎尤吠伏奚奮疣爻戈因畜莽怠庶度菴或盞希瘟瘤臭哭突戾矣戒牀
蹊	踩溪蹈跚踐跆足蹄踱踴蹣蹦踏蹲躇躊跟跋蹉蹂踹蹟踢踡蹶蹬蹺躁躅跨
頭	碩頡頜頊煩頂頻頤顆頓頌頑項頃顯顱頰頸頷頹穎頫領頗額題顓預頒類
標	漂噤鰾糉察崇縹棕際捺票蔡蒜賒祭襟嫖淙示綜膘驃鏢瞟
厚	享子荸孳遊閑俘浮孽孚李閉字悖悸脖囝好弼遊仔嫻
鉍	泌必祕祕鉤鈍釣密鉋鈞錫勿瑟蜜愧怕謐恭鉑鈿鈔釦針釙吻金匆易忽囫
鉉	炫弦絃眩舷玄畜鑠釙鑲蓄嬤鎬鏍吆以幻玆樂縴爍幼鎚姒鏈似亡麼幾茲
愷	皚嶝澄橙澧燈瞪磴壹禮豈惴證蹬醴體豉巖脰豌逗恰凱頭剴痘豐豆
弩	怒帑努駑吳娛虞奴蜈又誤夷九妳姨沒彆桑疚隻痍雙夜寢反友叉丸怪建
虔	吝虜文虎閔虞抆慮虛紋膚斑虐斐蚊汶處玟雯盧
鏟	產旌腥猩惺醒隆牲生性姓剷星諺薩甥彥甦瀕鎚蘋
凌	陵稜綾菱傻稷後鉻鈑廈憂鋒販瀲反珞賂板返扳各冬蔆
紲	純絲絢約細縲糸絆絀組紗紋紐納紙紂紆紀糾維緙縑繡縐
謐	諜謂論誡誌詢訑講謊謠諦謀諾謁諭諳諼謨譁譜識譎譏譆譙誼諒談請諉
盥	盜盛盅扁盪監盟盔益盍盎盃盂孟柵姍盤盈皿冊跚珊
晾	犒哼惇稿京涼鎬暝停佔驚掠淳嚎顥鯨暗搞昱憬濠璟槁景曩婷就諒影壕偯
迸	耕井拼構姘並送遘鉼胼併媾逆立阱搆駢餅屏溝
陬	趣椰取聶洱弭弔爺附陴陣耶防阡陀茸聞輒隧隨隴陳陡陝陲限陌阿阻阪
樂	牀吆藥似礫幼爍以糸機炫茲鑠玄樑弦奚畜鉉幻幾栽姒
樟	漳璋獐幛障蟑瘴章暗億憶噫臆粒境鏡黯梓草音
隧	燧遂隨障陪阬隴防附陡阱弔陬隊陳陝限陌阻阡隄陶陞除
寐	寢寤莊蔣鏘戕妝壯將狀未妹牆宋安案姚昧魅味沬
粘	佔沾站戰黏帖貼玷
彎	孿巒戀攣變鑾蠻鸞灣灤譏諂絃絮言礫繈絲燮訾譎譙識織磯縲縴謄謎縞
蜇	蟲哲蝨誓蠡融蜃閩蚤虺蛋螫蟹蠻蟲蝕蜜蠱搔蛔蛐蛙蜥蛀蚶蛄蚱蚯蛆逝
杗	亡忘肓妄盲芒忙氓茫案荒玄虻牀宋呆杲採桌樂森丐裊林罔核
戲	逗愷脰瘧痘豈豆碰碘豉磋磁短豐壹登匐詳砝研矽磺磴橙澧燈嶝澄皚豌
雖	雄截雊碓帷唯準雕離雜錐難維雉稚睢進椎淮推惟堆
孚	字仔子李荸籽脖孛悖孝季俘存好錳學孱囝浮孕
顧	頊頻頤頡煩頃願顯題顆頰頷頭頹穎頫頜頗領碩頑頓頒頌須項頂
釅	儼巖釀醋酷酩酉醺醴醮醞醒醇醉醃酵酸酪醣醜酴酥酣酗酌配酊
蛔	蟲蛐蛄蟲蛙蛞蚶蚵蛆蚱蚯蛀蚊蚪蚌虻蠅螺蟈蛟蛛蛭蛾蛻虹螻蛤蚣蝠蝸
粹	碎淬悴誶醉瘁萃翠料粒糙卒傘敉米糉精糕糢糟糝糧粉粕粗籽糊
養	食癢浪娘琅狼良餐飧蒼餮饗饕倉饜瘡苓艮餒槍艱滄搶愴嗆鎗傖
渲	渣晅萱溶演奭濱洹滓桓楦恆沱垣亙汁瀋宣淙暄濘瀉喧
荃	痊佺栓拴銓荼全詮茶荷班斑王玨莓苓蒼篁弄荏筐框
炙	胖熒月胱滕炎然籐籐火傑採疢妥灰朋勝膛爭灸孚羔舀魚焚焦無冗黑受
颼	颳颶颱颺餿瘦叟楓瘋嵐風艘颯諷搜嫂飄凰蝨逮棣肌稻焰陷啗阬役臼幾
好	仔子字囝孚李籽奴妞存孝孛季孱屘妳嫻錳孕奶俘浮猛蜢孟享厚學
俊	酸令含菱梭唆伋鈑浚念痠俯竣偺反鋒販伉俟鉻傻伐駿今凌峻
漢	灘嘆攤癱歎艱難滿瀟洪洋懣湛淇沖漠漕港湔濛濩滌溯庚
馴	駛馱馬駙馳馭駐駟駒駢駁騁釧圳駭騙駝駱騎騷騵騾驍驛驗驥驅
沔	鈣丐汪沍汗汙汀涿湎污河江洹酒源潛亡下茫汴汶沮沾汝泣注泥洱氾
園	遠嬉吉猿玩黠舐袁圉結砥呱桔圯埋轅畦壘袞疇元彫拮薹哀嘻僖裡完周檯
薔	檣牆穡嗇茴薹莓迴蓋稟苒蛔徊蓉蒼菱善茶苔佃回
頻	頃顏頒須瀕蘋頤頡顆碩頊頌頓煩頂顯頰頭頹穎頜頗題頑願項顧顥顫
瀚	翰煽榻遢塌嗡蓊翁蹋濯羿櫂曜擢褶摺翼翟寥翌習
慎	滇闐植慣悽顛恫直鎮填睿且悖真癲恆值巔匍宜瞋憤縝
闡	彈簞禪憚嬋蟬單闆問閭襄閤聞閘門戰關闔囊闋闈巖閻器閣闌閨閏開間
扳	叛板返鈑阪皈販咚恪洛咯降格烙胳略逢鉻客疼
碘	腆碰磊典磋磺碩硝確砠研磁磴石碑碓硯歌硃砰砧砝砷砟砲砂砍斫矽硿
暖	湲曖助暝緩援暈媛冒鍰鋤爰萌煖昊塚暉胴諼明天勗
迺	曬哂湮煙西酉酒迂配酌酗酊酣酥鈿醜逼醋上醫
櫥	樹廚棧械樽梭桔村檯橾糝橙錢腑淺俯鬆鼓私吋榭森喜府寺
劂	刑劍劇剛刻刪刊厥劃劑剴剩副剖候釗剎削剌則到制刺利刨判列劃刖刈
德	聽徨從得徐待役行徊律徇彿徬復徑後循徙徠徜徒很徉往徵彼彷徵衝銜
扼	呃軛桅脆捲厄跪危卮倦捱詭已己蜷踡配範圈掘搓杞妃氾忌卷苑範
牡	特犢牛牠牝牧牯牲物件拜牢牟看拮犧牴犄犒湃我生失毛
傅	博捕莆哺輔搏補甫傳薄賻圃鋪溥膊侍脯縛匍礴浦埔
勁	劻劾男勤勒另幼勵助劬經肋叻勣痙勦功勘頸涇輕莖劫觔氫徑陘逕脅
蟻	儀議蟲蛾義蟆蟒蛐蚶蟠蝶蜻蛇蚣蟲蠔蟯蟬蠣蟀蟑螳螺蟋螟螃蝠蝸蝙蝗
縲	絲鏍漯嫘騾螺細綑絃繙繹緇綏絨糸縴縵縿縹織繚繒縉繪綜綵纏續絹結
腕	字臏肺軍脖靛外麥蜿宛弘碗舜舛脆肢殯婉栘夕腔剜侈屍惋苑汐死豌胎
惠	栽哉蕙穗專截裁載忍戴弋鐵愚慰式團戟傳軾代
賤	貝貼淺賄賠購賊錢踐敗贖賬線殘貶則財賂棧賭貯賒賻賜賺販贓貽濺贈箋
痰	疢炎灰淡啖氮恢癆然毯燃燄熒談炒瘠煞撚熬詼燻
錕	焜棍混琨餛崑鹿媲篦罷昆皆楷揩偕陛比錫階琵
恨	娘良很限墾艱痕怛褪狠旬腿眼偃垠堰狼銀退根齦懇跟艮
贈	貝貼賄賠賊增敗繒贖則曾財賭層僧憎賜貯賺賤貽贍
簪	潛僭既蠶暨概溉慨簡簑竺威崴竿竽築厝箴筮畏猥娼
襪	蔑懵夢邁褡川薨甍順蘿癘篾厲萬襬還錨澴遝瞄描甽釧圳薯寰罟
守	寸博狩寺專宋尉射忖過辱襯討吋導未對紂時村付肘尊封
閔	憫閡門閑間閒閎悶問閃閂閏開閉閘閨虔聞文汶抆
脾	啤埤脈裨箄碑冗腫舀箠千卑陴腴鼙顰牌痺肌睥貌婢俾
佻	姚挑洮桃逃跳眺晁窕兆俳儘北邶啡排腓覜頫遣潰遺匱簣
某	芋謀宇墟嵌甘竽煤迂甜圩疳汙虛荼芣蚶五於鉗籲噓媒柑箝餘坩
澈	埃撤徹敵攸唉霰蔽敞散激朝撇流嘲挨廠潮撒邀敝俟轍遨
嫵	憮撫蕪無妳庶舞憔樵嫉媼媒啖淡借佯供併女姦
菠	波簸皮落疲被鈹破玻陂披坡蔆跛皰彼莎藻婆詖皴頗皺板
者	諸署堵屠楮曙渚薯睹箸嘟暑賭緒都躇藷煮褚儲奢著
鴆	鳴鴨鵑鵪鷂鴣鳩鵲鶴鴦鴛鴉鴒鴿鵝鵠鶉鵡鷓鷗鳶
啄	咿愜呃哂哽呎尹呀呵啣叮君籲呸啞塚琢豕涿喙逐唔
箕	簸棋淇祺琪其麒期旗欺簧箠箝竺芸甚具甘戡湛堪俱
韭	懺籤殲纖讖三辰振宸娠脣阮脣脤晨禦二行巧蟲止工虹竺桁項兆蜃示北
膏	高豪亭亳毫蒿嵩篙喬京槁搞鎬烹亮享亨賞犒稿縞嚎迥
藷	儲諸薯著躇者曙嘟站箸煮暑屠奢褚楮渚堵署睹都
是	隄堤晅怛坦匙查提題靛袒綻昌下旺昊量定緹旱暘曬但晨旦錠疸
塾	熟孰墊享墩敦惇淳郭壑廓丸槨燉爹亨諄醇鶉汍
剃	弟娣悌涕梯銻刎剎剌剔制釗利剩削則刺刮剁刷刪判列劃刖刑刊刈劃劑
圄	唔悟捂晤梧吾語伍鼯齬五圍韋敔同偉葦違寤本於畏幃衙籲合闈韓
楊	颺渣場查暢湯傷枴揚糧杳棍稈煬桿腸鍚瘍陽暘豕喳榻
王	弄玥琴珪珊班玫玖理玨瑰旺匡斑琳全汪枉玷玟瑟狂珀
煽	榻遢塌嗡翰蹋瀚蓊翁扇羿摺濯擢褶櫂曜翟習翌翼
糖	糠搪塘瑭醣唐糝米粳粒粗粕料敉籽糊糕糢糟精粉糙糞
燐	遴憐鱗璘磷轔麟舜粥鄰桀傑籽燦迷咪舛粱屎栘米糜粟氣炎
圩	籲汙迂於宇餘芋竽壞紆訏坷坪途五盂荼埂垣除某
嘰	機譏璣饑幾吆礫磯爍後鑠魂喲戍茲玄餽姒拗似鬼藥關奚畜巍
礦	碳碘磋砠礫曠壙研磴磧碾碰獷磕砝矽擴硫碟硿誡磊磺廣石
賺	賑貝貼賄謙賠賅歉購賊敗贖賬則廉財嫌賭貯販賤貽縑兼贈贍
騰	滕勝騫胖羈賸謄馱媽嗎馬篤駁駢駟駛駒駐碼瑪馳馮馭闖
呸	胚丕籲叮不呵哂砰啞唔否歪杯呀壞哽啄呃喱噤嚅或芣示痞
杈	又權
叩	卻印即卸叼叨卯呎卹唧啣腳命捌砸嗎呢仰抑迎哪孵匝昂節
姪	絰室屋蛭輊窒倒至耋緻致喔握渥到臻妍奸蛙齷
祿	綠碌錄氯剝祖祁祥祕祠祚祐祉祈祇祆社祀祺禎視緣神祝福祗禱
妻	萋悽淒棲安吏宙耍妥姦婁寰事乖使捷委妾姜要妄娶婪案女胤汝刊睫數
飛	灸久癸登疚發凳炊坎吹欽茨崁嵌羨嶔簌闕葵升砍柩畝欣軟玖欲次揆漱
捏	涅捍提揭揚撮捫把時措拮塒倡持指娼唱坦撓羯曉擱攔手晶昌
葬	薨髒苛莽薴葉蕨黃蕈蕾薑芸華芣芋荷荊茨莖豆芽嵌丁惜嘩樺曄
斬	斧祈訢斫聽昕新塹暫沂斤析掀嶄圻所芹慚漸斯折近匠鏨
屁	庇昆妣批沘枇仳毗比紕能尼妮呢怩屍花疵皁它牝叱化
壟	膀滂鎊矓攏恃龐隴徬嚨離龔坍傍聾丹襲蘢龍磅榜旁螃瓏籠朧寵
洮	挑姚桃佻逃眺跳晁窕兆潰北俳邶排啡腓覜頫遣遺匱簣
沃	奏矯澳襖祆洫嬌添妖笑舔派僑沂湊活忝汎夭洎橋躍泊吞
沒	芟殺穀夜骰泓殿殼浸涎股殷澱又役投設毀潑般殳毆候段侵毅疫
讜	誚儻談譟譙謂諾誼諒請諍誥誌誡詰詼詔訟讚讓讀譯譫譁譜識證譚譎譏
蜷	倦蜢螳蟲蝠謄蟋蜻蝓蜿螺蛇蜂踡蚱蚌螟券蝙蚣蛤卷圈蝗蝶蟯捲螃蝸蜈蜴譽眷
蘋	瀕頻傾籲鬚巔嶺癲貳擷噸顏贛澦頃頁頒煩須顯顆頭頤頡碩頓頊頌頂
忌	己已怨息厄改杞妃氾危卷卮想範凹扼呃犯屈尼苑圈屆紀桅倦脆捲
瘦	嫂痢疒瘋舂爻叟舀棣艘臼痿颼樁療病餿痺搜臾逮疼癢布疫
滔	稻蹈淫沉韜舀潟焰深淨啗浮腴臼溪湲渾樁陷滑諂餡瀉洞閻舊
盒	侖會儉仁鹽盂洽拿倫皿膈嗣盆哈翕拾命鎘監合鬲恰孟凳鑰籥猛答登俞
囂	器頡頜碩寡顎頷煩顥顯額顆頰頻頭頤頓頊頌頒頑項須頃頂
洧	侑宥囿餚淆汰賄鮪有鬱浹汍崤滯疽沮消沁沛決沐沖沃汨汶淦汝汕汁淹
駐	馭騾驛驅駁馱駙駝注馳主騎驗馬駟驢駱柱駒騵駭馴駛駢騙驕往驃驍駿騷騁驟住
睡	睫垂捶眨盼睨錘棰陲睹瞄盹目睢箠 眼眇盯綞睥郵瞋唾
囈	藝哎囌嚥嘩熱噶冽褻芸噥磁嗟咦哇勢爹茗護謨磺噤諾嘻噎嘈嗡喔唁唔
冤	菟逸冕兔娩挽晚輓免勉臭竟舜毚嗅溴沉儳巉攙
蓓	倍菩蒞葆荷部剖位荏花蒼莓茶僮億焙涪培荼荃苓陪
碼	嗎瑪螞媽馮駕篤闖罵駑驚馬磊騖駐駟駛駒駢馱馳馭駁
角	觔斛觴觸觼嘴肚奐周閒勇渙換喚煥臺瘓負醜惆啁週湧解塑塋裯榷僩
劻	觔脅動劫助肋功叻勸劬勒勘幼勤勳男匡另劾勉勁勃勛勦勣勵協咖伽迦
竭	褐曷謁意揭憶噫噶羯億暗暍章碣渴竟臆音愒遏葛 喝
院	梡皖莞陀阮寇完陣除陶隋際隱陌阻玩阡弔陛陞陪陸陰陷降陋淙階陽隆
侃	保唬嗅沉侶兄琥況克兌號悅祝脫銳兗息俗偕逞媳僎熄吮倪稅剋虎谷臭
球	梂毬班琅瑭玨求救珠瑰玥斑瑯王理玷珊珀玟玫玩玖璞琉琺玳瑚玉裘弄
棕	噤察漂糉崇際宗捺蔡檳蒜梡蹤標賒襟嫖淙鬃綜膘鏢瞟
顛	巔癲碩頊頌煩頂真願題顆頰頻頭頤顫頫頜頡顯頑頓頒項須頃
面	政靦麵覃毒票肯市靨母迪歪姆步柿焉緬芷每拇逮怔止亦武偭湎症衷正
懸	系糸縣喲絢紲純係約戀愁累索鯀縐潔細孫祕慼願絮您紮素紊蓀纂縈瓜
備	傭佯僅俑供併首道僕件借儀用傀俏俄侑伴位伯作佚伕任仟化偌奧向
佔	倍貼點店儕沾佔帖乩拈戰僕位玷砧黏粘偯站儲停住
証	訌評訶訐訏誣訂訃詛註訴訝訢訕計怔語詠詞詁詐訪訣訥許該詳誠話誅
蛇	蜿蟲舵陀沱佗蛄蝴蟲蚣跎蟠蚱蚪蚌蜆蛤蜂蜻蜴蜷蝶蝠蝸蝙蝗駝螃鴕蟀
晴	倩請猜精績債蜻磧情菁積睛責清嘖蹟鯖漬青靖
頑	頻穎顆頂頃頹頒題頓頡順頤顎頌頭顯頰頸碩顓頊頫領預煩須頁頷項頗類頜
墮	橢隨隋墜塑陝肚周史弔陸凋陞陌阻壓雷電堊病肯圭左臺塋蕾薹角鄭擂
譚	潭撢罈訐謂語詰誣評訶訏訌計訂蕈譁譜識譙謨譯譟謠謀諜諾謁諭諳諼
螃	磅膀鎊榜滂徬傍謗蟲旁蝙蟀蟑蠔蛀蚱蚊蚪虻螟蝸蟠蜻蛇蛟蟲
封	寸守涯寺恃痔卦尉持娃奪射忖掛圭佳峙窪畦桂等蛙崖吋特對侍時村付肘
武	芷企賦扯址祉啃歷止趾肯歧歲正鵡症步焉怔遣瀝壢
喜	熹嘉嘻僖嬉吉禧臺袁膳譆豆培繕鱔壹售告周敬鼓桔拮圯
芋	餘宇竽某荼於迂汙圩籲芣甘紆媒煤芽盂苛華五訏途
劾	刻咳垓核閡孩賅骸伽氦幼該駭亥脅劫助肋叻迦劣
鞍	革靼鞣鞋鞘靶勒韁韉鞅鞠靴鞦韃銨按鞭韆緙霸
爬	抓杷肥把吧靶笆耙芭疤邑爪巴爸梔扈琶葩履艱浥復
吮	喊吠戊哺侃唬嗅兄咱唆唉嘰鹹茂息吵聽吧吻吐吋吆吒咄咆呼咋況叱叨
歉	砍謙歎玖葵廉撳欲嫌嶔次欽歟賺炊疚坎畝縑軟吹兼歌欺欣
兗	袞況祝兄兌六悅脫銳競閱克侃稅蛻說嗅鋁冥剋滾
屋	室窒姪喔握渥耋至倒絰蛭輊致到緻齷匡臻套刁蛙司肆
潘	播墦幡繙蟠審蕃番瀋藩稞逶倭禾溜矮悸透穌鍬揪愀啾痿萎秦
掣	製制前箭刖煎湔削刺剪鬥涮刷奧痢莉捌俐向梨犁挈鬧鬨擊舉廁荊簌爨
詳	訏諾羊訥謙謀諶詢謹訣許鮮託記洋樣詐誰討訃羣詁計詛課訊訂訐註訕誚謨訑譜
榫	樵椎稚雜憔鐫進錐淮推惟堆唯隹準崔瞧礁睢碓雉雊雅雄帷準離杵截奮
攤	隹懼雌雁帷難歎艱擢僱暹罹匯蕉催雉坐癱濰藺嘆羅璀漢灘推摧籬銼 挫
瑜	喻玳瘉班玫輸蝓癒逾褕諭玨玲渝斑愈偷愉佺珍榆俞
惻	測側廁則貸貲貨鋇員濺狽費貴責貫贊慣貝賀買賃貢賢
蜒	延誕
眩	矓眨鼎瞑瞄炫目瞇睜瞧玄眼睬眠弦睛絃畜眸鉉瞞瞳舷瞌矚蓄睦
僑	奏矯犒蒿祆稿沃嬌鎬添妖嵩轎笑吞舔搞縞篙喬槁驕橋 
汶	抆文玟汴泣注沾紋蚊濟吝虔閔滴淑斑斐雯涉滷沆流涼液涪滾漓憫紊
痂	茄咖迦伽加努脅另叻男爻瘸力肋癡癖架勇勢劣奩荔協劫助幼
霏	霞霽誹霜雨霎霪霆菲霰霄徘匪罪悲雲非霹排靡俳輩徊霑屝痱啡雯雪腓扉霖霍
姅	拌伴胖畔半絆妙滕拳倦捲勝圈蜷踡謄賸騰判卷券眷
妍	研奸開荊邢姪刑硎娠形厝姍姐如姘嫣女姦華妒妞妙妖妓妊姑妹姓妯姅
剝	刊釗利剌制綠刈錄氯列削到劑副判刪刖逮剎剩碌劃祿刺剁刑
諒	詔諾譙晾京詼涼談謂謎誥譟諳謗驚掠讓諺訟訃詁訪識謫該諄註景詰誚詨誶誡譴誌諦
贍	貼貝賠購賊贖賬蟾簷貶則賂賦貯賒賜販賺譫賤貽擔瞻澹贈詹膽
飩	飽飪飲餅餌飢餽飯飼餃餉蝕餓餚飴餒餞餿饉飭飾餘餡餵饒
憔	樵瞧礁惟蕉譙醮焦憮榫懼鐫錐雊椎進推淮堆唯隹罹崔
餾	遛榴溜瘤餵餽飪飢留饅餞餡餛館饑餒餘飾飴飭餿餓餉餌飯
文	吝抆汶玟紊虔閔紋蚊憫斕大卜迦逖斑雯斐交送逛遼
唬	琥號虎噓噱侃嗅彪遞墟沉褫濾據擄璩遽瀘爐臚鑪瘧
焙	涪培倍陪賠菩黯煜競暗接噫粒泣拉垃位立笠昱
遽	璩據噱邃豳逐豚豕劇豢豬豭瘧濾擄墟噓琥唬瀘遞臚爐號鑪迢鱸
拎	掄捨令零泠齡聆擒蛉羚捻吟玲搶撿鄰拾鈴苓拖領侈唸憐鈐黔昤冷岑嶺伶今多拴
汀	打叮河釘汽丁仃盯汗汙汪洌訂酊江沍洹佇可歹薴
嗇	薔檣穡牆茴迴稟蛔徊佃回堆個俚每圖鄙偎懍儡玫獸
樣	善儀羊議義構鱔鮮永曦泳漾詳姜洋蟻繕模羣權犧膳羨羔樽栘對窯詠糕美楛恙槽
黜	點默黠絀黔黯黷黝拙咄黑茁屈嘿出墨壎微勳掘崛倔裡黛窟祟
煦	啖照句苟炎京鉤談枸拘佝煮熙疢炙傑灰景包雊晾哨炮咪狗吵
併	姘拼胼迸鉼並井屏阱耕佯供餅駢借媾搆溝構遘
鎢	塢嗚烏鋁鉑錘鍾銖銑鈑釩鉻鎚鍬薛銷鈷鉤鉍鈔釦釙叔鎳錦鉛阜
報	服幸悻倖圉睪擇澤繹釋鐸譯驛候腎堅捌緊豎賢
牒	片牘碟喋牖蝶牌版諜葉洩紲世屜溧慄亞惡患霖
陴	裨婢埤啤脾牌俾阡碑睥痺箄陲阪卑陞陣防隍降弔鼙顰
筐	框眶匡篁斑班王玨痊荃凰湟隍惶煌遑逛栓銓拴佺
澀	瀝沼徵汾正濯潔潰潯漏涊証涉政怔整症歪濫壢遣滅溜魑渥減淺淚疏啃
氮	氣氨氛氧氤痰氟氖氫氯氬氳氦愾炎淡啖燄毯談
冰	次凍準冶勻馮凋冷凌凜冽臧凝汞亟茨均昀鈞藏
式	氐玳貳忍鳶代拭瘧膩試岱弋惠三左二軾弒些旦底
懵	襪惜忱買懂慌愣夢懷邁瞞滿怖薨甍厲蔑萬蹣懼錨憤慣瞄描枕沈癘蘿席
偉	韓度違葦本儉緯圍梧伺幃拿吾悟諱闈笨捂韋缽晤韜衛合信休伍韌苯圄唔
發	廄瘢廢潑撥搬澱燬鍛緞醱殼轂疫芟股投癸灸久殿殷般段沒
為	夷犬九癬畎姨咦胰痍吠你旭伏仇尤友丸突畚疚戾臭妳哭究莽偽袱鳩穌
頜	碩頡頷頭頊煩頂頰頻頤頑頓頌顆項額頃顯囂頫頗領頸頹穎預頒須題顓
痲	麻腔潸控崆倥摩穹空穴硿搾搾嘛挖窠麼磨窄突糜簾究魔奔竇鉛邃
嚀	咕獰喻喀檸阜嗜亭碗哮嘲吱嚏喃噴寧味詰濘嗦喧擰
覃	蕈潭撢罈譚草章早票會儈膾燴檜璋劊瘴卓障獐漳漂幛嫖膘標樟蟑鏢繪
盎	央鴦盅盈英映泱怏盔盟秧益盍盛盃扁盜盂孟監盤盥殃柵姍瑛鞅
叫	吆糾赳呶收妯民吳叩吐壯妝呷戕喙嘯嘰嚷口品
坤	埂樓屢甲簍暢呻摟婁砷嘍圳褸鏤由申紳伸賣神
岔	忿盆貧分芬吩扮汾份粉氛刀初叨紛券招沼昭炤迢切賴
犢	櫝瀆續贖黷牘讀竇特牡賣牛犧犒犄牴牯牲牧牠牝看
樅	御徠很履律復眾彬屐榭薇徇覆蹤屨徐癥徉從聚徊徒微杉往衆縱叢桁驟徙屜
筍	苟笛殉洵竽詢絢怛麼耆託徇筷箸吒旬筆笮昏笑策簫宅笨竿笆恨笠忽竹荀
闔	侖盞閣藍閒籃閨嗑門閏磕關檻開閎濫監盍閥襤瞌尷豔鑑溘蓋
揆	睽葵闋癸撥嶝澄橙燈瞪磴證蹬欽炊坎吹撳登疚
罐	歡勸缶觀鸛缽缺缸罈瑤遙榣搖淘陶掏啕萄唯謠罌罄
鱗	鰍鰾磷鱔遴鱖鯛燐轔鯧嶙粼鯨鰓鰥鯖魷璘憐鰻鰭麟
鉚	柳泖聊茆卯卿留溜遛榴瘤御劉迎抑仰貿籀腳孵啣唧餾節霤昂
傀	塊愧槐鬼蒐瑰魄仞魂俄作伯件任餽魏仟幾醜入麼
宣	富渣晅宇萱宗奭洹桓渲楦士恆垣亙量百暄三喳賓旦宿喧完
喔	握渥齷屋至姪室囑致叼到窒呢絰蛭輊倒耋臻緻嘔套
俟	唉埃挨俯矣攸族伐倣做傚傲俊嫉敏矢廠伏撤澈蜘今
臆	憶噫億幛暗意樟漳璋鏡幢獐障境黯瘴音蟑諳竭章
桌	困牀痳朵綽釆宋木某柔晰森卓淋樂柴樑林悼掉閑柒沐呆退栽採集杗杲棹
箴	緘鹹鹹減喊戌後麼威逅垢竿竽答笞筒滅筮崴簾乏箋簽竺籥石戊
莆	脯浦捕埔圃哺補匍鋪蒲甫博傅溥搏膊輔葡誧芾縛賻
鏗	鐵驟鉅尿分鑑鋸醫聚忿岔鐃鐫鍍鑄錚銓鉛鑷逵涅汾扮吩份法匯金貧盆
掐	陷餡
屢	匝樓履髏鑒甲螻簍呻坤摟婁砷縷屨嘍褸鏤由申紳伸匣神
謄	胖請倦訥勝詢訣詼談謂諍蜷詳詐賸誰券訟訃卷謠詁計詛課騰滕註訕詰誚諼誡譽眷誌
沾	貼點店涼注泣佔帖乩拈戰淳霑玷砧汶濠黏濟粘站汴
楠	喃南植柵梓枯枝杖檻棲楮楛樺檸皿冊卅梢柑相林杵枓姍肺桿沛楹棺棕
掙	崢淨錚猙睜靜箏諍採爭探授揮援搖撚捐掘掬深揉揖換摒揹浮持搽搏睬
噶	藹靄喝歇葛噫竭蠍曷嚥哎嘩羯褐碣暍遏愒揭渴囌
羈	罵騫騰霸羅罹罰罪篤罩罟馬馱馴媽嗎驚闖鞏駕駑置買眾驛螞駢緙碼駝
灑	欐曬儷驪麗邐鹿鑣混麒沘鏖麓麋塵麂毗麝麟能沅沉比枇批妣仳昆庇屁
桿	稈焊捍悍銲趕楊查旱桿杳幹棍渣喳幹糧橄岸袒桓榻怛坦但肝汗奸竿旦
爵	嚼蘿寰夢環還澴篾薨甍蔑籮遝楞儸鰥玀愣囉邏鑼
遮	摭蔗迨棄庶械拚戒弁踱誡鍍渡獷擴壙曠礦述鷓率度庠充
失	佚迭秩跌軼夫牛牧伕件牟扶牢牡芙替鈇生毛我推
塞	異巽寨暴拱鎰鬨港卉搴供哄嘶廝共騫隘寒烘賽溢恭基洪撕
做	故估傲攸傚倣俟嗷橄啟敬湖瑚嫩撇撒糊遨瞰邀擻枯鈷咕姑沽族唉個苦
渙	觼澳泱湧襖瓊泓喚沒噢邂懊瘓漁瀰煥懈汛踴勇奐汐燠換
司	磊石巖拓匡泵刁伺祠叵峒恫洞桐砸胴銅筒後言矽哈恰拾洽砂砍研砝砠
詣	諧諳譜識訛訕詫詰詼詔誌誡誥談諉諂訟訖謁謂謨詢詐託記計訃
巫	筮噬誣仄雁靈夾坐來丙卒俎蒙佺柄炳俠峽座挾挫準浹病莢傘萊銼齒
遁	循盾道迫追逅迭近返遍逢目千貫亢逍逆相肺迅沛仟遑楣遞逶湄慣媚造
虻	蟑芒蛔蛀蟲螻蠔蛭蛄虹蚱蚌蛐蚜蛞蚵蛾蚣忙蛙蚶蚊蚪蚓蛆蠅蛟蟀螃亡蚯蛛
而	耍耐耑湍揣惴喘瑞端踹需串儒濡懦嚅燸帚顓糯
湲	援媛煖暖鍰緩諼爰洞溪沮渾淫深淨滔浮沉滑濛助
傘	萃瘁悴淬碎粹卒什午從誶醉聚翠俠儉佺估仗眾慫聳傖偷傷倥倫儈侮佬
散	撒敞敝敵霰敬畋枚蔽敢敖敕敗啟敉故數牧玫改收撇矢疾廠矣
匏	瓠袍砲炮胞鉋咆抱泡皰跑飽鮑苞庖雹包誇胯垮
轄	轟瞎輻轉車轅輯輸輳輪軾軛軻軏軒軋輾轍輜轔轎輕輛輔輊軸軼軟軌輒
穡	檣牆薔嗇稱稜程秒稚稞和稠禾番黍穢穠穗穫稿稼稷稻稔稈稀嵇移稍秣
謊	請諾謀謙講謁諶諂談諉謂諍詳諳誼慌訃謠護謐諄荒訕謨論誡譜諒譁諜諦
兆	眺貴佻跳洮潰逃桃遺遣非窕兀挑姚簣北覜匱頫晁邶齒盡
鼯	唔鼬梧晤捂悟鼴齬語圄吾伍鼠五竄敔遣誥違詰詔寤韋
聖	呈鋸倨逞望居窖程誥踞衽妊任薰壬皓造浩燻廷
殭	疆彊僵韁薑
琢	玥王班珊玫玖璞玩理玨瑰斑啄玷頊塚玟豕涿逐珀
示	齋杯崇棕宗捺票仁雲壞標芣禁元祭不竺三淙否奈二祟痞禦
鰻	鯧鏝縵漫慢幔饅蔓鰭鰥鰓鯽鯉鰾鱔鱗鱖鯨鯖鯛鱸鮪鮭鰱
賓	儐濱嬪臏檳殯繽鬢富宣宗完寅宇士湯寡容家室定穴
宿	察縮會萱痊荷輪輸奭丘佰儈倫荼荃陌全答偷蓿百途宣合幹餘佺喧弼栓
韁	革鞭鞍薑彊韆鞣勒僵鞠鞦韉疆鞅鞘韃鞋靶殭靴靼
令	含泠貪齡聆拎羚念移玲鄰夥鈴苓栘領侈爹憐昤冷伐嶺伶今多
悉	乎釉呼蟋釋釆竊米慰掬愁屎懋迷咪您息思怎想粱粵忝忠忽願芯志懸粒
鰾	縹驃鏢瞟膘標漂嫖蒜鱖鰓鯨鯖糉鱷票鰻鰭鰥鱔鱗鯛鯧襟鱸噤際賒綜棕
稠	惆調香秋雕碉程稿秈禾稱穩鯛番週稍稚穡稻委秧蜩啁凋租綢和私周
誧	誚誠詁詛詠訥許討訊訕訐計訃誡誦詳話誅詢課誰註評詐訣記託訏訑謫
絳	絡終綾降烽烙縲峯線鋒繙絲縫蜂綿編駱總級紙扳糸
脤	振娠晨宸賑震辰脣脣蜃膿胯佞三脹胚肝肛甚韭直具農冠
惡	堊亞啞氬患蜇恐背片惑悲慄要串揹慄粟忠介罹冀薨工溧牒腰遷怔融隱
誅	話詐硃託詬詁訴課諛訣許訢訐討訕訊訏訑計訃諉
玨	班斑玩琢頊王玥枉旺汪理玟玫玖玷珊珀狂琪瑰瑾珪弄匡全
頌	頓頊頒煩領碩頡頂頃頻頤顆顯預頑須項頜頰頷頭類顛
補	卜博捕莆誧哺撲蒲輔樸傅搏僕甫賻圃鋪溥膊脯縛匍浦埔
蔑	篾夢甍薨蘿寰籮遝澴還楞愣爵戍環襪鰥儸囉邏鑼
飪	飢餽飯餉餓飩飲餅餌餿飼飽餃蝕餚飴餒餞餡饉飭飾餘餵餾饒饑
瀕	蘋澦頻傾擷噸貳籲顏頃贛嶺巔鬚癲煩頒須頁顆頤顯頡碩頓頊頌頂
黔	鈐吟黠矜默岑黯黜點黷黝琴伶鈴捻唸玲泠拎稔聆羚冷黑苓今
靴	鞭仳革花鞦靶訛鞋勒鞘靼鞍鞣毗枇沘批妣韃韆鞅鞠化
倭	逶矮萎痿諉俐委墦播潘禾悸透幡繙蟠穌啾愀揪鍬秦審蕃
痞	否奈芣示不杯壞左痘宗甭盃奇痙票祭禁祟禦癌誇病歪蹙癡痂平丕滅捺
贅	鋇貸側熬貫賃貴賢贊員賈賀敖貨資貿費贗鼇責貲貢傲買遨狽聱
明	冒萌暉暖暝曖日曰暈朋月昌勗晶閒盟厭旺玥映昨昧胡晌朔朗朝晴帽瑁
麩	麴麵麥伕鈇趺扶舛芙乾攆傑侈夫舞窺俑替桀規佚承夕輦摯舜宛多令
正	政徵扯肯企懲址逃整遣啃狀証下證祉歪嫣焉步芷怔止武歧症
漱	嗽簌瀨掀嫩喇羨撳速悚欣柩獺懶蠍辣澄束久嶔嵌崁茨
雀	隹維仕淮推惟崔堆唯售集進焦椎錐濰坐佳帷雄僱隻準雉雊稚碓睢匯催
嘀	嫡摘滴適鏑謫咬商六唷嗚咳啼嚎啃吭嚨噗詨哺哨哂哄咱咀吶吐滾嘴噓
瓔	櫻嚶纓嬰罌瓚環琛現璦瑤瑁琿瑣頊玨玥斑班瓊璿璃璀瑞琨琉鸚珊
訥	許誰訣討訕訊託訏訑訐記註詁詛詐詳詢計訂訃誚誧誣課諛謫訖詮論諭
這	唁信譽誓譬警言訃諒諄誶讓謎卞訕計譴逗訟詔訖逼違詩詰詼詣詫試詮
葷	暈轟運暉渾揮蓮琿輝軍漣褲鏈車攆庫連軋鰱菜載輦軸軟輞軒軏陣軌
邪	牙雅琊鴉呀芽穿蚜邢邱訝鄴邦那邵祁鬱郃郎耶郢郾鄭鄱
肝	桿汗奸幹罕旱竿軒訐鼾橄瞰且同肛胚敢捍悍焊桿銲刊胴岸
翕	命歙羽合栩盒拿羿扇翔翎僇翅翰翮翻翁蓊翼翌習翟翡翳塌嗡煽遢榻摺
錯	慕芭臘鵲漠鎰墓昔惜厝膜糢鉼措鎂摹獵草莫鏡摸暗萌模借寞鉗暮醋音蠟錨
濛	滇漕湛矇湲漠濬瀟且朦港濩洋湔檬漢淇溯濃澧沮濡蒙溢滋灌洞洪滿溝
膿	濃噥儂穠農體澧禮遭槽醴漕嘈胯脤遵樽膘撙甚
總	傯縲繙絲窗編線綿絡絳終紙繒纏絃紹紛綞細囪糸
圾	洛扳烙閣咯板阪珞各伋鈑殼吸皈返恪及汲叛冬岌降反胳級坑坎極坡咚格
譆	誌詩讀嘻嬉僖譟禧諾誥誡詰譜證譙識譁謨譯講謐謊謀諜謂諳諱諒談諄
綱	組絀細剛絹緲網糸緩鋼岡紀縲綑綵綬綏納崗絲綢紲純
恥	聊取揖聶楫聆聳耶聰聘弭餌聯聒懾職耽耳洱聞耿茸
縱	終絡履繙緲絳緞繡糸線維紗蹤紕樅糾編綿從繳總縲絃紙綁納綞絲衆叢
礙	擬凝癡疑砌磊矽硼硎歌砍磴碳砭石磯確碩碌碑碓硝硬硯硃砧破砠砟砲
體	本骰醴骼髒嶝禮橙磴壹髑骷膿笨澄皚澧骯愷瞪燈髁
鉑	錦迫柏泊拍怕伯白粕珀帕腺泉舶遑煌嗥湟棉惶葩篁
毽	腱健鍵建毛毯毬尾梃挺耗奴撬橇娓艇蜓涎肄馭屘氈怪筵筆肇髦麾氅庭
各	洛絡扳烙路咯閣板珞骼鈑返恪詻冬賂反胳咎駱酪鉻貉咚客格略
胛	柙押呷鉀甲匣狎胭髑曼閘賣腮獨澤濁擇燭曙觸鐲鐸申薯爵
嘉	喜熹茄咖加臺袁吉痂嘻哎迦伽荔架僖嬉壹豆另禧叵叻
佞	仁偎圬儂喂煨僵誇二猥虧餵辰甚合三祭佺僭倀娠振脤堪湛戡侖竺俞
矢	知仃矣枚畋矩疾雉收攸改玫牧故俟敉挨埃唉敝敖啟敕短敞敢散矮癡敬
速	悚束辣喇漱嫩嗽簌敕剌獺瀨懶秉癩籟棣柚賴逮迷迪迂迆違乘卜卞
瑰	魏琍塊玥王球珞班珊玫槐玖玻愧瓚魁理珠玨斑魂瑭玷魄傀玟珮璣現醜琅鬼珀
壎	勳埋墨黑狸黠嘿點黜默塊塢貍埤垢坼圻黔墦黯黷裡黛
晶	昌娼唱倡猖暘暍曝鯧暗日曰萌間昔杳杲旦明汨旬
共	異益巽寨暴拱並鬨港搴供哄寒烘恭塞基斯巷洪
芳	菸房旁肪枋妨坊仿防瘀遊方彷紡倣淤遊簇舫訪漩嗾鏃
用	豐胖夫羊桶月湧擁俑冉甭且半備傭手目丹年牛甬皿恿憊聿甩痛耒內冊通
弟	剃悌娣涕梯銻阡第弔阪陞陴降引郝隍陲邢邦那防阱阬祁穹邱陀阻陂耶
捉	促足齪蹙趺趴距跚跟踝躋跆踐踏踩趾跋跑跌跤跦扣跼踫踞蹕蹼跎跺踱
闢	劈薛僻滓癖檗瓣霹辯辦辜避辨壁闢璧臂聞薜辛辮擘
臺	薹檯吉喜袁嘉熹啁肚豪高亭售告周碉涓桔捐娟拮圯
伍	唔悟捂晤梧圄齬五餘吾語途鼯荼仁除佰徐本於
剌	喇束刺釗利劃刖刈剎剃削刷制剁判刪剩刑刊劃川劑
礁	碓譙樵憔瞧醮蕉誰唯磊確雊焦雕碳雒石磴磋碾磕碟碣礫榫碎硿鐫硫砭
會	儈檜燴膾合僵拿俞侖劊仁盒命偭佰繪覃佞翕量黃蕈餘全丘僧撢潭佺
毒	每拇姆母素青莓侮海悔梅晦責黴誨憲面害菁倩清敏猜情偭湎晴甥毓睛
際	察蔡賒蒜祭膘瞟棕淙捺襟綜糉漂嫖標噤縹鏢鰾阻崇
炤	紹昭迢沼招貂超韶詔召絕叨初刀券分解賴切忿岔照
詢	訏訥訣絢許託徇記詳詐誰討訃詁計詛課訊訂訐註訕誚訑殉諜
慶	恪反憂鈑處鉻優擾略板返扳各冬皮及囫稷鋒綾殿稜賂酪鉍鈹痠絡絳菱
肺	脖沛芾脯肢朋悖荸朝嗦嚏甫孛腔膊宜軍索囊肝肚浦捕埔哺補鋪腕臏潮
斟	科湛辰諶農堪佞甚儂魁鬥芸勘膿抖蚪戡濃其料斜噥斛枓
疆	薑彊會票僵仁圬黃紐羞虧垣忸量殭扭三二喱畫醜韁鈕妞
澡	噪湣浥保燥涓譟躁棠沼泯沿潠葆區操吋褓況呆藻橾品涪浩澠灌渦治癌
咩	嗟羣洋佯烊詳磋羋羊庠祥鮮哄徉嵯搓差哎蹉氧羼
跋	鈸拔跆踐踱足距跚跟跤趺踝趴躋跑跌跛跦趾紱跼踫踞蹕蹼踏踩蹊踟
戰	獸器闡呷貼毋擋檔哭找踐沾輔弘佔帖嬋禪咽褲團蟬簞戟玷憚黏彈粘嗶站單戢噹軾伐福哩
接	撞拉妾啦霎涪培焙倍暗泣垃位立笠昱陪幛漳獐境僮障憧樟幢潼璋億賠
羔	羹恙美姜窯糕焦黑義羲善對羨蕉薰苒炎墨膳燻
襟	噤棕蒜禁標糉淙捺鏢膘際漂嫖崇縹驃瞟鰾賒綜蔡察
胃	胄冑渭喟膚田月思有疊囿朋畏肩脊青骨肓育男異閒崩受盧明困棚回因
熙	巳叵炎毯圯照煦巽疢巷炙傑灰癌局包啖峭炮祀咄乩叱加
波	洛陂破板皰彼玻菠疲汲皺跛皮被詖披鈹皴坡婆簸格頗 
誚	捎哨訏訥俏銷評詢誧諫訣許談託讜記詳鞘悄稍詐誰硝睄討訃詁計謫詛梢課訊訂峭肖消訐註訕帩訑
奧	噢懊澳燠襖向奐制筋爨釁自血然爻瘓央胰肱肋
墀	遲犀囑屬矚堰汴卞墟壇壕堤場培堉壤娓鐫坑圬垃坍匪土屝圭
義	儀蟻峨娥哦俄議羲我蛾餓羔恙美姜對羨善羹鵝曦犧
負	鋇貝貼貫賄隕貪貴贊賊盼員敗賀賬貨費目則財貧責賁賒損貞賤貽圓頁狽
貍	貊豺豹貓貂霾貉狸裡鋰理浬娌埋哩俚鯉嘿童墾
宋	守未朱十妹味沬昧宇字栽案木株呆牀安杲採卉穴茱檗森侏林銖魅
農	湛辰堪佞脤甚儂曲斟振禮曹勘脣宸膿娠戡濃澧晨尊穠噥
恬	憩古闊甜亂話舐刮括愧怕必聒舔千恤蛞性管颳活舌
氛	芬份氨氮汾扮吩氣氧氤氖粉氫氟氦分紛忿岔寡氯氬氳
笙	產星牲性姓生鏟甦猩惺腥旌甥隆笮笑薩牛猜拜剷醒
腑	俯府胎付棧膊肘咐符腐械附淺挨埃唉賤俟錢私寸冠
哥	砲砍後破融砠恫郃拓峒隔磴巖砟砝矽泵柯哈拾可砧訊問嗝桐鬲恰胴歌磊砭司石
間	門閑閒悶問閃閂簡澗閔閏開閎閉閘閨聞閩閭闆闌閥捫們
蜊	蝌蟠琍俐蟲痢莉蛛蚱蚓蛾蛞蟋蟲蜓蜥蝦螂蜂蝙蝗
酋	奠猷猶酉共酒鈿酊洪拱哄配酌烘恭供酗異基酣酥曾醋醜醫
吳	吆喀奴咯唆努虞吸誤怒叫又駑弩蜈帑碌喙咚呶娛
稈	楊稼科香秋秤程秈禾穢稱查銲番悍稻委焊穗杆桿旱幹租捍和趕私秣秒軒
判	刊別釗利刨制割剋刈半列刮削剁到叛則劑拌刎刷伴絆刪刺刖剎剩劃剃剌拳刻刑
紂	絲縲約紆細練縛糸紀紉紗紋純紐納糾組紱紲絆絀絢絰維繡絃絨綵緯綑
壅	甕雍擁臃亥妊牽圭造逞垓畜望玄壬逵核珪咳褻閡告呈亡嬈衽娃卦劾刻
箱	霜看楣自相眉櫬目苜媚親策纂冒睬廂瑁睏省篡帽租臬湘算想湄
廊	榔螂瑯郎參廓鄉爺晉弔殘梆椰慘挪摻娜哪滲擲
榦	斡幹乾翰廾韓朝戟休咻茶斬潮嘲廟輪輸聆保付漸慚咐嶄宿符府
沉	淫滔侃浮深淨溴臢唬渾湲琥溪混滑號況洞息渦媳熄沮洗虎臭
鍵	馭蜓奴毽鈑涎釵肄梃肇筆健又建挺庭津鋒誕聿怪筵鈹隻腱鉻帑雙艇
艮	娘良很限宴墾艱浪痕褪狠食腿眼偃垠堰狼銀退根恨懇跟
餚	餃餅餌餉餽飪飯飩飲飢餒餓餿蝕飼飽饉餞飴飾飭
購	遘構溝搆媾講賺貝賠賤賊貽贖賄賻賜贈贍賒賂貶貯鉼貼敗財則
柔	揉蹂鞣禾乃香委梨笨番策懋箱秉秋秈和私穌杲採牀宋呆釆朵閑孕森矛
僱	僱偏作催邀摧璀褊遍暹唳捩淚懼昨柞炸咋妒倣匯笮籬
嶝	瞪澄橙燈磴證蹬愷皚登睽澧壹揆禮醴體凳鄧葵豈
甥	生舅虜牲性姓笙星惺腥擄產猩鏟男甦隆旌醒拜猜毒
悸	季愀悖透李籽莠脖浮倭逶矮俘誘播幡潘墦俐莉痢秀
蜆	視硯現峴蟲覜規覲筧莧覓蛆覦靦覬觀覺蚱蝸蛇蜩蟲
汙	圩籲迂於宇芋餘竽汗汪紆訏江沐河洹途五盂荼
挨	埃唉俟矣撤拚擡找撇撒擻嫉摭矢廠族摻擴敏攸澈蜘
鴕	鳥鴃駝沱佗跎舵陀蛇鳴能鴣鴨鵑鳩鵲鵬鳶鴒鴆鴉鴿鵝鵠鶉鵪鶴鷂鷓鷗
瞼	臉儉檢撿險殮驗鹼簽瞪瞧睢瞿洽拾恰哈瞻矇瞎瞄睽睬睛睞盯目答
平	抨坪枰砰秤萍不評示壞否杯芣丕炭宗奈甭盃痞
固	個涸錮箇古咕姑居沽估枯苦鈷牯胡罟湖葫毋做蛄瑚糊骷
顰	箄睥痺頻碑脾鼙蘋瀕裨牌陴婢埤啤俾卑頃頁頒傾須
承	夫了孓芙扶伕替鈇失孑亨推麩予拖牧拾拴沒孜佚迭挫規趺孔撫輦擊闋
蜈	娛蟲誤蝦虞蝸蟬蠅蟲蜂蛤蜿蜢蛉蝠蝓蚣蟒蟆螺螳蠔蛔蛄蚊虻蜓蜘蚓吳
葉	喋碟蝶牒諜世洩芯葬菜茶藥紲棻蕊蘗菊荀苟茉苯芍
湍	涔而淪需瑞耑揣燸湔渝儒沸汕耍澴耐顓清嚅端懦踹灞濡溧惴喘
準	雀奮隹焦僱住碓蕉匯唯戎維榫催坐售仕睢淮堆稚惟椎錐崔隻集推瞿雙截進
儉	僉險洽儈籤撿倫傷瞼傖驗哈簽拾侮臉偷鹼檢殮合恰佺伶答
達	撻躂韃羋羊主烊洋咩佯逵差庠遂詳進祥逆送迸迭鮮柱注拄坩住搓嵯嗟
撙	樽遵蹲尊持搏描特槽遭漕嘈耨褥糟傳時恃峙狩侍蔚團
擄	虜據濾瀘爐臚鑪驢鱸甥慮膚廬舅蘆噱墟璩噓遽琥唬盧瘧男
馨	聲磬罄痿秦香毀蕃審萎莠疫芟痢穀矮殼股投鰍鍬燬穌潘播墦骰殿逶稈
研	硎磊砰硬碩礪石砠妍砂砍斫矽砧砝砟硝碰碘碌碓歌磴泵
耦	藕遇隅偶寓禺邁愚癘耜耕耙耒耗柙耘耨萬揀禹厲
潛	湣概慨澗漕湛涯贊僭蠶洹汀娼替溉汙涇沅湮源沍汪涅濃潭沔暨溼污既汗簪
鈉	吶內納錐訥谷銼肉丙傭鈐銓鐫鑰鈇欽鈿釦針釙榷銷炳柄鈴裕浴峪俗鎔
辱	寸守褥寺辰專尉射振忖牙耨脣耐討吋對紂村付肘晨尊封震
閘	門閑間閒悶問閃閂閏開閔閎閨閩聞閉闌曼甲鉀胛柙押呷匣
洸	恍胱晃光幌輝消沙沅兀淌淡耀汕洮元洶洹洎河況沮泡汪沐沌汨沖沂涵
徒	待越徠很御徵徜趨行徹律復徬彼趣徇起徘趟彷陡徐循徉從徊彿微超往徨走街黴徙
琯	棺倌綰館菅管官瑚玨斑班珪瓖耜瑭玷王琥琛琦瑞瑁琿瑛瑜琉珞瑤璋璃
煬	暘楊腸揚場鍚暢陽瘍颺焊煜焜爆傷炤豕煌湯殤緹袒怛坦觴但鯧豚逐豢
滯	滿鈽怖佈棉瞞啼錦帶希綿締飾蹄蹣怏忱砸巾蒂常席布
尺	呎咫家屍人敖僱傢嫁熬放於傲嗷僱肇稼遨聱邀
壬	告任呈妊衽丟廷浩荏淫逞造燻薰先庭挺望梃皓程窖聖靠
蹉	嗟蹣磋搓嵯蹲躇踫蹼足踱踐踏踩蹶跆躪跚趺躂躑
蘆	廬臚爐瀘鑪驢鱸盧膚濾慮瘧擄顱虜墟噓藍蓋蓑菩虛琥唬
揹	背驥挑冀捐排啃擰採搔蜻隱穩拽抽扯扛惡揮援晴探掄授掙搖情清猜睛
慾	欲恣吹容谷歌裕峪浴砍俗壑蓉榕熔溶鎔卻慫您嶔久撳歐腳欽
斛	角觔觼枓抖觴觸斜料蚪科魁斟嘴鬥斡肚蝌奐陡垃卦換湧渙喚煥解走閒
鋇	狽員貴貫貨責贊鑽測濺惻側貝貲賃賽費賀買貸廁貧貢
我	儀議鵝找哦牡牢毛件生牛蟻拚蛾娥峨牟餓俄失義擡
疒	瘦病療疼癢
岫	妯抽油柚迪袖鈾由宙笛軸釉冑胄鼬娉聘曳申婁
艱	難歎跟漢嘆銀齦退根限恨很垠眼狠灘攤痕癱艮
澤	呷鉀柙狎曙擇胛圉鐸押鐲閘澴倖悻濁繹釋燭睪匣曼幸賣驛譯
骨	猾滑萵亂棚過骷朋辭受骯鍋崩髓胴媧堝渦硼愛髁
茆	柳泖鉚聊卯卿留瘤溜遛榴昂節籀貿劉霤迎抑御仰孵餾
漩	遊淤旋遊嗾倣鏃枋肪妨坊仿房芳防瘀菸簇旁訪紡舫彷滂礎疋方
囑	唷育嗨遲哪迨叼嗎卞呎碾呢職硫唳叨喔屬啡汴矚墀叩犀嘔囁砸
狀	獸戕壯蔣獻蟲哭妝獎默畎將鏘吠寢伏戾寐突莊臭犬莽牆猷
傳	磚轉團專傅侍栽博狩付咐附符府搏溥膊撙俯時樽特褥遵峙恃持穗鐵糰
棘	棗策刺棚採想柵相肘採菜粗租睬稱膝孀湘櫬桐廂榮箱盂孟
痛	誦桶湧俑癡痍涌蛹舛瘓癬汍甬恿執捅疚用夕爹摯丸通
修	攸脩倏條絛鯈候衫爪仲疹悠倣做傚傲敕收俟珍趁杉
栽	牀戴專宋哉裁蕙糰鐵樂團樑廂傳載轉戟穗惠磚截
每	育嗨毒佃敏偎母儡俚梅侮姆莓個偶海拇繁毓黴悔晦誨偭
溘	嗑瞌磕蓋豔闔濫盍法溢溫檻襤鑑盞尷藍籃塭琺監
睦	逵陸瞌瞧目睛睬睜瞄眸瞑眩瞠瞞瞳睢盼眶瞿稜睽瞎陵眨瞟凌瞪瞬瞻瞼
穠	膿濃噥儂農槽糟樽禮穫澧體番委穡穢穗穩積遵醴稼稷稻遭撙稱漕嘈稈
冀	選異益僎戴巽寨暴拱慮背鬨撰港搴膚潠哄糞共驥寒烘盧翼恭塞基巷揹
豐	豈痘登逗脰短豎富艷豆豔凳愷壹盒合輻磋皚嶝剴凱豉
涉	步止扯址遣肯芷企祉泣注沾湎歧源汴汶江濟啃湯瀝逃洮正武歲
膾	儈燴檜繪臉會腹劊覃膘潭撢儉僵偷倫佺偭蕈檢罈瞼撿褕銓逾榆幹渝愉
李	季籽孚字子好囝仔孝孛存孱悸孕學錳朵孟閑享厚林俘浮屘猛蜢
涎	誕筵延梃挺庭艇蜓廷沒健腱鍵奴浸怪隻霆雙毽馭又
起	選越趙趨僎趣趁撰趟祀陡圯潠巳徒赳超走巷趕赴
繒	織縲憎增僧紛絲細糸繚繙縵繪贈線緹纏綵絹綏結絨絃絢綑層
技	豐鼓抹取扣梂屐撲找按搾捷扎豉手撮山挖枝吱肢支抖妓拷芰歧岐控求擰
菽	寂淑椒叔籐督芒薺菸莎茫蓮蓬範藷藻莘芷芳菩荒蓑
聯	聊取茸聶聆聳耶聰聘弭餌聒拚關職耽械耳洱溼恥耿畿
佳	隹褂捱鮭涯卦娃閨奎哇掛圭仕鞋窪畦桂僥蛙崖倖堯封
鈞	釣鈸釩準凍杓針勻釵釦妁釙勺鉋灼鈿鉍筠昀鉗鈍芍鋪勾釭鉤均釘冰酌
汍	執孰丸汐汰泓汎洧夷夕九染爹弘湧浹淆痛勢墊熱摯
髦	髡髯髮鬚髻髭鬆鬍鬢鬃鬣尾麾氅耄撬橇氈耗毛
懋	橘移栘茅矛夥柔多矜杼愁悉揉務祕侈恿怨爹予譎
邀	倣遨放檄激繳族遍竅嗷傲敷僱於敖僱房橄擻鏃撒澈撇撤嫩嗾傚做攸炸
捲	倦蜷踡圈卷拌扼掘勝騰券桅脆滕呃賸畔胖姅伴
衹	祇舐紙胝柢婚泜抵低底祗砥牴氏昏氐詆衷衽邸裨
晦	育嗨毒佃敏儈母幟傖暗職暍俚梅侮姆莓偶每海昤拇繁毓黴悔誨熾偭伶
瞽	鼙鼕鼓督苜冒渺眷省眉看盲豉相瞥芰篡算懼纂目緲攫湘
唾	捶錘箠陲睡綞垂郵啤咋聽吒叭噓嗚甜硃哦鳴咱呱呼嗥嘩咯噬甘千呈
晏	安按銨氨案早昧宴暄鞍草暑卓寰昌姦晶日曰奔暈曩囊章杲覃旱戎旦艮
叵	區加局屍咖司口伽茄迦痂句回匹嘔召君居品侷架扈熙
穀	殼般殷段股投毀殿役毅毆骰設殺疫芟沒慇躲浸侵板坡肌搬鍛楓皮瘢磬
邇	彌爾瀰璽逍燃盃甭迂逐迺這肖不慼盡勞戚銷趙誚硝敞梢敝迷送消捎悄
偏	侖遍褊作楹媼僱籃扁塭溫編蝙匾肩檻慍濫盛騙襤鑑篇
靄	藹謁霑霽雯霎霹露霰霪霜霞霖霏霆罰霍震雩雪雲雨噶
嬗	顫擅
縉	紜縲經絰絲紆緻縹織絨絃紅糸縛緯線緩緹縮縵縿綜綺綿綵綸綻繚繒繪
蹤	履崇跡棕宗跦跳踟跤蹴跼趴跋躑蹕樅從踫跺踞跚踵淙跌綜躂縱趺距桁足踝跟躋蹼
怩	妮呢屁尼能枇批毗妣沘仳昆庇沱佗比紕匕屍陀蛇跎駝花
虐	虛虎虔雪彗虜刁叼膚慮悵伺虞瘧慧盧侵浸掃婦
汛	迅汐訊泓汁涵汲湧沒渙漁汕汝汗汀沐汨沁沖沛沫沽沬洱淦湧瀛漲水築
輻	軛轟輕富逼福軾幅輊軻軒軏車輯轄蝠輛軸軋輸輪輜輾轅轎軟軌
於	坊旗宇施肪旅枋旌迂妨菸簇倣旎旋放房鏃邀芳旖方籲嗾族淤仿瘀
礪	蠣磊研硎厲磴磺磋硿砥碩硬砰砸礦礫礁磧磅碾磕磁碟碳硫勵碘硝砷砠
剪	煎芬箭前湔寡氛枴拐吩扮汾份棻刀粉紛砌初刖
僮	憧撞潼鐘幢瞳倍童億位俚漳暗樟喱噫憶焙培接涪臆陪黯垃拉泣笠昱
鍋	剮猾滑迥鉛萵骼骨窩亂鎬咼禍過鐺朋鏜銅蝸鉻媧炯堝渦撾錚銘
靼	靶革鞍韁鞣鞋鞘勒韉鞅鞠靴鞦袒鞭韃韆怛坦但
距	踩拒躡跦巨跤踐跼趴跆跑跋櫃蹕趾踫跚踞踏跌趺踝足跟躋蹼矩
斜	科斡丘斟魁塗鬥蝌荼酴徐除於抖蚪途料餘伍敘斛枓
隄	提堤緹陽是錠綻靛限袒定隍陪除陋險阮阬陡陌阻弔
統	絲織紋絃縲紡絞綽絀細純紂約紀糾繡締縴糸絆紼紳組紲紱紗紐納絢絰
耕	拼構耒胼迸姘併鉼耙阱駢並井屏藉籍耗耜餅耦搆
破	砍陂板皰彼玻菠疲皺跛砟被矽詖砂披鈹皴波坡歌簸磊皮頗 
央	匝瑛泱盎襖吊胰市殃鞅肋肱鴦怏映秧庸英奐巾奧盅然布
屠	奢暑著箸署堵渚楮褚睹諸者嘟緒豬賭煮赭都藷薯曙儲
嬉	嘻僖禧譆喜熹嬈結桔拮嘉噎遠檯黠鼓娃周吉嬋膳猿轅彭培孃娟始圯樹
聆	伶羚玲鈴泠拎冷蛉齡苓零令鈐吟聶侈聯職耶耳岑
鷥	鸞鳶鷓鷹鴛鴦鳴鷺鶴鵲鵝鵠鵑鴿鴣鴨鴒鴆鴉鳩
先	洗銑壬任告呈妊息衽瓚丟兄兒廷沉侃虎浩臭荏淫逞造琥塊媳熄燻薰
吼	孔孑遜乳孜菰蓀亨孤孩孫哼喉孺烹啊吹吸了弱桅脆啗喚嚕兀危嶽
旬	怛恨悍耆心昏洵荀惕惺愒筍慢憬日曰惜嗜甸句勾勺昌怕晶憫
楔	喫扳澳板梭襖駁沃託妖噢扒懊契枴鍥林榛模樁杭杉椅揳夭橋拍棒格燠換
目	盯盹相眇苜冒眼睏睬睢瞄瞿自貝盲省眉看盼眩眠眷眶眸湘廂睫睦睞睹
囤	芻屯沌肫鈍思縐趨盹純囫飩腮噸匈曳困因回囚四田洶胸頓慮
豬	豕豳豭褚楮渚堵箸屠諸睹豚逐著暑奢賭赭緒豢署
嘲	咕瀚韓斬嚀斡撤乾唷肺哺澈嗜嘟朝廾喟吱潮戟喃嶄廟幹味轍噴榦慚漸嗦囁硼
瞧	睢瞿樵憔礁懼蕉譙醮崔焦瞼攫摧睦催雛目瞳瞞瞠瞌矇璀瞄睽榫睛睬睜
儆	敬警擎
彥	頻彬箄榭形彰麝彤趁穆射顏剷彪產諺髦彫杉鬚疹彭衫珍鏟影彩
痿	萎矮逶倭痢秦委諉審蕃馨禾榛莠揪愀啾潘播墦穌鍬
卷	倦厄豢謄半杞蜷己踡券紀已妃圈危判氾卮犯捲拳譽眷
稻	陷秋稠程稿秈禾穢稱穩蹈番稀舀稍滔焰腴穗秧樁稈啗韜租秩祕和私秒
沆	抗坑吭炕杭伉阬骯航亢涼淳液漓返幾般淬逢澶濠遊處蓬篷
淙	漂察噤糉崇際棕宗捺蔡蒜濱渲蹤標賒襟嫖鬃綜膘鏢瞟
盯	睫酊眨瞰盼睨睹汀瞄打目盹睢眼睬眠睞睛丁叮貯仃訂眇睥釘睡瞋瞭瞟
斯	斬斧旗祈訢斫聽昕新嘶廝沂斤析掀其期圻所芹折欺近匠撕
賣	讀呷鉀柙狎甲牘胛薯觸贖鐸瀆押犢鐲閘黷竇匣曼續櫝
隊	阱陽陲陌阻阡陳陴逐豚陣陡陝陘限阿陂阪防隄隘陋險隧豕弔墜
矛	矜務茅橘譎多侈栘霧予夕爹移夥懋弘抒序妤杼
膽	恫謄脰坦峒逗洞小蟾同簷脆逼膈臉銅譫桐擔瞻胴但澹筒旦詹硼贍
痢	莉俐琍蜊痿利秦梨矮禿荊前簌犁秉喇悸秧榛廁薊萎莠審蕃馨鬥乘禾揪
宴	艮晏寰安案痕良根退垠恨銀濕氨昌姦晶十娘娼按銨靼
偵	楨幀禎貞債側貝鋇僕傍貪貨員敗狽貼財盼賄位住佔儕貽損賊價賤遺償
瘉	偷榆褕逾渝愉喻癒瑜蝓輸諭愈痊俞疙瘡崙疹倫
勵	荔劻厲萬勳脅男勤勒動茄幼勸助瀝劬肋勁叻勦功蠣勘劫筋礪勛勇觔勃歷勣
鎬	槁搞縞稿犒篙蒿嵩橋嬌僑鑲矯高轎驕膏濠壕嚎鉉婷停釙鎚
倔	倦絀窟出咄掘崛伺茁倨黜拙己伊呢妮怩尼偃已屈笨仞屆侵祟侷倀
齬	齟齣齡齷唔齪齦齜語梧晤捂悟齲鼯圄伍吾齒五齧
昌	晶倡娼唱猖暘暍曝日曰鯧間昔杳杲旦暗昇昊旱春昱冒音香旨書耆曹暑
故	做啟敬敔古畋胡枚敢敉牧玫改敝敖教救敕收敞敦散敵數斂矢疾矣
氓	泯抿岷眠湣民亡忘妄杗肓盲忙芒虻娛茫荒絮愍嬴
蛤	蝓蟲蛉蚯洽拾恰哈給蝠蜘蟲蜻蚣蝸蟾蛔蚶蛆蛄蚵答磊
疏	蔬硫琉梳流毓堉唷幟熾職識織止遣舢扯址逃肯芷育企
其	旗湛甘某琪堪麒甚斟芸疳勘棋具箕廣鉗淇戡祺柑期二斯簸坩欺俱
轍	輳撤徹輾軼輜輪軌輸澈輛輔轔朝轎較嘲轟轅軛軔轄潮轉輻軋輊輯車軟軾
惶	湟煌遑徨隍蝗韹篁凰皇怕珀旺潤斑班棉嗥腺栓銓拴佺錦鉑柏迫拍泊玨
童	裏意潼憧理鐘浬嘿狸埋撞暑俚立章僮娌幢竟瞳站鋰音裡哩妾著
科	香秋秤斗稿秈禾穢斟番魁鬥蝌稍稚稞委抖種料租斜祕和私秣枓
畔	圈胖拌姅伴半絆滕拳倦捲勝蜷踡謄賸騰判眷卷券
鋸	倨踞鈷聖居鉅鑷錮耳古分釦針耿恥胡洱枯弭沽姑咕取估鏗茸苦忿固岔
齡	齣令零泠聆齷拎齬齟蛉羚齲齪玲鄰鈴苓領憐齦冷齒嶺伶齜
掘	拒倦窟出咄攬扼崛倔摒茁拙己呢妮怩已屈卷圈笨握捲撬招
沼	詔汾炤貂切刀韶紹岔賴昭券忿迢叨照召超解分初浩招
壺	冉腓址坍圭壹螢堝塚苒志吉再蟲止土工眺遣噎玥壯肛刖兆北
則	鍘釗貝側貼賄賠賊敗贖賬廁貶財測賂惻賭貯販賺賤貽剎贈
撿	掄捨儉擒拎僉險搭捻洽籤搶閤瞼驗哈簽拾給蛤臉拖鹼檢殮合恰鑰答拴
翳	扇翡栩翱翻翩翔翎翅翮翹羽羿翟翌習翼蓊翕翁褶濯擢翰櫂曜戳瀚煽遢
畦	褂捱鮭涯卦娃閨奎哇掛圭鞋佳窪桂蛙崖堯封裡
座	準隹雁焦難唯雄進攤矣坐催雉仕售淮堆癱惟椎錐崔灘府集推銼截挫
牟	牢牛件眸牡湃犁戊看庾生我失毛牝牠牧牲牯蛾
逵	陸睦陵稜綾凌菱遠主珪達雍基塞壅逞造增暹鏗鐵柱注拄住遨卜褻圭卞
柏	遑迫櫛鉑湟錦槐穆怕篁帕柞陌材腺棉白才粕煌楷葩嗥拍泊泉伯舶惶 珀
鐐	撩嘹潦了燎
篤	媽嗎罵駑駕闖驚螞碼瑪馮騖馬馱騫駢駝駐駟駛駒駙駁馳馴騰馭
府	符咐附廚俯付腑駙侍寸傅傳冠蔚痔等奪團峙恃持時博搏溥膊磚
膘	漂噤鰾糉察崇縹棕際捺票蔡飄蒜標賒襟嫖淙驃鏢瞟
嘈	漕撙遭儂嗜曲禮曹唱蛐膿蹲哎樽遵濃澧糟噥穠體槽
棲	杵植樓淒梂悽木柙楮末數楠框枝棣梓柚林枰沫材枯沐杖析柿根村枕株柄萋柩妻棺枓棹
浥	扈吧邕邑涓滬澡巴梔絕杷肥把笆疤芭葩混湣潠耙況澠爸
蔆	菱落菠莎綾稜陵浚凌蒞蒲蕩萍藩茫藻範鉻鈑蓬薄痠芟反鋒竣販梭峻唆
木	傑困牀寸杏本宋子果束禾森末東也樸框米林材杳於未才沐呆耒村採棲休札柄柩杜杲
施	坊旗肪旅枋旌弛妨也菸馳簇倣旎旋放房鏃於芳旖拖他方迤嗾族淤仿瘀
妝	戕壯蔣褥寤蟲姊陋將鏘叫遣狀婀婊娉妯姚寢收北兆姦娠寐嫣莊汝牆陘
廁	惻測側則員鋇費貴貸貫貨責贊狽賀買資貲賃貢賢賡貝賤濺
騎	駁馱綺錡畸犄椅崎倚琦馬駱騵駝驕驗駛駒馭寄
摹	慕芭募意漠墓昔惜膜厝糢蟆措草蕞莫摸萌模錯借寞幕冪暮驀音蔓葛
喂	偎煨猥餵畏喟佞噥衰簑嗉嗯娉嘿哩咽呷呀辱聘噹耨褥謂嗶表長畫當
語	訏詔訶謀評梧誤齬誥譟訝詻証吾誣悟諱捂訂晤譚諮訌訐詰唔
熊	態擺襬能罷昆庇屁毗枇沘批妣仳比筧莧覓見蜆焜視紕峴鑣
妄	亡忘杗肓盲姦芒忙氓巡茫荒玄虻安妥妾丐裊姒罔邋
腮	思鰓胭胛雷慮囤聰曳蔥渭喟擂鐳朋月蕾甸囫嗯醃憾胎胝膾臆鈿勰洩拽
孱	孕李孚字子好囝仔遊季孝孛存森遊屘籽林學痳淋猛錳
沽	咕牯葫古湖居估蛄鈷沛姑涸苦骷枯汁沬固活胡
幡	播墦潘蟠繙審蕃帕番帆幅稞巾幢幟幔矮帽幃逶悸倭幗
濘	獰嚀滇溶湖檸濱滓渲沛渝潸沱潮汁瀋沬淙沽寧浮瀉擰
喇	嗽剌咧捌漱俐涮琍硎嫩速悚弗痢莉簌惻測側蜊倒洌冽例瀏懶瀨獺辣怫
齋	蒜崇齊棕淙捺示蔡察噤鏢襟膘標糉漂嫖宗奈瞟劑際賒綜
察	蔡際崇祭蒜賒棕淙糉擦鬃綜膘捺宗嫖漂標噤瞟襟鏢
俑	傑誦令仔桶湧仍伋你舞備傭麥涌蛹健舛甬恿捅像夕用痛侈乞伶麩通
彬	杉疹澎膨珍穆森榭林材趁淋彩診諺琳痳桁樅須衫
琪	棋淇祺箕麒其簸玨欺期璞璜弄瑾珊玩旗斑班理頊瑰玷珀玫玥玟玖瑛王
將	鏘蔣戕狀妝壯膊牆肘博傅搏溥縛褥時峙恃持侍賻莊寐
腫	湩鍾董種踵慟重衝動懂脾肌腴脈裡千舀軍冗裡貍鋰胭狸浬娌埋哩胛俚
回	圖圓田茴迴固口因囚困四叵句品嗇囝向囤囿吉如扣臺杏思胃釦
潸	腔溶控崆倥窩搾搾硿挖沛汁潮湖痲麻竊滑渭邃清涓穹空簾
討	寸詩訏守訥詢誧諫訣許託誅記詳過詐襯誰誠詖訃詁計詛課謝訊訂對時村訐註詠付訕誚訑
乓	丘乒嶽卸邱兵全餘雲合至蟲伐冶仁佰戕倒啣蚯
彫	彩彭衫彤杉形影彪彰雕彥裯箄啤膨惆啁週周珍射碑彬澎謝凋碉稠疹袁
蘇	鰍囌藩菌香秋莉蘚繙禾秈你蕃番萎臻癬莎榛莠委辦穌稟和私協脅
攜	摧催璀崔揣扎攫搆睢推瞿懼瞧撬膺擢擭涔指雛挫拙攤挑隹冉
對	寸守恃寺痔尉持奪射姜忖過峙襯等討吋羔特侍時村付肘尊封美恙
佈	怖鈽希俺布幣佑唏晞烯佐稀飾滿滯蹣巾帑倚啼棉瞞蹄錦侑席
嶇	叵噪驅闆崛漚奩櫺歐巖區操眶軀毆嫗鷗甌橾品嘔樞
鬧	痢莉荊吊啼製鬨市廁鬥裂弗測惻罰帝捌蜊前俐柿帟啻巾帑蒂瀏喇薊布
籥	鑰答簽閤盒籲洽拾恰哈合儉八拿篌筏臉檢撿硼給蛤砠
怡	擡始治胎迨惦憾勾勺冶苔臺笞殆貽跆慘怠飴颱或勻
窮	窗簾身窄窘窺空躺搾竊窈竅窕躬窪究窖躲穴穹突竄窠
把	吧杷肥耙巴邑芭疤笆搗爬捫靶爸捏扎浥色琶捍梔扈葩
緞	鍛燬搬澱綞絲段瘢廄縲發縱繳紙線絡絳繙終緲綁縫紕緒紗紋紐級編綾
廾	戟朝乾榦斬幹斡廟嘲潮韓十慚嶄漸翰車塹暫鞍聶瀚鏨懾攝囁
啪	拍啦搗喫白揩嗥箔柏迫鉑怕泊伯摺泉粕珀帕的鳴魄偕皓階楷腺諧皋皇
忘	亡杗肓妄盲忙芒氓茫荒玄民氏妁她虻志忠芯思恕愍懇丐裊罔惘慌
冠	寇玩府符莞峙梡肘膊廚蔚元痔等恃持侍咐時院將皖詩褥
置	植眾直罹罟罩矗寰羈值罪罰澴罵羅薨遝殖買還
簿	薄溥蒲膊搏博傅賻縛浦箔符甫肘莆等鋪補脯捕埔圃哺匍沛
晤	違葦晅寤圍梧齬吾語昭悟鼯五闈捂韋暄圄暘旦伍敔偉唔
澄	醴睽嶝禮橙磴洽葵證壹揆蹬潑鄧皚澧愷凳瞪燈體登 
桐	胴洞恫峒銅筒磊棚硼同石壹喊碉洽拾恰哈脰答言礬
硿	腔控崆倥磊磋砥空碗磚碳邃石碎搾碟搾硫碾潸磺磴礁挖礦礪礫碰碘碑
飴	餞餒飾飭餘館餡餵饑飼飽餉餅餌飩飲飪蝕餓飢餽
笛	軸岫簍胄聘筆冑爪婁迪鈾妯簫柚娉徊油由申鼬曳袖廟抽釉郵宙
桶	橘誦橡湧俑李遴燐涌蛹移舛甬恿捅檻夥栘杼用痛夕憐通
屐	屜履屨薇覆癥桁樅縱蹤很徊徇徉律往德徒徐從徠徜待衍彿循彷行徵
梯	涕悌娣銻弟剃阡第陴阪陞梆榔椰郝陲隍降鬆橢弔
衣	裔依裁袋袈裟裘裝裳裂製褽迎裴襞襲衷嬝氏方亢迫哀逶裒
舔	添舐舌甜刮恬忝活括聒憩笑僑嬌橋轎蛞祆沃妖闊奏
嫌	簾謙歉姘姊女廉媾嫡鐮濂姦賺縑如媒姣妍兼姍
薴	佇莞萱貯蓿丁菅葬蓉汽苛釘行汀打叮氨荸蕙薨苦芰芾荷卅士盯軻仃
廓	槨郭墩燉廊敦孰鶉店享鄴惇淳爺嘟榔椰瑯綁螂惦梆挪擲娜哪躑
芣	示不杯壞芋否痞甘苛盃甭華萍蒜宗奈平丕芽某疳芸炭祟票祭黃葬禁蔡
罵	馭騖驅駁眾駕馱瑪罟馮媽罩駝嗎馳羈驚駑螞馬駟駒置篤馴駛駢駐買闖碼
麴	麩麵鞠菊麥乾掬侈傑迷殉咪俑你舛汐外代仔憐愾栘粥米夕粱惠氣屎宛
朮	怵述麻穴戎摩空穹術嘛麼磨糜魔求甫弒麾嬤蘑
戟	廾朝乾斬榦幹斡廟戢韓潮嘲戰翰惠栽哉找伐弘轉慚漸嶄
鎘	膈隔鬲鑰融盒鎬鐳砠硼福鉛逼短幅逗脰釭釘翮銅碉籥空命合同
退	根恨垠銀腿褪艮痕限眼狠跟很艱齦偃堰良遏暹卓桌宴
宮	埠呂呈它鴣剋宋古克居櫚寫莒阜鋁舐牢卉官舔侶營宅苦穴聖召嗚閭安
詬	訴訢話詐託誅詞詁詛訶諛訐訕訏計訂訃誥詳誠詢誣誚註評課誰訪訣訥
欣	掀斤析昕近沂折圻聽芹匠炊所斫玖砍祈坎吹次斬欽斯歌歎浙淅逝晰斧
鼬	鼴鼯妯鼠迪鈾袖柚油抽岫竄笛釉軸娉宙聘由裒胄冑
鏝	漫慢縵鰻幔蔓饅曼鑤鍚錫銲錕鉀鐸鐲曙錯鏤銀甲
再	玥冉王珊琛匡全弄汪旺枉苒現琿瑤璦玉坍玨狂玖佺玟玫拴玷珀皇框栓
競	焙涪培倍賠陪兄菩鏡瞳境況兗鐘臆諳憶噫潼樟撞憧億漳僮暗接祝泣拉
曙	薯署褚暑曼躇儲者藷楮渚堵箸煮著屠奢諸睹都閘
榮	熒塋犖勞瑩縈螢營鶯嶸菜綵癆採撈嘮採棠睬炎肖踩炯
茫	芒範莎蒞藻荒亡菠萍落蒲蕩藩蔆薄肓杗忘妄
嘴	角柴斛觔訾貲些喚觴唁觸觼紫啃唷吭噓噫噱嚎啼唬嚷哼嘀啁臺
睜	崢睬淨掙錚猙靜瞑箏諍瞬爭睛瞞目睦瞄瞌眸瞠眩瞧矇矚睞盼瞇睏眶
灣	灤彎攣戀鑾巒孿蠻變鸞譏礫潔漯絃濰織縴縲談諂誡誤詼減給訟這唁洽
爪	攸條抓從笛筆簫脩八爬徐篠川刎修倏袱絛褓鯈庚
嬤	麼蘑摩魔糜磨絃麾鉉靡嘛舷鑠眩炫弦姒麻窈朮
唸	捻稔吟嗆念鈐喻伶吃岑哈鈴拎泠噙黔今羚聆玲矜冷喉咻咐苓含令
迭	佚秩跌軼失牧迫牛夫追逅返近牽亢牡扶鈇伕件遁造逶邂邀芙牢毫牟替
貽	賤賊賠賂貝賻貼貯貶贈贓賄敗財則賒賜購贍贖販賬賭賺員
傲	埃熬橄嗷攸擻敖激倣撇放鼇繳邀撒檄俟傚做遨族贅聱嫩
歌	砍破融砠碓研玖隔磴歐款證砟欺砝欲矽哥欣次欽硝砂砧炊坎嗝畝鬲吹碌磊確砭石
知	矢佑癡矩仃雉蜘踟枚畋短矣疾智唉矮矯右吝吞君
鏑	適滴摘嫡嘀謫鉸釙商六鋅鋇鎊鎬鎰鍋錚鑪鉉鋼銅
艇	蜓舫霆涎梃舨艙艦挺舟舢庭船艘舵廷艋筵舷航舶
藐	邈貌搗葩笆芭皁薇籐前莧苜篁脾脈薩箔菔皆蒙萵菜白巴皚腺肥帕
巨	叵荔拒渠匹炬刀刁戶凹兕跼尹己苣局櫃鉅已凸乍尿力耳屍尺距侷釁協矩
睹	睫諸署堵屠楮渚嘟箸豬者暑賭緒都躇赭煮褚瞋奢著
泄	世屜蝶碟
稍	捎哨秋俏檔揪銷秈禾愀鞘啾悄硝睄鍬梢峭肖逍消租誚帩和私秒
祥	烊鮮祺庠洋咩社佯祕祐祖祚祆祀祁禮羋羊癬祠神祝視祿祉祈祇羣詳徉
篙	蒿嵩槁鎬搞稿犒縞橋嬌僑高矯轎驕膏簑豪喬亭濠壕嚎敲鄗婷停
淦	沿浴汾水涕洪泗金沐沁汨沖汝汕汁淮消浬洋津洱洧洵滴泣注泌沽沾泥
想	相廂箱湘盹憩息忌目孀親態棗策怨冒苜霜棘櫬襯
弗	夢拂釗患刈氟費鬥事川沸佛彿紼袖刖介劃怫喇剌串
剴	凱覬刑刪副刊豈割剩剖剛劃劂釗劍剎削剌則刮制刺到劑別利刨判列劃
醞	釅醮酸酥媼酊酵醴醒醉醺醇配塭溫酴醣酩酗慍酉醋酪釀醃酷瘟醜酣 酌
踢	踩跎踐蹈趴剔跆蹊踡蹂蹋惕易賜跺踴蹟躇踹踏蹦蜴踱跪蹉蹄錫蹣足跟跨
彰	瘴蟑獐子箄形彤漳彪草幛贛璋彥樟彫章障杉彭衫音影彩
嘟	都諸褚楮堵渚箸暑著奢屠哪睹署儲緒賭者藷豬赭煮
饗	響嚮餐饕餮飧癢食養鄉良狼娘琅浪瘡蒼傖饜鎗艙槍滄搶愴嗆袱
姜	美恙羔義羲善對羨羹苒窯糕膳妾妥安姦羌漾儀樣鎂繕曦犧鱔
仕	佳隹侍倖堆唯惟推淮椎進錐催僥僖儔坐人雀售崔焦集
丫	釗鈾鏽中金簾剎釧則鉀鏤小巾六弔父只史由甲共聿串束鬥肅匹四兒公
璋	樟獐漳幛障蟑瘴章境暗培垃斑璃億憶噫臆琉黯玷玟玨
閡	氦核孩垓咳賅骸該駭閔劾刻閉閃亥閨聞閘閭閏開閑間閒閎悶問閂閥門
歹	死列殆殉殘歿殃殊殖殮殯夙殤例洌屍咧殲夕丁
縑	絲緙嫌繡細紲縊縲糸廉維繩絞絢絆絀組紋純紐納紗約紂紀紆糾繕
韜	韌稻滔蹈舀樁違啗偉衛葦圍韓諂焰幃陷闈韋餡緯腴硼舊閻
雊	唯碓惟雕雒誰礁進椎淮推堆錐雉稚睢雄帷準雖離雜雛憔譙隹崔
鋰	裡浬娌埋哩俚鈿裡理狸鉀鯉嘿鐘黑童貍鍾煙湮喱墨黛量
寮	療嘹撩潦僚暸燎遼繚瞭寄宥宏剎宴煮者丈協顯
糕	窯糢糟羔樣米羹膳糧糉精粉粒糞糝儀粹繕燻漾糯曦犧鱔糖糠粗粕料敉
撥	潑醱廢發揆投殼睽股搬疫芟嶝澄穀橙燈骰擱毀殿瞪磴殷般段役歌欽畝
呶	吆叫民吳喲泯汝娛嘰嚷口品姦襄咖咻淑嗨岷抿吱吐如喙偯湣嗓嫂孃喪
善	膳羹羔恙美姜繕鱔菩對義羲羨弄培喜萵茗窯苔苒焙涪塔漾倍樣儀糕曦
留	瘤聊餾劉卯褊籀屢戶茆霤印貿笮卿榴乍卵鉚遛泖溜孵柳
趙	趟赴走越起赳俏趕超趣逍趁趨銷梢陡消捎悄峭哨儻
梭	浚峻唆俊竣酸駿痠格棧鈑板械凌稜杭鉻稷鋒販反菱
演	縯夤寅濱滇汁渲淙淒沽沬沂沛江渚潸溶瀆漸淅浙士鏨
漚	區歐軀驅嶇
苒	冉溝搆媾遘構髯購再講美姜羔恙蓋薹玥坍稱苜苗芯芾昔艾善薔廿
霤	霓雪霍霄霽雯雩籀雨震霜霪霑霖霆霾霎黴雲霞霧霏霰霹露零靂靈
賀	鋇貝貸貫賃貪架貴賢贊員駕賈賬廁貨資質貿費贗財測惻貧袈責貲賒賞貢圓買狽贅負
蕃	審萎莠潘播墦莉幡番蟠繙藩菌稞痿禾秦蘇穌鍬鞦逶揪愀啾倭
嚐	嘗淌倘噹稽趟躺徜哨叱尚脂呢炯當掌棠旨嗥詣啖指硝吵啪賞裳黨堂常
皁	昆比庇屁白沘批妣枇仳毗能泉尼它紕皚帛皇皋匕牝叱化魄
畎	吠伏犬默獻狀猷獸突臭戾哭莽袱尤畚獎器淚捩唳溴嗅圃國因
情	倩請猜精績債蜻磧菁積睛責清嘖晴蹟鯖漬青靖
痠	梭浚峻唆俊竣酸駿疼鈑疫菱疲反販鉻凌鋒各冬蔆稜殺殿賂陵傻綾稷板
塗	芋宇竽嶽淪汽丘洽圩圭汙桔渝淮荼徐除乓全於途堡餘乒斜伍敘杜
事	弗怫拂沸佛串鬥剌喇彿氟紼費妻患介夢吏宙前劃刖圳釗刊涮袖釧刈川
鉸	校姣咬皎狡較跤蛟絞鮫餃詨傚交效鏑郊釙父六
挖	控搾穹倥崆迄屹吃腔硿搾潸紇訖邃乙疙麻痲按擰空究窟乞
邑	吧芭疤笆浥扈巴把肥杷爸邕耙琶爬唱靶色滬葩梔
肌	芟朵亢脈脾骰炕殼凱股殷譏冗抗舀役投胳般腴伉沆坑帆杭吭幾咒段飢疫
暉	漣軸陣渾軏鏈運軌軍輝庫揮葷暈鰱轟褲輦攆載蓮軋連車軟輞琿軒
算	篡纂省眉瞄苜瞞筧看冒箱自目楣湄媚相矇眷臬盲首洎咱
繈	絲縲紐綁纖級絃紜糸緻緲紕繡緘緙綠絰統紼紳組紱細紂紉紆約紅糾縿
私	禾秈和秋嵇委香番科秣租祕稍稚稞秤秧秩秒棧稽穗利禿季黍
夫	芙撫大手替鈇佚扶牧輦攆拾規拖迭伕承推失犬趺天麩人拴挫
零	黴苓霍雨伶雲霎鈴玲泠拎冷靈雯霄雪霽霆霑霖霜霞霰蛉聆羚
慨	濕唧節概澗湛即漲僭潛蠶湯溉卿湄餵溺沍廄涅渴鯽潤暨汨污既簪
訢	訴詬託詐斫詛訐訌訕訏訂訃話誅計諛訪訣訥許註詞証詁評訶記討訊訑
鳩	鳴鴣鴨鵑鵲鴆鴒鴿鵝鵠鶉鵪鶴鷓鳶鴦鴉鵡鷗鸛鴛鷹
糰	囀團糞傳專料籽轉糝磚米梱糠糖粳粒粗粕敉糧糢糟糕粹糉精粉糊栽
輝	漣恍渾軏鏈運軍庫揮葷晃暈鰱胱轟褲攆耀蓮洸軋連車光暉輞琿
舐	衹砥舔舌祇甜紙胝牴柢婚詆泜抵低刮底祗氏活括恬昏氐
念	令含泠貪涔稔聆拎羚捻吟玲俯代伏筏俊愈鈴苓唸鈐妗俟黔昤岑冷伐伶今
斂	劍敔瀲敬敢啟敘故玫踟敵數散敞敖敕敝敉畋致枚牧攻改孜收
媛	援湲暖煖鍰緩諼爰姐助媧塚娟姍鋤胴天勗肓婿綏隱穩肝桐銅峒恫洞且
壤	瓖嚷孃攘鑲禳曩讓釀壕襄壞壇坑喪偯鎬槁搞培瓤玷囊
衍	街銜術衙衛衝衡衢桁行御徘微徹徵很徊律徇徉往徵彿彼徙徑徐得役徨
腦	瑙惱臘淄錙緇輜邋巡繅獵蠟媲巢災鬣胭篦邕囪姦
鑰	籥銓洽拾恰哈鎘鎗儉答盒臉檢撿鈴鈐蛤給閤谷合
國	域摑幗或蟈惑臺笞畎胎苔迨始怡擡治圃怠路冶
拳	半眷卷券拌畔胖姅判伴豢叛捲扶滕圈倦捧絆勝騰
篠	滌條筏符篌八簽附攸爪答籥脩府悠茶褓倏除徐咻休仲
氬	啞氟氯惡堊氤氣氧氫亞氦氳氖氮氨氛愾邱汽蜇介片何
芥	疥界尬介串佛茶仲患花荏葆荃荼夢蕉蕪芝芙芹芯芷昔苗英艾莢萋萊萸
密	勿匆虎耄褫唬克耆寬宛必岔彪遞兄鉍易蜜瑟泌寧賓息忽琥審祕完謐
鞣	揉革蹂鞍靼鞦鞠鞘鞋靶勒靴韁韉鞅柔鞭韃韆緙霸
琵	琶瑟琴揩楷偕陛階諧毚琨皆崑鹿焜棍混錕罷篦媲玨餛比
竈	社燒火墨土杜肚吐仕結黠炎圭灼牡炒炊炬炸烊烘禧燻禱尖少
垓	咳核孩賅骸該駭氦閡劾刻亥雍垃坊壅址坑擁壕臃壤亡
僉	險檢驗臉籤撿儉
韶	昭迢炤沼招超貂詔紹韻韹召叨解賴焙涪培倍初切照劈音忿券岔分
跆	踐踱躁踟足踏踩跋跎跺蹂蹉蹈蹊蹣蹦蹲躊距跚跑趺跟跼踝踞趴躋
忸	扭妞鈕醜紐羞怪怯惟疆心快忙忖怕怫恨悄悚悌悻愧懈甸旬句勾勺閨
碩	頜頡頭煩頓頊頌頑頻頷頤項頃顆頂額顯頒頫頰須題願顛顥顫囂
借	偌芭臘鵲漠昔惜厝僭膜躪措獵草併億供莫摸暗萌模錯僧醋音蠟倡佯
枯	咕牯葫古湖居估蛄鈷枝姑苦骷杖固糊沽胡楛棺
狹	愜狎狡狠狸頰狄狗陝狼莢狙猓峽犯挾狐夾浹狽狂俠
鍚	暘腸煬楊揚場暢陽瘍颺銲錫錕鏝鑤傷豕分觴殤湯袒怛坦但逐豚盆忿岔
拍	遑迫鉑湟錦託惶扒怕篁啪帕陌腺棉白揩柏粕煌葩嗥泊泉伯搗舶指 珀
湎	偭緬麵面靨靦潭漂涉酒沔汪汗汙江汀涿源洹河沍湮海毒
鄭	擲郊躑鄴鬱邢鄞郵部都郡郎耶邱祁邦那弔鄧鄱鄙鄘鄒鄗郾郭郢郝郃邸
嚷	壤孃攘鑲讓瓖禳曩釀嚎哼襄唁吭品噪偯喪圖鎬諒槁搞瓤砧囊
奢	屠暑著箸署堵渚楮褚睹諸者嘟緒賭煮豬赭都藷薯儲曙
猜	倩請猾猙精債蜻情菁積睛清嘖狷晴鯖漬青猩靖
行	徑桁徵衍銜徐術街衙衡役後待得從復徨往彿很徊律徉徇衛衝衢
鱸	爐驢鑪臚瀘蘆廬鯨鰭鰓鯖鯛鮫鰱盧鱔鱖鰻鰾鰥鯧鯉鮪鮑
倪	睨兒霓身躬俾傀作伯任件仟侃俄係侏佚躺躲仳臼窮
蒿	嵩篙槁搞鎬犒稿縞高僑嬌橋矯膏轎驕蓄蓑萃豪亭敲鄗婷濠壕嚎停
潼	撞憧僮鐘幢瞳涪童漳泣浬樟億憶噫暗臆焙喱接培陪倍黯拉垃位笠昱
冥	暝瞑六螟皎肥腸腥滾鵬袞兗昱交暗煜受景昌晶商與月校脂咬姣帽晾朋
筷	快袂決抉筍也鴃忽訣缺悚忖筋箱符柒宅忿竹惚牠迆池託弛她地吒他
阜	埠帥啟師呂宮召薛味咕吱戎莒篩烏計侶追喧獅鋁嚀
煉	練楝揀鍊闌諫爛柬瀾攔欄蘭籣斕東米糞棟魚炎
魅	鬼魁昧沬妹味未魎槐愧塊傀魑魍朱蒐魄瑰幾宋戎麼
萼	愕鍔胯垮誇跨巖鄂儼嚴雩襄囂顎釅簞誇囊靈污圬
耜	官棺倌耒菅管耕耗耙耦琯耘綰耨館藉籍杏藕搪抹和抉嘯糖橾譴唐哲吊
濩	擭獲穫護攫雙隻漠濛瀟滿灌湔滋沒蕉液浸淮舊
砌	庇詣碳徹吩屁切叱碑硯枇沏比此砟妣仳紕枴北砂拐硼批毗能沘磊礙昆石
習	羿翌翟摺褶翠翼翁塌遢榻蓊廖寥嗡僇煽嘐膠翰蹋濯擢櫂曜瀚
軔	轟軋仞輾輒車軒軏軟軌軸軼輊輔紉軻較輓輥軛軾輯
迄	屹吃紇訖疙乞夜迤途逾乙挖液掖腋進旋跪蹂你仔函卒
堯	澆褂橈嬈珪繞撓娃蹺閨奎哇掛圭佳曉畦桂僥饒燒蟯驍鐃
拽	洩抽曳摟由拂思柚迪岫油妯袖鈾掩揹冑胄宙笛
八	筏符答叭扒竹篌篠簽籥佾爪人豕亥黎以猴麼仄欠囚
刖	刺制削刷劃刪刈釗刑判利刊剎剌則剛剩劑列刎別刨到刮剁剖副劃前
睥	脾裨婢埤啤俾碑陴痺箄睨睡牌卑顰睫睹盼眇眨目鼙
二	三竺仁雲元示完言些奈宗岸芸一佞沅亟仄左旦誇祟票祭禁禦嚴圬污阮
宥	餚囿洧侑宏有丈賄鮪鬱崤疽者老協杖仗宜宵宋安卉穴寄寮十淆髓
荻	逖狄艾逛茄嶽若薰猖猓狸狷狠誑狎狙狗漪狂犯
瞪	嶝磴燈橙澄蹬證睽愷登皚壹瞼禮澧體瞻醴揆眨凳
遏	暍渴揭愒喝褐竭碣羯謁葛曷暹噶歇遢退藹惕錫蠍意
憤	鋇慎貝貼貫賄懼慣賊員墳寬敗悖貨苜惻瞎賁貯損髖賤貽惋賽噴狽懵實
俾	啤埤婢脾裨陴睥碑痺箄牌卑仟鼙顰侏傀伯作任件千疹
餞	飴餒饑餡餵餘飾飭餓餽餌餅蝕飩飲飪飢館餛饅饒餚餃餉飼飽飯
軻	轟輊軒軏軟軌輛柯軋河坷呵何軛輻車軸阿苛奇
騖	驚駑闖篤駕罵媽嗎馮螞碼瑪馬馱騫騰駢駝駐駟駛駒駙駁馳馴馭務
戴	糞冀翼異載惠栽哉截裁專共選撰潠僎搴寨塞寒基恭團烘拱洪哄供
瓊	觼珞瑁現玻玨斑班璿瓔璦璨瓚璃璀瑤瑛瑜煥琛琨渙湧換喚琉玖瑕珮夏
盼	棻寡眇睥目盹眠眼盯睫睞睹睨睢頒睡瞋瞭眸睦睜眶貝分
茹	如妾娟茲茄莊姦品恕展苔藥蔣茗菩萵慈廿娛接始
稱	稠稻穩租構程禾遘稿溝搆媾稈稀穗穡穢秒稚稍秧秋秈和私番香委
冗	肌股亢幾咒胳骰朵舀芟疫帆投麂嵐瘋反凡伉吭坑役抗沆佩杭炕段殷珮
瞠	嫦膛擋螳掌檔撐償讜棠瞄睜目睢當鐺瞧睬睛鏜襠儻堂瞞峭眇尚噹瞿睦
籤	蚤儉篌辰纖僉符傭險撿殲脣宸驗讖簣簽筏築箕臉韭蝕竺檢八籲三篠笞晨籥答懺禦箋
獵	淄臘鵲鬣繅錙邋輜巡昔惜猿猥瑙措猖獗惱借錯巢狷災腦蠟緇
顥	顯煩願頻頡碩顫類題顆頰頷頭頤頜頑頓頒頌頊須項頂頃
捩	妒淚遍褊作袱偏煽僱戶搾笮砟蚱炸編溴蝙乍邀唳嗅戾咋牖祚昨滬犬柞
煎	剪箭湔前蒸燕刖蒂氮菜蕉蕪薰掣烈莉荊削刺制
闇	黯暗諳
曩	攘孃壤嚷鑲瓖禳讓釀景襄晾喪囊篙蒿嵩瓤憬偯
截	雄惠崔栽哉雖僱專瞿隹椎進錐惟推淮堆唯準載裁霍應膺奮蕉榫維憔睢
繩	絲繡澠細絀純紀縲緝絹糸蠅縑維絢絆組紲納紗紋紐紂約紆糾結
妙	少妒吵緲妖女紗莎炸沙省劣姦砂娑抄鈔妊眇杪如炒姅渺
梔	柝析杷浥扈葩絕淅晰巴笆桓棉柢橇耙柏爬肥把吧邕疤芭邑卮
梳	流琉硫毓疏堉唷熾幟織職舢樸梅識育杭橇柱枓
塭	侖遍醞褊氳媼偏鎰嗑溫磕盜檻錳慍跚濫襤盧瞌溢瘟鑑溘蓋 
傾	頃瀕仳噸蘋擷澦貳嶺巔籲頻化贛鬚癲煩頓頒須穎頁
投	芟殺穀扳骰殿殼沒股殷役搬設毀般殳毆段毅撥疫
賸	臢滕損勝胖漬嘖債眷謄績蹟遺積磧潰騰慣隕鑽賞圓賁
苦	咕牯卅葫古湖菅居瑚罟估蛄鈷姑芾骷枯固糊沽芰胡做楛
卵	孵卯泖柳卿鉚茆即聊節唧留印叩傀塊愧槐魄溜榴遛櫛劉鯽鬼貿箋蒐瘤
牌	啤埤版脾裨箄牘碑牒卑陴鼙牖顰痺睥婢衫片俾
巾	匝布吊帖帕帷市央庸帆希佈簾帛怖帝帥席帳幅帽鈽滿幟幡
軾	轟拭軛輻輔車弒輕軏軒軋試輪輯輸輾轄轉轍轔輊軸軻輥軟軔軌
就	蹴魷疣嵇尤稽憬璟晾掠涼景京默吠乩獻顥鯨佔犬尢哭
桁	衍街衙銜術樅衛衝衡衢行薇縱蹤徵屐屜履屨癥
蔓	鏝饅慕募慢墓昔縵漫摹蕞莫萌幔幕暮驀鰻曼葛
詆	砥試誥諉胝柢泜抵低託詫詻設誌祗牴訴詐話誅詬訢諛
熨	慰褽尉蔚屎糖糠紂炎米寸糕糝熱熟焚傑寺守痰燐煉淡啖迷咪村肘忖吋
髏	鏤褸樓摟嘍簍屢螻縷髁骸骷髑髒體骼骰骯髓屨
需	雷湍糯電孺而憂瑞擂耑燸揣霸恆儒耍亙耐嚅顓鐳懦灞濡蕾蠕惴喘
惜	芭臘鵲漠昔厝膜憶旬措獵草莫慌摸暗萌模借錯憎世醋音蠟懵懂
擒	噙禽掄撿搶捨捻拾拴拖拎漓璃魑撫斡於推扶僕
扁	盥盈遍褊益盟偏僱戶柵盂盪房皿編肩蝙匾乍盃戾盛監騙盍孟冊盔盅怎篇
添	沃舔忝湊妖夭笑僑嬌橋祆奏涊澳矯轎吞淚浩洛溴嗯傯泜滯潘潟驕泊
糢	模膜漠摸蟆寞糟謨糕米糧精粉粒粕敉糞莫糝糯粹糉糠糖粳粗料籽糊冪
碾	礁展碳碘磋輾礫研磴碰砥砟磕泵硫碣礦碟碼硿磊磺砸石磁
嵩	蒿篙搞槁鎬犒稿縞高僑嬌橋矯膏轎驕豪亭鄗婷敲停壕嚎濠
因	囿男田咽姻恩胭茵畸大回囚四困囪更爻畎畋嗯
咽	嗯姻胭茵哩呷恩哽喟氤因嗶喂嘿囿男咦吠吐叻噹囪更口品當
值	佬慎滇植直仁填鎮佞脤且估矗真仗傢具倥儐置殖什信佇宜俱使
畋	枚矢疾矣故玫牧敉敝敖啟敕改收敞敢散敬敵數囚
烏	塢嗚鎢薛叔阜鳥呂足迷淑啟帥寂埠逍椒菽召謎
簧	黌橫磺璜黃箭箕蕈薑廣箠簸箝蕾算葬竺芣芋甘升貓樺曄嘩四
戚	槭戊威鹹滅慼茂減喊蹙髭戌不上延邇崴芣否箴示筵歲禦齧成戍涎杯壞
詁	詰計話評詞詛詐訶註訣訥許詳誅詢詬訐討訕訊託訏訑誚誧記課誰訂訃
峨	儀我議鵝找哦牡牢峯件巍牛蟻蛾嶼娥牟餓俄嵐匕峴義
突	空穹究窄臭戾簾哭窒窗窠窈犬畎吠伏穿莽窘猷鈸獻
喪	襄壤噩嚷孃攘曩瓖囊鑲吉禳民單喜週售啁區偯惆哭桔袁品拮器咒呶周
驍	燒繞撓鐃橈曉澆嬈僥蹺蟯馬饒駝駁駐馱驕驃騾驛驗騵騷驟騎驢駿騁駱
齒	齧齜此雌齟齣齦上齪齲疵齡齬齷逃兆晁桃洮挑姚佻
炯	迥尚棠掌當倘淌膛噹肖常堂營黨哨儅煖燃擋檔襠鏜鐺向熒嘗裳賞
緇	繅錙淄縲絲輜繙經細糾綏絃獵臘邋蠟綑糸綵絹腦結絨惱縴縵繒繪纏續
墾	娘凰藐髻貍履霾貓豺墜貂痕箔貊狠篁圭皆垠堰狼白豹召解分皇恨貌貉懇泉艮
哂	曬迺湮煙西酉酒籲叮酊呵呸哽配酌酗酣酥鈿醜喱酩酷醋醫
薇	癥屜屐履徵屨覆樅桁縱蹤徊徇徉律很往微從徠徜徐徒待彿彼役彷行
潦	濕嘹撩暸淡淆顯沿汍汰了涅僚鐐洧療滯淹剎寮浹繚燎遼源瞭
饞	飭饅餞餾飴儳攙飯饑館逸巉冕飲讒餵飪饒餓餡娩晚毚飾勉纔餽飽餒餘餛挽飢飩免
化	仳比叱匙傾花仙佗妣批沘枇毗匕它尼屁庇昆北此牝能紕靴
生	猜拜姓旌醒笙牲牡牢腥甥件牛產性隆牟惺星青猩甦鏟
瞥	氅彆弊幣鱉斃敞敝眷省督眉看苜冒盲蔽廠撇算相
耘	冽耕動紜運仁耦桓耜耙云耗芸壽雲耨禁魂竺三耒二
濂	鐮簾廉渡兼嫌縑歉賺浦浪洪泳淺治濟謙淇淦洋泣洩法汰汐樑滲滅減浚
辜	宰闢莘梓鋅辭辯辛辨辦辮薜薛癖闢滓僻避瓣古辣
髮	髯髡髦鬆髻鬍髭鬚鬃鬢鬣鈸紱拔跋衫杉箄歲餮疹戊匆犬澎戮影膨穆彰
戾	淚獻哭僱戶扁殷畎房吠肩捩伏乍唳突臭犬莽怎
燄	潟毯淡啖談焰痰氮炎啗燃燻陷閻寫瀉妳炒臼熒
蓉	鎔葫萱熔溶俗菅蕙荸蘑莞豁欲谷葆薴裕腳苦芾穴容卻蓿峪榕芰慾浴
囊	襄簞索嬋囂巖闡靈器萼孛喪孃彈憚曩蠹芾儼嚷壤攘鑲蟬禪鍔愕肺沛
芰	豉鼓支肢枝技岐妓吱芾苦卅歧莘萋華著蕞求瞽葫薴蕙幸辛畢取
餽	餓飪飢饑餉飯餿餅餌蝕飩飲餚餃飽飼餞餡餒飴
但	們倡仁怛坦查銲湯袒替悍晝傷旺倥低焊昊僩桿擔旱暘靼旦捍趕膽疸
咬	嘀唷父餃跤狡六交郊較鉸效絞膠蛟鮫嗚吭咳校傚姣詨皎 
串	拂患芥而亞釧疥事川沸圳佛甽界竄袖介片弗怫姬
攔	蘭澗鍊欄爛嫻煉柬揀燜閑籣僩捫斕瀾楝閉闌擱
佬	姥仗老什耄耋使估丈午杖值佇佗倥傯做儲傘侏侑杵俠佃佝伐伏休仲倖
壯	戕玥蔣王寤珪班妝竈址將鏘叫狀堊旺妯姚寢收北兆吐汪枉寐莊肚杜牆
殿	殼殺殷般段股投毀骰毆穀役毅設疫芟澱臀沒浸侵鈑鍛慇擊
償	儻賞俏勛檔噹擋瞠膛襠鏜嫦鐺儅倘螳撐趙尚債損讜銷梢逍哨峭悄捎消
杷	耙肥把吧巴芭疤邑笆杳爬根靶梔爸棍查札浥色琶
檳	臏濱嬪儐殯繽鬢棕梡賓榕檸棺稼糉搾錠暄嫁渲喧傢淙佇植枯枝杖
菸	瘀淤芳簇倣於房嗾肪枋妨坊仿鏃旁防遊方遊族旋旎紡漩旅施放彷
豁	鎔割谿鉛吩熔溶俗拓欲谷瞎害轄裕訟容卻峪蓉榕壑磊浴
壘	疊儡墨裡畦園疇圉埋黑田鋰煙裡湮哩娌浬俚薑量童思胃圭重土鯉黠壎
篡	算纂省眉筧看苜冒箱自楣湄媚相督眷戛臬盲首目太瞭渺懼洎咱肱
處	恪返逢鈑隆板扳疼客略舨胳烙格皈洛咯叛鉻咚阪
暮	慕募漠墓昔膜薯糢摹蕞莫摸萌模寞幕驀蔓葛著疸
剜	剛剋刨劃列刊宛釗剎削剌則剩刺刮制剁到利刪判刑刖劑刈
媳	熄息嗅溴臢鑽虎瓚婚侃沉讚娩妒妖妊臭嫂媲琥嬌唬婢娥姓妣兄鼻忌贊
棒	奏春俸輳木秦攀森梆絳泰舂捧楔降臻林榛模樁奉湊挾揍
卒	俎巫粹夜踟率傘醉碎坐瘁翠來從遙迄途迤淬什悴夾午萃誶褒進
掄	侖捨喻淪輪擒拎捻逾褕搶撿渝倫拾偷拖綸愉論崙榆拴
徠	彼從徒很徊律徇徉睞往萊徙徜彿彷徐待循徵得復行御微徹徵衛來
擁	甕撻撲拄攘傭抗雍亥挺掠接撞搞臃掖用妊壅擅撾摔
徇	待徠很徵徜行律詢絢彼彷徐循徉從徊徒彿得往徨殉徙
傭	例令含貪擁偽席吊念食殃傅慵倆代佩倉傖伏筏鄘用偶佈庸仲俟飾巾伐伶今
注	涉蛀潼涼拄沾漓泣主流滷淑柱汶沆滾濟往駐汴註涪滴住
毛	看耄氅毽牡扎牢件屘耗牝氈尾牛毬麾髦毯牟毫娓撬橇
交	父餃跤狡冥六郊較鉸效絞膠滾爸蛟鮫校傚姣詨咬皎 
幃	偉違韓緯圍葦闈韋拿幅幡帖巾帽幌幛幔幢幟韜韌帳帷帕笨苯
慘	摻餞怡飴淺盞殆錢踐勻殘勺參棧憾滲縿眸勾賤鹹戊廊忪糝惦箋
氖	仍秀氟氣氧氤扔奶氦氯氛氨氮氬氳乃氫孕莠透愾
舒	杼抒妤野序澦予預豫捨捨矽歿侈墅多移栘夥爹
夤	演縯多寅名夕爹夥移栘殯侈舛外飧麥宛茗令銘矽汐
侮	儉毒儈母倫傷傖梅偷姆莓每海拇黴悔誨晦佺伶
愈	侖掄喻瘉淪輸蝓優癒念逾褕諭渝儒倫瑜偷盒愉合覦崙榆俞
才	板木豺槐黎疲牙呀財被材柝披柏粕析芽杉鈹波坡株閉竹皮柞
憫	閔斕燜嫻潤澗僩捫們擱櫚攔瀾欄爛門文閡悶簡藺
乳	孔吼孑孜脆了嶽孤孩孫弱亂桅兀危舢汕胱訕仙札扎預兒股侯阮孺溺遜
殖	例植殆咧直歿洌列矗殃殘值殤夙殲殯歹宜置殮殊屍死殉
晞	烯唏稀幕希鈽怖佈布爻崤募帑冪掩淹醃俺駁暸映巾莫幣餚
論	侖掄請譙訥淪輪諂許談諉謂諍誥認諭診語倫誼誰訖詮訛綸誨誡誶諒謐誌
考	丈拷烤銬孝杖仗老者宏宥屠奢著煮暑箸寵協佬姥渚堵楮褚酵
刨	抱砲別釗剋剛苞刈劬泡炮胞刮剖跑則咆鉋包袍副剜庖刖飽剩劃刎 
別	刈刨劃刖刷刮剎剖釗副判利刪列刑刎刺到制剁削刊剌剋則剛割剴創剩
蟑	璋樟障漳幛獐蟲瘴蟀蛀蚪蚊虻蟆螃蠔蛟蟲章蟒螟蟬蝶蝙蝗蜢蜴蜿蛇蚣
觼	瓊觸觴斛觔角煥渙換喚踴湧瘓嘴邂懈廈夏奐勇
斥	拆坼柝下訴卡斤戌後竺竿竽卮正丐匠折沂狂圻聽昕析定芹近是威垢鹹
籃	遍盞褊藍偏艦嗑磕蓋盆檻闔濫監臨盍襤瞌尷鑑溘篇
蹈	踩踢跎跦踐趴躁跆蹊舀蹂滔稻跚跺踴蹟踹踏蹦跌韜踱蹉蹄蹣距踝足跟躋
悅	悌剋競稅虎兌侃唬兗克閱鋁釦愧怕銳兄祝袞脫憎況嗅熄蛻說息忪媳懍
熒	撈淡勞榮啖螢營炙瑩嘮鶯縈痰癆炎塋炯犖燃嶸
宛	舞麥蜿碗移矽婉茗夥栘夕腕剜侈爹惋苑汐豌多銘
倣	仿邀放族嗾鏃淤傲簇激檄菸瘀攸繳枋肪坊妨房芳竅
恆	雷慎糯恫砠姐需且燸惰疽渲情楦儒亙悟嚅宜匐懦宣愉沮濡怔惴喧咀
效	政救啟疾餃敵癡跤致狡敗教交敖敏嫉郊畋鉸故放絞膠敕敝校敉傚姣咬枚敘皎 赦
萸	庾腴臾諛蒐臼茱芹舊董舀萎蔥蕃薰萊莢莒舂茂苗蕭芳芙芝芥芯昔薦薺
去	劫怯法盍玉丟砝琺嗑溘蓋戈土城埔埃域塘瞌磕闔
荼	途荃除茶餘徐芋餘荷於伍莓苓蒼葆瘩竽塗宇荏花斜敘搭塔迂褡汙圩籲
廂	箱湘霜相牀目楣想廁冒苜帽媚湄睏瑁睬親櫬樑眷栽臬樂省眉看盲瞿算
霓	霽雨霍霄霤雯雪睨倪震雩霑霖霆霜霪霎雲霏霞霰霹露霾黴零靂靈
痣	痔志奎恙地誌怪應壓圭爻大筠均痰痊惹疸瘧瘓奪墓怠奮奔希堅疢疝壑
延	蜓奴沒涎浸狡股假遐梃又健建挺投庭蜒誕般煆廷怪筵桑候腱獄侵暇鍵艇
鮫	絞鮪鉸校姣咬鯨鮭鯉魷較皎狡鰱鮑跤蛟鱷鯧鰓鱸
糟	糉粹糯漕精撙遭儂粉糢禮曹米糠糧糞膿蹲粒樽粕遵澧濃嘈糕糝穠噥槽
續	讀細繽繙繞纏牘縊繪綾繒贖糸縵瀆結犢繕締綿縲黷繹綵綰竇絲賣繚緇櫝
衫	杉彤彩形彫彭彪彰影彥裨褫箄陴修彬疹珍襖衽射
腓	排啡俳徘誹匪菲痱屝扉罪霏靡非悲斐裴輩靠眺逃桃洮挑姚佻遣
瀏	測涮洌惻側瀨蜊喇琍捌俐廁硎倒咧冽例淚痢莉荊前
灌	權瀟濩濛漠滿滋湔澡溝涪澧漾漕溢港洋洪萼濃潼涓涅治沿歡勸漢湛淇
蔞	婁樓摟數縷僂褸
瀉	寫瀋潟濱淙沱濘滓溶渲汁滔嬸燄潸插沽沬沛臼
騷	搔蟲駁馬蝨騵驃騾騎驍騁駿驛驗駱驟駝驥駢駐駟駛駒馳馱馭駙馴蠡蚤
譯	讀詩諾譙謀澤詼擇談謂誥鐸諳誼訟詮譆繹課釋譚詰謨誡譜詫驛譁諜誌
崇	漂察噤糉際棕宗捺蔡蒜蹤標賒襟嫖淙鬃綜膘鏢瞟
路	洛絡烙閣咯珞骼各恪詻略賂胳駱酪鉻貉咚格客
奘	裝琦美王劻弄全爻痊斑旺枉玨玟玫玥汪匡皇閏尖艾荃筐再玉框栓珪珞
捱	涯崖掛扼掛珪搓拴撓畦桂娃哇卦佳奎窪擂蛙封拓打褂王差堯閨圭
邸	邱郵邢鄞氐邵祁邦那郎鬱郃耶郢郾鄭鄱鄴邪郊郡郝部郭都鄂鄒鄗鄙鄘
怒	急奴忠思悠夜芯努虞您懲誤又恩駑愍恕忘吳慇怪隻悶忝弩帑蜈雙志娛
芝	莆眨之蔗泛葵孳貶飲茅欠藺次欽茂灸歜苓久疚炊坎吹茨薦苔莽乏砭
壽	檮冽蟲紜鑄云芸禱躊耘疇坎蚓濤儔籌燾堠強至弼蝨
吱	妓岐技枝肢支芰豉鼓味咕歧求取哮喃嗜嘲阜吐梂喧嚀口品屐娶最
辭	薛僻辣骨宰亂滓癖鋅瓣梓辯辜辦避莘辨闢薜辛辮 
謫	詨訃註誚該詛訪訥訕計謙課誰誧詳詢詁詐訴訣許記訐討訊託訏訑訂謗
燒	澆鮭橈嬈火珪繞煤撓竈社黠焚蹺翹圭結曉僥饒堯蟯烤災炎驍鐃
莊	蔣壯寐寢寤戕妝牆鏘狀將茹菲堊姚茲芷荃珪蔬弄慈藥王班叫
敝	幣鱉啟疾敵改玫數敗矢蔽敬敞散敖弊撇畋故牧廠瞥憋收撒敕肖尚彆敢敉枚
蝴	蛔葫蛀蟲湖蝦瑚蜻蜿蛄蛇蝌蚌蚱蛐蛞蚵蛙蚶蚊蜩蚪蚓蛆蠅糊胡蜘蚯蛛
狂	王狎琴班狠玨猶狸獗誑旺匡逛斑狄狗全汪枉狙猓犯瑟皇
綢	惆組調雕稠碉絹網鯛糸週緩結縲蜩綵綬啁綏綱凋絲周
換	觼澳撈湧襖瓊喚揉噢邂懊瘓煥撚懈揆踴扭解勇奐拯渙燠
滂	榜膀傍鎊磅徬螃謗旁濬肪楞愣遊淤方枋妨坊仿漩攏嚨朧房芳龐寵籠
髻	髯鬃鬢髮髦髡鬆鬍鬣髭鬚窖鹹告周皓造浩桔拮
瞰	橄敢盯撒撇眺做攸睫睹睢肝目瞿罕徽邀擻瞇緻遨澈撤徹嫩嗷微傲傚倣
黠	黷點黔黯黜默結墨黝桔拮嘿黑禧壎周嘻竈吉檯疇燒嬉遠僖皓造浩勳埋
記	詞訏詔詭訥詢訣許託認詳己詐誰誠紀討訃妃詁訪計詛課訂訊訐註訕誚訑
獷	擴壙曠礦廣狼猥猜猖狷狩狙狂獲獰獨獗獐猿猾猩猛猙猶猓狽狸狠狡狎
煜	暗昱焙焊爆立音煬焜竭啦意黯粒泣拉垃位笠妾
潮	瀚斬滇斡撤乾淒滑湖肺渚澈滓朝沛廾潸嘲渤汁戟溥沬溯嶄廟沽轍榦濘漸慚浦
沙	少吵妙淡裟紗莎省劣砂洸娑抄鈔眇杪淌消炒渺鯊
君	咿叵吝佑杏窘咯裙癡匿各吉尹伊羣啄郡若右喬召品知臺癌吞
喲	約絲絮累系濰縲紮紊素索辮絢紲純嗦嗉糸紫細紂灼吆絨結絃絹縐緊繁
犒	搞槁稿鎬縞篙蒿嵩僑嬌橋矯轎驕高掠攘牯牛看
柙	胛押呷鉀甲匣狎棟棵釋梱曼閘賣樓楞東楝耦澤濁擇獨曙燭櫝鐸鐲申薯
運	漣軸陣渾動鏈軏軌軍輝庫揮葷芸暈雲鰱轟褲輦耘攆載遙蓮軋連車軟暉輞琿軒
潰	隕槓貴慣洮臢績債瓚遺磧價積賡櫃賸簣嘖賁損匱蹟鑽貢圓漬
擇	呷鉀柙狎澤曙胛圉鐸押鐲閘倖悻濁繹釋燭睪匣擺曼幸賣驛譯
背	惆育月脊貴蟲恫肯穩惡胄肓將冑螢啃肛隱簣朋貲蜩匱胃驥惘膊脯有止腓青揹盡工冀
隔	陷隄陞院隕陪際融陶隙險陋弔陸隋降阿阮哥隱膈除陌隆陰障鎘嗝隘隍鬲陽阻歌
脖	悖荸孛肺浮俘孚悸勃沛渤芾嗦膊酵嚏子厚享字學
昂	迎抑仰節茆唧泖柳姬啣鉚卹昨即印卿御叩卯聊腳鯽
緩	組暖湲縊緯絹網糸線援綻媛締編綿鍰縞煖縲綵綬緹綏綺綸綱綜絲諼綢
抗	亢擁炕撲蓬攘返篷掠投搬搞掖般伉沆坑處阬杭吭骯擅幾逢航摔
廚	樹府櫥澎膨蔚符等痔鼓時峙恃持咐侍冠奪團撙樽遵傳彭蹲特
財	賑貝貼賄賠賅賊敗賬貶則賂賭材貯才販賜賺賤貽贈
蝙	蚱褊遍偏編蜢篇蟲蠱蟠蝗螃蜂蟋蛾蛞蛛蟲盛扁
韹	遑煌湟惶隍蝗徨篁凰皇韶韻珀斑迫旺班錦潤銓詮腺嗥棉栓拴佺鵲鉑柏
孜	孔孑孤孩攻孫政枚玫致敘敢孺吼改放收牧故效敉敝敖救教啟敗敕敔
超	越詔趙趨炤貂趣趁起韶紹趟沼陡昭招徒迢召赳走趕赴
拐	枴扮揖叨招吩捐扣汾份刀召粉紛詔損砌捌芬沼昭炤迢揚初氛券剪分
郢	郡郃部邵鄙鄱郝郭都郊郎鬱耶邸邱郵郾祁鄗邢那邪邦鄘鄭鄴呈
彌	捎哨杯彊俏撈邇銷甭勞爾你敞壞悄瀰獼硝燼不梢盃肖峭敝逍消璽盡儘弼燃
秉	束乘禾禿利俐秧莉梨痢簌秈委和私秋香悚琍犁速番籟
瞑	暝螟睬睜瞬冥睛瞞瞄睦眩眼目瞎瞌瞠睽瞳瞧瞻瞼眸矇眨矚瞋睹睢盼眇
愚	禺寓遇偶藕癘隅耦邁萬惠懣忍厲禹慰甲巾感蜀患恩思忠吊布罹躉弋鉀
空	窗簾窮窟窄窘穿崆窩窈窒窕邃窪究倥窖穴穹腔突窠窯硿控
名	多夕茗銘臺舛外哉汐侈栘酩夤或怠爹弘移夥麥宛令苔笞歹凡丸始怡擡
胱	洸恍晃光幌輝炙胖胚兀耀朋滕賸冠元胸胞脹肥肫肝肛肚勝沅膛謄胴丕
撳	嶔掀欽歉久漱嗽欺歟揆柩崁炊坎吹扮簌羨嵌闕茨疚灸
凸	巨拒炬苣鉅凹局爭矩協侷荔崢掙淨渠脹距箏錚
憋	敝蔽鱉弊
憎	漕遭怛增惜繒旬曹悍曾鈿層僧西醋嘈曬糟贈忪鹿槽
繃	縲絲綬綵絹綏絀糸蹦締結絨絃紇細組純納紀紕
鄗	敲鄙部郡郃邵鬱高鄘鄭郭郢鄴郊郎耶邱祁邢邦那啊
升	昇陞廿竹飛血笠箕箭簧卅壬夭井戶牛千冊乍世必戊才甘白皿禾立匕刀
脯	博捕敷莆誧哺蒲肺輔傅搏補甫賻圃鋪溥膊縛匍浦埔
隻	雙隹售集焦濩擭又奴雋健怪獲穫攫崔燮庭夜筵挺候涎淮梃推惟堆唯進
媒	芋謀墟嵌甘某姘煤甜嫻疳虛嫌蚶於鉗噓柑箝酣坩
崧	淞鬆鬆公森臬頌痳嶔巍山峙林忪錢崩冠霖突杲採宋牀呆蓊岑木崆崢梯
皴	鈹被波披陂坡跛破玻彼疲詖皺皮皰菠頗簸板格
磚	傳轉團專磊硿碗詩礫栽褥磷潯磁碟博硫鐵時狩持恃峙侍硃砝矽咐石府
聞	弭闖門閑間閒悶問茸閃閂聶闢閨閘閔閏開閎閉闐耳洱
茸	攝取揖聶躡楫聳趣耶聘陬聾弭餌聯苣蕞懾椰職爺鑷耳洱聲聞萇恥耿叢聱囁輒
風	凰颺朵楓亢飈颱颯瘋鳳颶飄冗夙颼颳諷幾肌嵐蝨
孰	郭敦鶉汍塾熟執墩槨燉廓丸惇淳享諄醇亨咦哼烹爹多褻
箋	摻餞淺盞塊篾朗蒐殆颱鄉戍麼錢槐踐愧線殘茲參慘棧滲筏傀賤笞乏鬼刃
陞	陸陛隍阡降陴陲阪陪陷陀阬弔除陽隆隘阮隙障陡防阱昇
稿	科犒矯蒿稠程禾穢稱嬌鎬嵩轎稍搞縞僑稻篙槁驕高租橋和秒
玫	致玨玳斑王玟玥枚玖畋敖敢珍玲瑜班牧玻珀玷珊政故改攻孜收敉理敝
髒	體骯髑骼骰葬髖髏髁骸骷髓骨朦樺曄膜嘩滑惜薨苛
棰	垂陲睡錘捶  
永	令含脈郎予之泳漾念吟芝樣蒸鈐詠丞岑拯乏今矛多
媽	馭騖驅駁駕馱瑪馮駙駝嗎馳驚駑螞馬罵駟駒騫篤騰馴駛駢駐闖碼
扎	扣把撲找揣紮手毛仙山拙牝尾汕甩攜批摧札指兒撬
敬	敔擎啟疾敵改警玫數矢敞散敖斂矣故畋牧儆收敕敢敝敉檠做枚敦
澱	鍛燬搬殿緞瘢發廄臀轂殺殷股沒投疫芟潑殼般段
祁	社郎祀邱祉祈祆耶邦那鬱邢祕祐祖神祚祥祿鄘鄭鄴弔
蕊	芯萄葉荀苟芍蕙蔥惹菊苞惚燕慕葬慈蔔葡廿葛菜蘆莽莫茶苔恙恭苗思
凝	擬礙癡疑冽次凍準冰凌冷冶馮凜凋臧茨雌邶此北丸爹勻
轅	遠猿轟園車輾轄輳輻輯輜軋輸轉轍輪轎轔輕軾軛輓輊軻軸軼軟軒軔軏
亙	俎雷糯電砠孺姐需助擂且燸疽渲同楦恆肝儒喧嚅狙懦宣蛆祖沮濡租阻青粗宜咀
簣	隕槓貴績潰臢債遺磧積賡櫃貧嘖賁損匱蹟鑽賞貢圓賽漬實
腹	扳膾復板夜伋各鈑股覆皈返複冗冬晷反胳臉愎腋肌馥
蘊	絲縲羅累系濰細氳紫絮紮紊素索辮綑喲納繫繁緊糸繹縊編綸媼
懦	雷糯電孺而憂需擂耑燸擾惰優情壩恆儒耍亙嚅鐳灞愉濡蕾蠕惴
瓢	飄剽狐弧孤呱瓠瓤瓣瓜標膘漂嫖鏢菰票瞟縹驃鰾
黝	黑點墨吆勳脅似幼黠默爍窈黜玄奚鋤慟劫黷拗拋黔黯姒
邏	囉儸鑼玀蘿籮還羅遝環澴寰鰥楞愣篾爵甍蔑夢
尊	撙樽遵蹲曲曹寺守專辱寸對村肘吋忖付農導尉射封
堤	隄場怛坦匙提題靛塌袒綻晝垣定是塒緹暘但壇錠
縴	絃縞縲絲織締綏綽絞紡紋縫糸綵絹結絨終絆細統糾
抱	砲刨拘苞皰劬泡炮胞跑匏咆鉋包巳袍鮑庖雹飽 
囿	因宥洧侑餚鮪男有賄鬱崤咽姻胃恩疽胭茵困回囚四田淆畸髓
熬	無黑埃疾焦嗷疢矢煞肇敖倣矣畋放鼇灰灸羔邀痰恢尺傲炎遨贅聱然燃
撻	躂韃達拄撾撲擁拉擅摔搞搓攘掖掠抗擠拈抖抆撞接羋羊
呃	扼軛桅脆厄跪詭危卮喱已己倦捲蜷踡配啄範呢杞妃氾忌苑圈範
墓	慕芭募意漠昔惜膜厝糢蟆措摹草蕞莫摸藺萌模錯借寞幕暮冪驀音蔓葛
苛	奇柯河坷呵何荷阿可蚵軻訶寄倚崎椅畸錡葬婀啊琦犄
貊	貍豺豹貂貓貉奭陌佰霾弼墾懇百解宿梔刀貌脾脹脈射洹初叨切彩衫迢
綾	稜陵凌菱絳絡終縲結絲稷繞續級線傻絃紹紛繒繙紇後纏縫糸
玲	令零泠玳琴齡班玫聆拎蛉羚吟玨瑜鄰斑鈴苓領憐鈐冷嶺佺伶珍
隋	惰佐隱橢隔院陋阮陝陽隆隍隄隘隕陵陸陰陷陪除陞際降陀險阬隅陌阻
房	妒坊防廬爐肪舫枋戶妨菸彷簇漩倣遊鏃驢訪芳紡方旁嗾淤仿瘀
隱	陷急隄陞院隕陪際陶穩隔背險陋弔陸癮隋肛阮除陌陰陀阬隘隍陽阻
卑	啤埤勿朱脾裨箄碑笮笑箠仟千陴鼙顰牌痺睥婢舌俾
瘡	蒼傖槍滄搶愴嗆鎗倉艙餐瘉痊疹癢疙癒食創奪飧
偶	遇寓隅耦禺愚邁癘藕佃萬倆俚傭伸侮佈禹厲儸甲巾每
綰	棺倌琯綻綜館縮繽管菅縲絨絲絹結緒縯糸綺綿綵綏締緯緝縞絡給絃紹
曇	雲師震雩雨雪篩獅珮佩瘺霎黴零靂霍霄雯霽雲霑霖霜幟漏
溯	滑漕湖漠涓港漓渭洋湔潸厥鋼岡塑潮濛清逆闕漢灘崩綱崗溢洪滿朔溝
槁	稿搞鎬犒縞蒿嵩篙橋僑嬌矯高轎驕膏婷檀濠壕嚎停杭樸槌
髭	鬚髡鬆鬍疵髯髦髻鬢髮鬃鬣齜此昆庇屁雌能紕毗枇沘批妣仳
蒙	仄巫籐萵矇蘸恫菔蔡且朦同葷菁苜壹濛檬瑩煎前剪銅塚桐胴丙筒菜洞
南	喃楠冊皿卅柵盅姍肺芾沛灞幸甫畢辛血岡扁珊盃苦侖孟宜宰朕益盍盂
喱	量哩釐嘿呃裡僮幢憧撞潼瞳鐘纏理裡埋娌浬俚鋰黑
驛	馭騾駁澤擇馱駝馳鐸騎驗馬駟驢駱駒騵繹驥釋馴駛駢睪駐驃驍騷騁譯
埔	哺捕浦脯補鋪圃匍莆輔誧博傅搏溥膊甫縛賻蒲
呂	呈埠啟咯兌侃克聽櫚呼莒阜鋁吒沼烏侶營兄況叭咋帥召宮閭嗚哀咒招
埃	唉挨俟矣域嫉墩矢廠族壙敏傲攸嗷撤澈蜘遨轍敖畋枚玫知倣做傚嫩撇
概	唧節慨即杷查僭潛蠶溉朽卿杳廄鯽桿根暨既簪
吩	扮汾份粉紛芬氛分拐枴叨岔忿盆刀貧寡砌召招沼昭炤迢初盼剪棻
哉	怡或戴專裁蕙迨名鐵載惠怠笞栽苔臺始治擡截胎
嬪	妹繽棕臏檳濱渲梡嫁傢姑喧殯婉儐妓淙暄賓佇嬸鬢錠
炫	絃弦鉉眩舷玄畜爍炕縴蓄熾嬤吆以幻玆樂焙禳鑠幼姒似燧亡奚茲幾藥
盹	芻肫縐趨目沌鈍眇眠盯眼睨睢屯囤盼純飩睫睞睹睥睡瞋瞭睬瞄眺睏想
坐	隹雁焦難唯催雉攤挫仕售淮堆癱惟椎座錐崔灘集推銼進
降	隆阪絳峯陵烽鋒蜂扳洛恪咯胳烙格咚逢略鉻返版板鈑
瓠	匏狐弧孤呱瓢瓤瓣瓜菰胯垮誇巧誇跨污圬以愕虧鍔姒雩萼
竟	瘴竭獐意漳憶噫幛億鏡童璋暗樟章立障韹站臆音妾黯靖免境
右	若祐匿偌惹君吝吞佑知智口大各癡裙癌郡羣慝暱諾
造	浩皓誥酷窖告逞糙呈燻衽妊任壬迢廷望薰桔迨過拮遣醺飪聖靠吉
鬲	仄痘富言豈碉融砠而隔硯籥同巖拿哥泵膈詛盒命鎘豆嗝三翮合鹹二歌鑰硼石
羽	櫂瀚羿翻翔煽擢翩扇翎塌翹翱褶翁翅翌戳翳習嗡翮遢栩濯曜摺翡翰榻
左	奈痘奇病誇痞大爻二症疳疽疸痙一旦有灰疝疢奭三仃短
飾	飭餘餒飴餞飲館餡餵饅饒饑餌餉餅飪飩蝕餚飢餽
肘	村忖吋付膊寸寺守封射尉對將採耐紂博傅溥搏辱專尊
怎	乍戶肩扁房戾僱急笮昨柞炸咋妒作扈所窄扉成方乃殷砟祚
秒	秋穢稍揪愀啾鍬禾程稻祕秈和私鞦鰍香委番移稈稀嵇稜稔稱稿稼稷穆
曷	褐藹竭謁歇日意蠍揭靄象噶曰昌羯晶暍昀易碣渴是愒旦杲遏葛喝
豈	痘豐登逗脰短豎愷炭巖皚崖岸豆剴凱嶝凳壹合豉磋覬
豺	豹貊貍貂貓貉財材霾閉射才墾懇解榭黎秩衫彩杉彤刀曆
班	琍玥王球琴玳瑕珪珊玫瑚玖玩瑾理玨瑰瑯誑逛斑琳瑭枉玷琉琊玟瑟琺狂琅栓珀
駕	加馭騖架駁馱瑪馮媽賀嗎馳驚駑袈螞罵馬駟駒篤駛駢駐闖碼
翱	羽翔翩翹翻翅
陸	陵逵睦陞陛陡弔陪陷隍除隘隕陀阮阬陶隋陽隄院凌降陋隔稜隙障際險
悲	誹菲徘匪罪非排靡俳輩斐徊屝痱啡靠霏裴腓扉翡
悄	捎哨膛趙俏擋檔銷屑蔽撇鞘稍鐺廠硝睄鏜襠梢峭肖尚宵逍消誚噹帩
兀	元光完沅虺嶽阮恍洸晃胱軏山一孔北兆此玩梡莞髡
槃	盤磐般瘢搬疫芟殷段股投朵毀殿穀殼役慇亢篷骰毅毆殺設鍛杭
汕	涔水氾沌湍山汝汁沁沐汨沖札仙扎兒淦沘汗汙池汐汛乩汴汶汀沙沈汪
撞	倍啦陪潼焙漳憧垃憶噫鐘泣接億暗樟培拉位昱僮幢瞳臆笠喱涪黯童
窖	造浩窘窩皓窄告酷誥窯竄窗呈窮竊窟薰竇窒聖空穹窪搾衽搾妊任
鵡	鵲鵑鴿鴣鴨鴆鳴鳩鶉鵪鵠鵝鶴鷂鷓鷗鴒鴉鴦鳶
臾	陷鼠與身諛寫裒舂閻叟舀萸瘦滔躬舊庾臼稻焰腴樁八啗搜舅潟兒
夾	卒俎巫愜疾雁痊癡筮傘疥雉坐嫉疙瘁頰來陝座莢萊狹峽挾浹佺銼俠挫
黴	御徠很徵徜徹律復衝彼徇術徘彷衢衡徐循徉從徊梅侮徒彿微銜往徨每海街衍悔誨晦徙
悔	憔嗨毒佃敏母惟梅侮姆莓愎愉每海恰拇繁毓黴誨晦愴憮
吻	物囫易惚勿忽惕錫刎踢蜴賜匆啤必咆剔泌鉍唬喋怠
馥	黍香扳穀閣復稔板夜飯伋各稷鈑覆皈返複皮冬傷晷反偺腹俊處愎傻稜格
凰	篁徨惶湟隍煌遑蝗韹皇珀風斑班旺鳳筐幾玨夙框珮痊粕逛栓荃拴柏腺
探	深琛採掙授揮援搖撚捐控掬崢淨揉換揹浮持搽搏損睬俘拖扮播擂錚靜
倦	胖畔勝呃扼謄範桅半蜷己踡脆拌賸券軛已卷圈伴絆騰滕捲跪姅苑譽眷
鉛	沿釦銳船銘鉻鍋鋁谷鍔鎔銻金痲麻裕銨錯錢錡浴峪錨俗鎬鎰鎘鎗鬆鏜
貳	膩噸嶺蘋巔癲籲傾澦擷瀕式鬚頁項頊頌頓頂煩碩顫贛
直	慎滇植闐鎮填姐肺且脤疽矗真值沛誼具芾冠置殖沮二宜瞋俱咀
送	朕逆迸擲躑立艾遂鄭泣拉垃道位哎遭辛音若笠昱妾羹
趁	越趙趨彬趣起穆趟診陡諺澎赳超疹膨走珍趕赴
半	胖畔倦勝火豢手叛拌賸券卷圈伴絆判滕捲姅拳眷
擷	頡噸瀕傾澦蘋貳籲碩嶺巔癲頷頜煩頊贛頁囂鬚
霸	壩鞏革緙羈鞘需灞鞍鞋靼鞅靶勒雷電鞣鞦鞠靴
剷	薩產劃鏟剩割劑剔釗制刻利判刑劃刎刖刊刈剽劂剴劇劉劍劊副剖剛剝
雒	唯雊碓喀落雕擱雉誰稚雄礁各睢錐進椎淮推惟帷堆離雜準僱奮露
釙	鉉鉸鋅鏑鎬鑲鎚鏈金卜寒針釦鈿樸撲僕鐘詹卞
閻	焰陷啗餡闋諂門閤閣舊關閭閑間閒悶閉問閃閂
弦	吆藥玆似幼以爍炫樂鑠茲弧玄關奚眩絃畜嬤鉉幻幾舷蓄亡縴姒
腳	卻叩啣唧仰欲溶熔榕鎔蓉鉚御柳迎泖抑聊卿鯽卸裕浴峪俗節容茆昂命
見	莧攪靦窺硯覲覺蜆覬比觀筧規覜覓能現峴覦視
訪	詞訏訴防訥訢旅詢訣許託話妨誅記詳謗詐諺誠訃討詁計謫詛訊紡方該訐註訕詨訑仿
呆	吋保喳架噪棠口木咻澡燥宋牀杲採堡品森葆藻籲林咪喇嗽褓橾
怨	鴛忌苑息恿急想憑己已夕怎忍悶惠多名危感厄憩懋宛紀桅栘侈脆惋杞
芻	趨鄒洶頓煞沌忌盹囤皺匈屯噸雛鈍縐息肫胸飩純
註	訃訪詨謫詛詐訴詁訥許訣該詳詢誚記訐討訕訊託訏訑課誰計訂諒諳識
傑	桀侈舜憐燐遴俑舛保璘伶磷麥舞轔鱗麩仔令栘侯蹂麟你健夕乞
阪	降隆扳返版板鈑陵陂皈叛阡販咚洛恪咯胳烙格逢略鉻客疼閣
孫	遜蓀係孤縣鯀孔孑菰孩孜孺吼系糸懸細潔素累
錦	遑迫鉑湟幫啼怖怕帕帛綿腺棉柏瞞煌滯佈鈽嗥泊拍伯惶滿
蟋	蟲蟠蛛蚱蝗蝙蜂蛾蛞蝌蜊蟲螳螺蝶蜢蜴蜷蛇蚣呼悉
邦	豐鄒郎邸幫邵郃鬱邢梆耶郝弔祁鄴邪鄞郊邱椰那都郾郡鄗部郢綁郭鄭郵
象	像橡豫色間惟曷旭免渴揭愒喝遂遏葛陶煦歇暍意竭碣褐羯澗恰憮憔億
嚥	燕哎噶嘩囌嘆囈瀟蹣瞞嘻嘈滿嗟哄咩豆謨磺噫噥諾噎磁瑛韉啖噗嘶剴
盂	盥盈益蜢盟盎珊扁柵鹽盪皿盆盜於錳盒盃監盛盍孟冊盔盅猛姍
疳	甘柑坩鉗虛某媒煤嵌甜蚶左箝酣謀芣芋爻瘩墟噓
拙	絀窟出咄攬掘崛倔扎毛茁黜屈笨甩微批祟摧指撬橇
睢	瞿瞧懼崔雛目椎進淮推惟帷堆唯錐離催摧瞼攫
桔	檮杏橈告檣吉潔梧黠結售圯桂拮造嘻浩樹杜櫝格周檯
槍	飭稔檜蒼飧艙創滄食搶倉嗆傖白梅瘡檢鎗飾餘伶愴榆栓
眶	框筐矚匡班斑目睏盼睢玨盯睛睦睜瑁瞧鼎瞿眼眠盹眇睫睹睥睞睡瞋眸
羸	嬴贏瀛肓娟羞硼崗羋羊亡謠鋼綱啁胡咩氓迅霸葫菔崩茫前恕差庠盲芒
頫	頰題頤碩頑頊頓煩項頂頃頡頜領頻頷頭頹穎頒頌顆覜須願顛顧顫顯
伕	趺扶鈇夫芙佚麩替年攆失推俸倩輦窺休仲件伐夥仕仙伴佃傭什佯僕迭
消	捎哨膛趙俏擋淡檔銷屑蔽撇鞘悄稍鐺廠硝沙睄鏜襠梢肖峭尚宵淌逍誚噹帩
姣	咬校鉸狡皎絞蛟跤較鮫詨餃傚交郊效嫡六父妨
音	意章竟立暗竭妾昔昱童瘴漳樟億憶噫臆黯笠站泣拉垃位煜障獐幛境璋
銘	酩茗名夥移栘侈爹多汐夕鉛矽麥宛鉻鈴鍋迨胎殆治擡怡始釩舛外舞苑
峻	酸扳菱蔆板梭唆各殿稷鈑綾返峯浚痠冬岌賂竣反鋒俊販陵鉻駿稜凌
諸	署堵屠楮渚睹嘟箸豬者暑賭緒都躇藷赭煮褚儲奢著
秋	傑科鰍香秤揪秈禾鞦愀番啾稍稚稞鍬委租愁祕和私秣秒
熔	鎔繽縮谿溶俗駝綻豁鴕欲谷裕腳穴容卻峪綰蓉榕壑烤綜慾浴
繅	緇絲縲巢錙淄臘輜邋經絃糾縴繒繙獵綵纏綏蠟繼綠細綑糸
捺	蒜淙棕漂嫖糉標膘噤襟鏢崇綜賒際瞟驃察奈蔡
簑	衰篙畏煨猥喂偎簪蓑笠篷澶擅壇檀裹竺筵籬還餵羶懷壞迴娉
滄	飭泠涔淪汽蒼飧艙創洽食搶渝倉嗆濮傖槍白滌瘡鎗海飾餘伶愴
巖	儼釅嚴萼鍔愕靈囂襄囊闡簞器岸哭禪嬋彈憚崇單咒區蟬嶇鄂
搶	掄捨蒼擒拎飧羚艙捻滄創食撿倉嗆傖槍拾白拖瘡鎗愴拴
佛	拂例側芥氟疥費鬥事沸倒彿界俐伸尬紼仲介候怫弗喇剌串
筠	均鈞昀勻等籌痣志猿誌特釣的灼杓妁地冰丟壬篛芍勾勺
焰	啗陷諂餡閻滔燄臼樁稻蹈潟韜舀舊煥躬炊舂裒
量	喱釐旦糧裡旺黑裡理浬晅娌埋哩僮鋰潼撞憧幢俚瞳鐘纏
貞	偵楨幀禎貝員鋇負頁目盼則財狽貫貨責敗貼貽賁貴賊賄貲損圓賤遺贊
縯	演夤縝絲繽緒縲綻綜繡細組紅紆糾縮綰糸縷縑緘緬綞緙綽綠維絞絢絰
宏	太汰肱閎宥丈叉雄篡老者杖協仗宋安守卉穴寄寮十釵
侍	待詩恃寺痔持符奪傅仕咐峙傳等特對時府付封 
祕	科香密秋稅秈禾番必稍稚稞鉍委蜜種泌租秩祕和私秣秒
春	泰奉奏秦舂蠢疸俸捧棒疤昌痕暮者揍湊榛樁昔杳暑替晶瘍臻輳
氐	昏底低泜抵柢胝牴砥祗衹詆祇婚邸紙舐式二些
獰	猜嚀猾猙狩獐狎猿猥獲檸狠猖獷狸獗狗狄狷狙猓犯獨寧濘狽狂猩猛擰
酸	梭浚峻唆俊竣駿痠酪酬酷酩醋醺醣酉酵醇醉醃醒醞醮醱釀釅酣酥酗醜
勤	荔劻脅勒謹茄勵幼助饉覲瑾肋勁叻鄞功勘劫堇僅勣
旅	坊防旗施肪枋旌妨菸簇倣旎旋放房鏃訪於芳旖紡方嗾族淤仿瘀
刁	叼長伺帚虐彗司匡侵倀套浸張悵尋脹萇慧一屍屋框婦掃雪筐
嚮	響饗餉晌鄉向箋襖巍鬼魏朗箴蒐奧幾麼雍廊喬參笞晉高庸唐餽魎魍燠
誥	詰詻詔語諮誌諉詆設譟話詬詐託誡誤誘詫詩詼詣詮諒談諂諾謂訟譆譙
磴	證燈橙澄嶝瞪蹬歌砍磊愷登禮澧皚醴體壹磋砭矽吹閤
威	鹹戊崴喊戌減滅戚茂竺箴槭簪戍成衰佞歲緘表長後斥斤姦城畏竿竽底
鋅	梓闢辭莘宰辜辛辨辦辣滓瓣辮辯釙鐘僻避薜薛癖
脆	倦詭厄呃扼範侯桅蜷配己踡軛已圈危卮捲跪苑
民	泯抿岷氓眠湣愍氏叫她妁吆忘呶偯喪氐吳昏衹襄
蛾	蟲蟻蛞蛛蚱餓蚌峨娥哦俄蟠蟲蛙蛭蛔蛐蛀蚶蛄蛆蚯蚊蚪虻蜂蝙蝗蚣蟋
描	菌貓撙拼拱擭擂撲苗茴曲搓搭瞄曹措播搽撞拚摸搆茵錨
囚	泅畋田界人四因回困囝囤固囿仄欠佃八思胃囫甸圃圉仙仕以什仲僕夥
紳	組約細絀絢紅繡糸維呻紐坤紗紋縷砷糾紀練縲紆絆申伸紂紼納絲紲神純
戮	櫂羿僇翻翔擢廖穋扇翁翅戳翟習嘐寥膠曜繆謬栩濯羽
否	不痞甭盃芣示壞杯歪奈宗平丕蹙炭祟票祭禁禦呸滅碳燥
裏	童埋理狸暑著
倌	棺琯綰館菅管官耜估傢佇佗儐什做倥傳倨使仗刮個捨
枇	毗沘批妣仳紕昆庇屁比能楷砌牝叱化棍皁尼它
閤	答閃閥洽拾恰哈磊闋蛤給磴詹闈簽籥問閂門儉
姿	砍準恣嵌之玖汀打資瓷欠次懿丁蚵欽灸叮久炊疚坎諮茨吹釘冰氨欣
更	胭埂鞭笛岫胄哽冑因粳咽恩迪妯鈾柚油由姻便袖茵抽硬甦梗宙
溼	涇涯沅污潛渥滋聯汪沍畿溪漯湮潔潭淺逕濃紜縉佞圬汙汗汀濰亟丞
張	急畏彗悵漲刁佞煨脹伺叼賬弭弘偎辱喂匡虐弼引萇帳表長倀司弓
惦	怡店勾勺佔慘憾圖憬拈沾佔乩惇砧站玷帖廓霑勻
俱	俎植懼俏偵直颶仁姐琪佞脤且佰侑齟傭值供棋具箕淇其祺沮期信伍欺咀
珀	凰遑琍迫玥王湟鉑珞班怕玨珠篁帕瑰斑碧陌白柏煌蝗隍拍泊伯惶 
黨	當棠掌常尚賞裳嘗儻噹堂鐺襠檔擋讜肖儅鏜膛炯
鵠	鳴鴣鵑鴿鷗鵝鵲鴨鶴鳩鵪鶉鴒鴆鴉鷂鷓鸛鳶鷺鷹
愜	夾挾峽浹俠莢狹陝頰怩涿啄悴塚琢悵塚尹暱柩惟俎快伊恢懾匈來巫坐
涔	岑泠汕湍鈐吟今泛滄昤念含令嶺捻唸拎伶催鈴漾摧璀黔攜泳洮苓
摞	累騾螺
酊	酉配酌酗酣酥酴醜醣酩醋酪酵酷醇醒醮醺酸醉醃醞醴釀釅酬
黎	黍秩八答簽籥曆筏禾才種稔豺番香委秀篌篠符稻潘穆漆稚雅穢程瀝祕
鎚	槌追鏈釙鎬鑲鏃鏟鉉簞糙鎢鋁攘孃壤嚷襄曩詹
諧	請詣諾謀謁諂談諉謂諍諜認階診諳誼皆讒諺謊謠偕揩訛楷訕讚諒協謐誌
迆	池弛她地他迤也牠訑馳拖快忖悚施柒柴迂迷速卜卞
胰	姨咦仇夷九痍軌肱肋旭究友丸朋央奐疚然奧胭朕肚鳩肌汍醃為月染筋
侶	鋁宮莒閭呂侃櫚營促嗚保俗儼阜谷俄侷帥依侏俾倨倘咋佃何佔作伯估
擲	躑鄭挪梆娜哪嘟榔椰朕送郊槨螂瑯綁邶弔爺廊
矽	砍歌磊石多砝汐侈栘移碗夥磴爹砂研砧砠砟破硝碌碓磯磷夕泵
鉋	袍胞炮泡抱咆砲苞庖跑鮑鉤飽皰包匏雹劬刨鈍
錳	蜢猛艋孟鎰鑑柵盆檻溢盂褊濫隘遍溘溫慍媼塭嗑襤偏好仔李孚字囝
慍	媼溫塭瘟醞偏盧溢溘嗑遍褊錳濫檻鎰襤鑑跚氳盜侖
圃	匍哺埔捕浦脯莆補鋪輔甫博傅搏溥膊誧蒲縛賻
碟	砲葉礁碳碘磋洩礫硃研諜磴碾泄碰砥磕泵牒硫碣礦世蝶喋磚硿磊磺石磁屜
蝶	葉蟑蜢蟲蝠蟋蜻蟆蛄泄蟠蛇蠣蛐蟻蝙牒蚣蛤蛙蚶世碟蛆蟒喋蝸蜴蛛諜屜
帽	幌瑁幔冒幟媚湄楣幀巾幅幛幡瞞帕霜幃幢帳帷帖帆湘目廂箱
如	娟茹娛女恕姑始口扣釦嬋姦品脣好她妁妃奸妒妞妙妖奴妍妓妊加妹姐
捫	攔們擱門把僩澗嫻燜問悶閑間閒閃閂簡捏憫潤藺
滋	淺藥漕湛漠瀟港漯漾濩洋孳湔茲溪滷滲濛幽濃濺溢溼慈灌洪滿畿溝磁
磊	磴研砰言石碩硬硎砧砠哈泵巖筒訾答磋碳歌銅碉硼碓硿硝喊礪砝砟砲
逕	涇徑經輕莖痙氫巡逗逼陘勁邋頸言這姦災淄佞錙巢衰些
宙	笛軸由妯岫抽油柚迪袖鈾聘冑胄釉婁曳申娉鼬
燉	墩敦槨廓孰郭鶉教敉枚橄撒遨邀澈撤撇擻嫩嗷傲傚做倣攸淳惇唉享
願	頻顧穎顆頂願顛頃頹頒題頓頡頤頌頭顫原顯頰顥碩項頊頫頑煩須源頗類頜
努	荔劻劾奴男另茄幼虞助劬勢怒伽肋叻駑恕劣劫吳痂咖力勇觔弩帑協脅娛
蔡	察際蒜祭賒崇膘棕淙捺鬃標糉瞟漂嫖噤襟鏢綜縹擦驃鰾
嘗	嚐當掌棠裳賞常黨尚堂稽肖噹叱旨膛擋敞敝檔脂削炯襠鏜鐺
也	悚心木施弛筷迆馳忖池地柴她柒拖快他迤牠訑
伊	咿尹裙君窘仞侷倀倨伺侵倔偃仲夥伐休伏仕仙仗作佃侑仇什僕人
舟	制唷育澳舫自向坍迨血舨艙艦梳丹流母舢幟船艘舵艋航舷奧熾泊堉艇
紀	組約細絀繩絢紹記繡絕糸維紐紗紉己紋糾妃縲紆紡絆紂纜納絲紲純
毯	耄氅淡毽談啖毛耗牝氈尾毬麾毫燄痰炎氮娓撬橇
立	倍啦意焙垃泣煜接菩暗培拉章粒位昱竟站笠音涪辛妾靖童
滾	滴六漓澴涪涼濬流沆濟泣注沾汴汶淑袞冥漳滂潼澶淳液淬濠濾瀘嫡姣
竿	旱乾肝桿汗奸罕竽竺軒橄鼾筮岸訐捍悍焊桿稈敢刊銲瞰
牠	物牛牡迆池弛她地他牝牧牲牯馳也拜訑牴特看
諮	請詔詩諾譙謀詼諂談謂誤誥認譟資諭詻證語誼次訟諱詮識訂試姿詠詰誡諒誌
檀	澶擅壇羶槁杭樸桓氈檜樟槽楊桿顫槌查渣喳梳棹柱枓簑
練	煉絲縲細紂楝鍊揀絆紗紆糸維絢繡絀紳組紲紋純紐納紀約糾緯綵繙綑
厲	萬席愚禺寓勵厝瀝薯蠣藕礪瞞偶癘懵遇邁躉滿歷襪
吆	嘰礫玄叫以幻爍譏鑠似姒喲奚畜茲樂藥呱機呶拗絮關
店	惦佔拈沾佔帖玷乩砧站廓貼點臺藷圖儲黏京外諸
泱	怏映秧英殃鞅央沈盎沖瑛鴦油津滿巾沸洩淵渙滯澳
致	救室玫屋到窒敖矣畋臻倒侄握孜至喔敢渥攻枚姪敘緻
託	訏訴訥諛訢詢訣許話誅記詳詐誠討訃詁訪計詛課訂訊訐註訕誚詬訑詫托
豉	鼓豌芰頭吱肢歧枝技岐妓愷壹皚澄嶝燈澧橙磴
洽	拾恰哈給蛤答汽閤磊淪減渝儉洞澄撿檢臉鑰滄險瞼瀲石合簽籥
墩	燉敦槨廓孰郭鶉埃教枚撒遨嗷嫩撇撤橄澈傲邀傚擻做倣攸敉惇淳唉享
沱	庇它跎屁濱枇駝佗蛇比妣仳鴕呢怩妮紕舵汁瀋陀批能毗匕沘瀉昆
娉	聘騁妯圬污誇虧朽巧兮柚袖迪岫抽油鈾鼬婁畏笛宙粵
誰	譙許訥詮課諛誣誚詳詢註詁詛詐訣討訊託訏訑訕記訐計訃訂訖訛
撚	燃然撈撫換採恢痰疢灰援掙探授搖詼揮捧攫揪央
仞	塊蒐刀麼槐倔伺忍愧倨紉伊傷軔偃叨份傀召超分初俄伐韌侷倀鬼刃
笠	倍瘴陪獐潼焙漳憧垃憶噫泣鐘接億菩撞暗培樟拉立粒昱位僮站臆音涪妾
亡	罔卜虻芒盲丐巡茫肓女雍炫亥玄氓弦忙妄忘畜鉉裊荒杗
弓	引欠弘小子夕久弔又幾了九醜丁乙夷門鬥弛弭弼粥
踩	跎跦踐蹈趴躁跆蹊蹂睬蹲跺跚踴踏蹦踱採蹉蹄蹣距菜踝足趺跟躋彩
欐	曬灑儷驪麗邐鹿鑣棍麒枇鏖麓麋塵麂楷毗麝麟能比沘批妣仳昆庇屁
軏	轟軒軋軻輊輛軛車軌軟軸輻軔軼較輔輓輥軾輕輒
漠	慕墓瀟膜糢蟆濩湔摹莫摸模濛寞幕暮冪謨滋灌滿
籟	癩獺瀨懶簌賴秉速悚初乘束漱辣嫩嗽喇箱犁梨禿敕剌利
麼	嬤摩磨糜魔麾靡窈蘑鑠麻玄茲畜奚藥朮嘛爍姒似吆
提	捏隄堤怛坦匙揭題靛袒綻撮揚掖定是緹擅暘但捍錠
聰	蔥聒恥聶耳職耿取聊聯聘聆耽耶腮懾傯洱弭茸
巒	言譙訾跡蠻礫謄鑾灤戀謎譏鸞灣奕變謊縞攣孿絃絮識繃縲織燮彎訕絲亦磯縴弈
孛	荸悖脖孚字學孝李勃俘浮存季子好囝仔孕索孱籽渤
罩	罟棹掉悼置買眾罰罵罪罹卓綽羅羈楞愣寰遝澴還
禍	祠剮猾禧滑萵社窩咼祀過禪祐祝祖鍋蝸媧堝渦福禳視
渡	鍍踱淺治度浚滲濂械拚戒弁摭樑遮泳洲減滅溥誡獷擴壙曠礦浦浪庶庠
螟	暝瞑蟲蜩蝸蛆蜻蚣蟲螃蝙蝗蝓蟑螳蟆蟀蜢蜴蠔蜆蛟蛀蚊蚪虻蝴
啣	御卸唧仰叩腳迎抑哈聊卿柳鉚泖鯽蚯喻丘節昂
塑	漓茁圭厥鋼岡逆薹墮溯朔肚崩崗塋基臺角周檯
鐮	釣鈸簾謙鉛歉鍍錢鉼戒廉嫌公弁濂賺鋪鉗縑兼忪鬆鏽
迢	炤昭沼招超韶紹貂詔召叨初刀分造解賴切忿券岔
騙	馭遍驅駁偏馱扁駙駝馳編匾馬駟驢駱駒騵駭馴駛駢驕駐篇
解	懈邂貂招蟹賴迢炤昭沼初叨挈奐勇分詔超絕韶紹切刀盆忿券岔
什	仗估午佇佗使佬杵倌倥傢儐人缶傘仟值十卒率
孔	孑孜吼乳孤孩孫孺遜了菰蓀兀嶽危扎仙札兒汕弱預侯桅脆溺孓光元亨
閉	閔閒闊閱嫻閨門閏閘閡間開閂閑材闈才閎問閭悶聞闖闌閃
商	嘀嫡摘滴適鏑六迥高謫交向袞冥脊兗炯過尚滾銅鍋
著	裏諸署堵屠楮渚薯睹箸嘟理豬狸埋暑者賭緒藷躇赭煮褚奢童
歡	砍歇歉歎勸玖歐款觀飲欲欠次欽崁罐坎炊疚畝軟吹鸛歌欺欣
娟	捐涓如狷絹娛茹婷婿胡咀硼始喟損嬋嬌湖啁恕高亭葫臺豪嬴
甕	壅甍瓦臃擁甄雍瓶瓷甌亥妊褻牽畜衰玄逞造裒衷望多壬互夕遴移通逕
貝	賑鋇貼賄貪賠賅購賊員敗賀贖賬貨則貶財賂貧賭責貯賒販賜賺賤貽贈負
涓	捐娟浥狷澡湖絹渭清滑潸濠胡咀硼湣治沿喟損潠況泯澠啁高亭葫臺豪
彼	徠很後陂破律復徇玻彷疲皺跛役被循徉詖徊披彿鈹皴往波坡皮 
胥	疋婿蛋楚旋漩踩礎蹈內跚蹊俘嚏胃肯肓育閒有膺走足肉丙朋佾吶傭進
鞘	革捎哨鞭鞍俏韆鞣勒銷鞠鞦韉霸鞅悄韃稍鞋硝睄靶梢峭肖宵逍消靴靼誚帩韁
給	組細縮紜繪緯絹緘紹搭糸洽維絨結哈蛤拾縲絃紆綵緝綏綸綺合塔恰納紇絲答 
鍬	揪愀啾鞦鰍秋秒稍禾琍俐穌酥潘播墦逶倭蕃審痿愁萎秦
位	倍僮億垃拉泣僕立昱笠粒住佔儕培接涪焙暗妾音菩蓓
沖	油津沈沸泱洩淵水中汨沐沁汝汕仲汁引淦洮川
夔	賂販夏鈑處鋒鉻疼客骼蜂詻路酪略逢峯格烙珞胳舨咯叛恪洛皈降咚板
仃	短矢叮打汀知釘倚盯矩雉丁訂酊奇枚畋佇汽崎椅畸矮旖錡矣疾寄斃
肆	套津律建筆肄聿肇屋渥握喔腱健鍵冽刁叼毽帚雲
絰	緻絲紆紅姪紜縉縲組細維紐緬紂約糸絢蛭絆絀紲紱紗紋純納紀紉糾繡
灞	濡壩淪鐳糯蠕燸懦孺嚅擂儒霸蕾芾擾優渝清沛需
鎖	瑣銷鋇鏜鐺鑽貝貧賞員賄煩鈔貼敗財狽盼賸賤賊損貽則貞負頁賽贊圓
蹣	蹄躇躪蹉滿蹲瞞踩蹼踫躑足蹦蹈踱踐踏跆跚席
煤	芋謀嵌甘火某甜焚爍疳虛蚶於鉗燒烊媒烤災炎柑祺烘箝酣坩
芸	冽蔭蕨薑動藝紜運仁甚黃壽雲耘莖魂竺三戡其二
兵	丘乒乓嶽西餘全佰合仁卸邱廣酉具其真佞何汽侖佺伍捨俞哂哈恰拾拴
樁	榛棒舂湊揍稻臻輳秦奏滔焰捧啗陷韜俸諂餡蹈臼閻舊
謝	詩討榭諛誅詬話訴詐訢託諉誥諷謎誑訛訓課訣訕訏訑計訃諺誡誘詻詆
嵯	嗟磋蹉差羼烊洋咩佯羋羊庠祥鮮蘚描控措捱拭拯扼羣詳徉菁氧
陽	暘暢揚場腸煬楊鍚颺隄瘍隊限袒隍陷除陞陀阮阬陌阻阡弔
均	釣坼坷準凍杓坪垢勻址妁圩地壞勺鈞灼次筠的昀痣城芍勾圻坩冰埔志
俄	哦娥峨蛾餓義件儀我佚傀鵝作伯任仟蟻牛係侏俾找議入
砸	碾磊匝碉碼石砷砠砟斫硝碘確啼諦礪硼泵常命
在	書布刈存晝畫希佈奄怖建鈽褂中土大帑唏俺薦陡庵健掩晞淹烯陸醃菴
夠	苟拘齣令泠予拎移哆枸佝狗夥駒鈴苓栘侈爹鉤庖雊伶矛多
作	妒窄仍偏任僱戶件笮砟仟詐蚱炸肩乍咋傀祚昨怎伯仿柞
精	晴清情倩睛靖猜鯖蜻菁請積青漬嘖債糊磧績米
子	孚字仔朵獐李彰荸籽脖孛悖悸孝厚季閑俘存章障好錳孱孟囝浮享孕
諶	謀謙謹詳譁詛湛堪訌訕訏訐計訂訃諾謊謨譜諫誰諛課誣誚誧謫該誠話
刀	召分叨初刃切份吩岔扮汾券忿招拐沼芬昭枴炤迢
璨	瑛粲瑕珞瓊珪班琦玫玻燦玨玲瑜璋斑瑁琛愾玷璀璿璟琉璩璘玟瓖璃掬琥
嫻	欄閑攔瀾爛斕閉蘭籣澗僩燜櫚捫們門闌憫潤好闈簡
狠	娘很限狎墾痕猖狸眼垠狄狗狼銀狙退猓根犯狐恨狂懇猩艮
拿	合偉盒命葦闈圍違幃韓俞登侖會儉緯仁答翕拾恰洽哈
母	每拇姆毒侮海悔梅晦莓誨黴育敏毓嗨迨流梳堉唷熾
屯	芻囤沌肫鈍盹匈頓縐趨洶純胸心山岱飩噸包愷鄒雛
蟬	禪憚彈嬋蟲簞闡蝠蜈蠅蟲單蟠蟀蟑螳螺蠔蝸蜿蛤蛇蚣蛐蛔蛄蚪蚌蝦
鰥	遝鰓鯉鰻澴鯧還鰭鰾鯨鯛鯖鱔鱗鱖環鱸楞愣鮪鮭鰱鯽寰
辨	薛僻辣宰滓癖鋅瓣霹梓辯辭辦辜避莘闢薜辛辮 
照	詔炤邵貂京刀談阜韶紹啖燙沼煦昭熙迢煬叨召超分初炎招
荒	罔芒虻盲蒿薺網魍茫肓菽菩氓慌謊忙妄忘芳莘惘芷蒂蓄萃杗亡蘆輞蓑
侵	浸伺候假倀夜寢殷股投沒殿叼健段般婦役掃設殼毀骰毅毆穀暇煆瑕遐
燾	壽籌檮濤疇儔鑄禱躊堠社坎蝨雲彌瀰弼強蚓壞圾
強	蟲蝨搔蠡騷蚤蟲蜜螢蚣蝕蚓閩蛀蚶蛄蛆蚱蚯蚊蚪蚌蛔蛐蛙虻虺繈蛋蝨
摯	墊執舛丸孝舞汍痛桀爹堵軌熱勢麥究多宛舜夷夕丈九麩傑哮
蚯	蟲蛤蝓蛆蚶蟲蛀蛄蚵蚱蚪蚌蚊蛙蛭蛔蛐虹虻蛉蜘
翡	扇翳栩翔翮翻翅翩翱翎翹羽斐悲裴輩靠羿遢翟翌習蓊翕翼翁煽榻摺塌
擰	豐獰嚀捐擋擂擒按檸搾捷擾技撮搏挖撚搞擦損拷攜控採寧濘撼揹摔撢
瘴	樟漳獐璋蟑幛障章暗草音憶噫臆億蕈意境鏡黯
魚	鰍鱉鱟鮭嚕鮎鯉鮮鯛鯧鮪櫓漁鯨鰓鮑鯖魷鱷鮫魯鯊薊鰭
荏	任花葆薰壬庭荷蓓荃茶逞淫霆告呈荼衽挺梃程妊
薑	芋葬蕨彊會蘸橫僵票蕈黃疆芸簧莖芣量竺殭三璜蕾韁磺
雨	雷霽霞霜零靈雩霎霪霆霰霄雲霹霧霓霑雹雪雯霏黴霖震霍
匿	偌若暱惹諾慝右艾展祐哎屏君荔茄落區叵屍荻莢摒智朕送郡羣裙知吝
肯	止啃歧歲芷企扯址武祉趾遺步正遣青背症貴歷焉怔逃涉將賦
熱	褻藝熟勢丸執囈汍爹熨摯墊痛疢灰多夷夕九封
耆	嗜旬鰭怛昏荀筍昌恥悍洵恨杳昔晶惕惺愒慢憬
猿	遠轅園袁狷哀猥猖狸狠狗狂猾獐猩獗猜猛猙獲獰狩獷獵猓狼狎狐狙狄
罕	肝旱竿幹桿汗奸瞰訐軒銲橄岸刊捍悍焊桿敢鼾
豭	假遐瑕煆暇蝦豕葭霞豬豳豚逐毅據噱遽邃豢璩
膩	貳拭試軾弒賸臢項頁式碩煩頓頊頌頂顫代貴責貢
諱	語詰諫訣討謀諜諮諾謂諭諳諼諒談諄請諉諂論諍誼誌認誡誤誥謨試詩
豆	豈痘逗脰合登豐同石哎短磋韋壹喜哄咩豉碰碘愷磁噎磺
嗡	蓊翁塌榻煽遢翰蹋瀚嘐羿摺擢濯褶曜櫂廖翟習翌翼
纜	絀細攬繙纏絹緲繒絕紹糸紉紛紀編欖縲絃繃綵綬緝覽縐綏紇絲
狐	瓜狎瓤狠菰瓣抓呱弧狸孤狗狄狼瓠狙狹猓犯瓢狂
癢	娘良疒養艱浪痕蒼飧餐饗食滄疳搶饕瘦倉嗆槍狼苓瘩瘡療病餮鎗癘疼餒琅饜愴艮
舶	迫鉑舫舨艙艦怕帕舟舢船艘舵腺柏艋粕艇航舷泊拍伯珀
撬	橇耗尾毛耄氈麾氅毯娓拙髦毬牝扎毽摧掘攜牲
刎	剔勿忽剃吻囫易劃刖利刨刮制剁刈釗剩物惕惚錫
金	釣鉀釗父鉛鏈匹針錢鈉釦小六鈷鈇釙丫谷鈿公欽穴共鈍鉗只銅鈔四淦分釘鈕鍵
漂	噤察鰾糉崇縹棕際捺票蔡飄蒜標賒襟嫖淙潭綜膘驃鏢瞟
窗	傯囪總窄窠突究窖空穹簾窮竊窒穿竅窘竄搾搾
燥	噪保炤焙絹譟躁棠澡禪葆區操吋褓呆藻緝否橾品癌
擠	霽齋儕扯抆撲薺拄臍齊抗拈掠接劑掉拉摘抖濟躋
擻	藪數撒撇撤挨嫩攸邀橄遨嗷傲做嫉徽瞰燉墩緻徹澈微黴傚倣埃唉俟矢
疢	灰痰然恢煞瘠大燃炎爻熬火撚疝炙傑盔有左狄偽
鷺	鳴鵠鴿鴣鷹鴦鴛鳶鷗鵑鳩鷥鷓鶴鸛鶉鵲鵪鵝鴨鴒鴆鴉
塽	爽爻堵垮土痍美餚圭塊鈸堆淆鎂埋埂垠垃坩坡拔圾坎壞坍地圯圩崤埃
皺	鄒陂破皰彼玻菠煞疲跛被詖雛披鈹皴芻波坡簸皮頗
獗	猜獰猾蕨猙狩獐狎橛猿猥獲鱖狠猖獵獷狸厥狗狄狷狙狹猓犯蹶狂狽猩猛
詖	破訣討諫設詐被鈹訕訊託訏訑計訃訂課玻波披坡詻
駟	馬駐駛駒駢馳馱馭駁騾驛駭騙駝駙馴駱騁駿騎騷騵驃驕驍驗驟驢驥驅
郡	羣邵部郃鄙鄗郢都郊鬱耶郾那鄭啊郭郎邱祁邢邦鄘鄱鄴君
腔	控崆倥硿空潸邃窒搾搾挖痲麻穿穹弒胝臏肢肺窕窠窄突簾究穴竊
碇	綻錠
鬃	鬢髻髡鬍髯鬣崇髮髦鬆髭鬚綜糉棕淙蒜察蔡鏢襟噤膘標漂嫖捺
蟒	蟆蟲蛐蚶蟻蚣蟲蟑螺蟀蝶蝙蜢蜿蜈蛉蚊螳蟋螃螟蟯蟬蟠蝠蝸蝗蝓蟾蜻
癘	邁藕禺愚寓耦遇隅偶厲萬希躉瘩席布襪滿薯夢禹懵勵瞞礪鈽怖佈
航	舫炕舨艙艦抗舟舢船艘舵伉沆坑艋杭吭舷舶艇
洱	弭耳茸聶取泥恥耿氾陬聞餌攝懾囁鑷椰趣耶汁揖楫躡輒爺聱聲聳聾
兇	兇匈狄犯息兄見沉狂侃比狎狙狗虎狠狽狸狷臭猖猓荻逖媳熄獗
憲	害寰菁患毒罹精睛靖晴情清猜倩青廳磧積績請漬嘖蜻蹟嗉債鯖聽
犬	淚鈸夫獻偽袱哭大默拔畎畚狀吠溴捩伏唳嗅戾突臭莽天疣尤為
氨	氮氛氣氧氤氫氟氯氖氬氳晏愾按邱汽銨薴安佇何鞍
嘔	嫗嶇樞軀奩驅區品噪操橾櫺闆歐甌鷗毆喔呢囑叵咖
無	蕪撫憮嫵舞庶炎借佯併供夥焦羔疢炙傑灸灰焚然黑煞魚熬氮痰蔗火淡
槭	戚滅減喊茂杯戊慼歲威鹹機棕棧械枰標樽簷梭邇梂延村戌不上髭蹙
偽	伏伐袱代犬傭俟疢灰今跋畎吠夥傖俊伶倏倉筏食念含令
玉	瑩去王璽班琅球瑭璧匡全汪弄玥法枉旺怯砝瑯瑰
腿	褪退艮堰偃銀眼根恨垠臃痕跟臍狠限腋鼴丹朧髓艱很肪齦臆良
測	鍘鋇側貝貸貫賃貴賢贊員潰洌賀廁貨費涮則惻責貲貢濺漬買瀏狽
邃	遽豳據噱璩逐豚豕腔控崆倥豢硿豬豭空潸搾搾挖
千	啤垂埤朱重脾裨茱箄恬纖括仟盾卑乖遷侏活痺段婢株舌銖俾阡
煙	湮曬迺哂西鋰酉醮醺甄酒酷醋煩酣酥酗配酌酊醜墨醫蘸
輩	漣陣鏈範軍菲庫徘匪悲非鰱轟排俳輦載斐徊蓮屝痱連車啡靠霏裴囀腓扉翡
胳	咯烙格略洛恪鉻骼珞絡貉賂路客詻酪駱閣咚各
惟	憔推淮堆唯椎進雊錐隹崔帷準雄睢碓稚雉離雜罹
彿	律怫拂沸佛往很徊徇徉徵彼彷徒徙徠徜紼行徘
煌	遑湟惶徨隍蝗韹篁凰皇線珀旺綿潤斑班腺嗥棉銓栓錦拴佺鉑粕柏迫泊
玟	斑玷玨琉璃王玫玥汶抆琥璋璨瓖班玖珊玻珀蚊理琢瑰璿瑕瓏文弄
耋	室窒屋老姪耄輊至絰蛭倒緻姥佬渥握喔致到臻齷
溢	遍異益褊媼偏鎰拱暴縊港嗑塭溫潠供盆哄檻錳慍濫隘烘襤賽鑑溘洪蓋 
邁	癘藕遇禺耦隅偶愚寓萬厲遵遭滿襪躉蹣瞞懵席
項	頂頑頊煩碩頸頤顫頃頓頌頫頜頡頻頭顆顯須預頒頗領頰頷頹穎題顎顓
撕	斧薪聽拱晰昕淅浙嘶廝斤沂析逝掀嶄蜥圻芹斯慚漸折近匠
闋	葵睽揆癸閤閻闕閣閔閏開閎閃閂閥門燈橙澄嶝
埂	哽便梗硬粳更甦鞭坤壞圻圩坷坪由埋胭咽姻柚袖迪坩妯岫抽油鈾垣圬
橄	瞰敢桿檄嫩做枚撒遨邀撇擻嗷傲攸肝汗奸桿竿旱
嗨	敏毓海每晦梅悔侮母莓姆拇嗓誨唷流黴毒繁咐呶囑匯蒞泵
鵝	鴣鷓鵠鵲島鵑鳩鴒鶴鳶鶉鴉鳥鴦鷂鴨鴆鶯鴛鴿鷗鵡鷹鳴鵪鸛
昔	慕廿芭臘鵲募意墓惜厝措摹獵草蕞莫萌暗借錯幕暮音蠟蔓葛
儂	噥濃膿穠農佞澧槽遭嘈漕禮偎蹲醴體撙樽遵糟甚
牢	牟牛件湃宅牡犁看寫我生失毛牠牝牧牯牲軼牽犖犛審物拜特眸
駝	馭騾驛驅駁馱媽嗎馳佗騎鴕驪沱驗馬罵駟驢駱駒騵駭驥陀駛駢驕駐驃驍駿騷騁驟
拔	鈸紱跋髮找犬捕搪拚擡挨捩爻吠畎伏拭摭撼拗
娼	唱倡晶昌猖鯧暘暍曝婚暗嫻媚惜措袒捏借湣涅坦怛僭但潛澗錯汨日曰
押	擇呷柙胛鉀甲匣狎擺曼閘賣摟捆拇澤濁獨曙燭鐸鐲申薯
鬍	鬆鬚髯髡鬃髻鬢髭髮髦鬣葫蝴湖糊瑚胡居箄苦鈷蛄牯枯沽姑固咕估
沂	折圻聽析昕近所斫祈斬斯芹匠新浙淅斧訢掀漸斤
避	劈薛僻宰滓癖蘗鋅檗瓣霹梓辯譬辦辜莘辨壁闢璧臂薜辛辮擘
部	倍郎陪邵郃鬱邢邦耶鄙剖鄴祁郊鄞邱啊那都郾鄱鄘郡鄗郢郭鄭蓓郵
璧	劈薛襞僻癖玉蘗檗霹譬瑩辜避壁闢臂璽薜辛擘
凡	汎釩帆梵夕幾弘亢冗外名朵汐肌舛丸反歹多泓
暇	霞芟奴穀夜瑕骰蝦殿殼沒浸股殷假遐又葭豭投毀設般煆毆候侵段毅疫
震	賑霽霜雨辰霎脤霄振辱雲脣靂宸霓霑娠雯雪晨霖霍
軒	軻軸輥軏軼軌輛輔較轟軛軔輕輻軋輊稈杆輯車軟幹軾輒
儀	蟻議義俄我曦犧哦娥峨樣漾糕膳餓蛾羲繕鱔對鵝件窯
雅	牙邪鴉呀穿芽蚜椎訝稚碓準雜琊雄進雉雊睢淮推惟帷堆唯維錐離榫樵
袋	裁岱依裘襲袈貸裟裝褽裂裴製襞黛衣裳裔代玳迎
褡	搭塔瘩郃襪洽拾恰哈頜鴿答荷荼荃合褕蛤劍閤拿
伋	吸圾汲岌級及仍反扳阪板返鈑俊偺殼各冬閣仔你叛皈伉咚侵咯恪洛降
灤	灣鑾攣戀彎巒蠻變孿鸞礫譏謀諜爍潔樑漯綵絃濰
跤	餃跡狡趴交郊跋鉸效趾踫絞膠跚校傚躂姣蹄距咬踝足趺跟皎躋蹼 
猥	喂煨偎餵猓狸狎畏猜獨猩猿猾猖猙狷獗狩佞獷獵玀猶狼狠狙狂狄
桅	檮倦詭厄呃扼範侯杞蜷配己踡脆軛已圈危卮捲跪苑
絕	紹紛紉縲絲紀線纜糸結絨絡絳絹綏絃終綵綿緝編緹紇縉縐縮繃縵縿織
禮	澧體醴磴燈愷瞪蹬橙皚澄嶝壹證祥穠禧膿濃噥儂福祺
階	媲混崑焜琵篦諧隙價比皆偕揩陛棍陀琨楷隍毚錕介餛鹿罷
仗	杖佬什丈估使午老者考孝杵值豬佇佗倥酵做儲缶宏宥傘
沿	鉛浴淦汾釦治船沼洛浩涪渦涓浥溶銘鉻澡鍋涕鋁泗水品谷
唐	塘搪瑭糖醣庸康允庚劃州官傭慷慵臺充中戈口哲倌班蚤強洲耜棺菅鄉
策	棗棘箱笨禾租稠稱稻刺番柔香委秉稍棚秋相柵秈和私
筧	莧覓峴覺蜆硯視現規見覜覦靦覬覲觀窺攪算篡能比
蚶	蟲蛐蚯蛆蟲蛀蛄蚵蚱蚪蚌蚊蛙蛭蛔虻虹蟒蟆蚜蛟蛛蛞蛾蠅蚣蛤蜻蝶蝠
捂	違葦寤拓圍梧齬搭撿語吾唔悟拾鼯五拮韋擡晤圄伍敔偉招
璟	憬瑁琨晾玷玨景斑班璃璨瓖琉珪珀玟王璜璣璘璋璀璩環璦瑤璿琿瑛瑜
貢	貴槓責項員汞匱簣工潰遺貫貨費買賈貲質贊鋇
婦	掃歸帚伺帶浸侵叼彗虐刁雪帝慧啼嫦妮姬而啻耍蒂
勇	湧奐肋踴男另筋脅瘓觔喚換渙煥努劣勢勞力助叻勵
華	嘩樺曄譁荊蕨莘苦芣芰芾芋卅萋著苛葬甘芽葫薜薛黃厝薴蕙蕈芸蕾妍
走	卒坊越趙趨夜卦趣趁起垃址趟胥陡迄徒玷定赴坑迤是玟赳超足疋趕進
絲	縲糾絃細絆紗綠紂約糸絢絰絀組紲紱紋純紐納紙維練緣紀紆紉繡絨綏
現	莧攪靦瓔玥珊班窺瑤硯覲覺玨蜆覬瑰觀斑筧琛瑁見規覜琨覓峴覦珀視
黯	瘴點獐意焙漳黠默憶噫諳黜幛億璋鏡暗樟培響障黷黔闇臆黝音境
歙	次翕歌砍羽栩飲欲吹磴嘐謬翮翻翔翎翅翟扇茨羿
專	團傳栽磚守轉惠哉寺尊辱截寸村肘吋忖付裁載尉射封紂對糰囀
嗷	傲遨敖邀倣唉熬做嫩撇撒橄激檄擻繳攸放埃聱贅鼇
臣	臥臨宦臧藏贓堅腎臟鑒緊豎賢叩鹽匝印即卯初泖卸茆柳姬聊鉚
鳳	夙凰風鳥幾鳴鳩鴻鶸朵鳶鴃鴣鴨鴿鵑鵝鵠鵡鵲鵬鷺
向	制迥澳掌襖餉自血爨噢棠懊當響咱晌喬尚高奧炯筒釁燠
淞	崧淋沐鬆湘鬆淅渣漆濺瀨沫決公漱頌泓淦波林嗓樑忪錢水森
檻	遍盞褊楹藍偏籃柵艦嗑磕闔錳濫監盍襤瞌尷鑑溘蓋
歟	與舉譽欽嶼歉欺畝歌欲砍欣炊玖坎吹次撳嶔歐歎歇款飲軟疚
羣	羊磋裙鮮搓詳洋咩徉氧祥羼郡君烊嵯嗟羋蹉庠佯
濫	遍盞褊藍偏籃艦嗑溫磕檻闔監盍襤瞌涊溢尷鑑溘蓋
紡	組坊約防統細絀綽肪旅枋妨糸紐紗紉紋紀縫絞訪縲絃絆方織紂紙納絲仿縴紲純
礎	楚磊旋漩疋磴噤碎砭歌破砍胥磷礁磚礫磋磅碾碟碳碣碗硿婿硫碓砧矽
畝	炊欽坎吹砍軟玖次歌歟久疚欲欺款欣飲歇歉歐歎歜
卡	下上斥迂此正丐卞言坼定拆是柝訃柴迺疵逗訾逼齒穢
僖	嘻嬉禧譆喜熹僥儔侍仕售倍桔拮嘉僱遠催噎結檯黠鼓倖佳周吉
豎	腎堅賢緊痘登豐豈短逗脰凳臣宦臧臨臥服藏盒豆合報
痘	豈短登豐豎脰逗左奈豆痙凳誇痞壹合礬愷豉磋
悚	懶速束快忖辣喇嫩漱嗽也簌敕剌瀨獺秉癩籟柚棣迆弛她池地他賴柒
亢	芟迫朵颯炕蓬股返冗抗篷投般跺伉沆坑阬杭吭骯幾逢肌航咒疫
粲	燦璨
庶	度戒弁席廣蔗摭遮蕪庠械拚無廉憮撫嫵煎痰盞蓆蒸燕蕉薰戈渡鍍鷓
賅	核垓咳骸該貼駭孩閡氦敗財賠貝賄賑賬販賭賺劾賊賂貽貶賒賤賜則刻
翔	羿翻擢翩扇翎塌翹翱翁翌翅翳翟習蓊翮遢栩羽摺翡榻
郃	鄧邵邱郡部鄙頜鴿鄗郢邢搭塔褡啊瘩郊郎鬱耶邸祁都郭邦那邪郵郾鄘
侯	喉堠篌跪猴桅脆詭儔溺篛儼你仔天危乞佺侈佑佈傑弱伋仍健佩孑夜疙
逅	垢詬後近追迫減喊石鹹言箴迭返這造逗逼遣亢
花	仳靴化昆庇屁訛荏枇沘毗批妣佗能葆匕紕比屍荷疵蓓茶沱怩妮呢匙跎
羚	拎伶聆玲鈴泠冷蛉苓齡零令捻鈐吟侈羋羊羞岑
綻	繽堤縮緯絹提靛糸緩絨縉結締緒給縞縲絃綵縯綰緝緹碇綏綺綸綜絲錠縝
措	芭臘鵲拼漠拱擭昔惜厝膜搓搭獵草搽莫摸暗萌模借錯描醋音蠟指
驗	騾儉駁馱駙僉駝險騎籤撿瞼騁馬簽驢駱駒臉騵驥鹼檢殮駢驕驃驍駿騷驛驟
覽	窟出咄攬掘崛相倔櫬茁目盹苜黜拙親襯冒欖屈胃纜
諷	訴楓諛飈訢颯誘瘋飄託諉話誥誅詻詐詖設謝嵐詬風
雙	隻隹集焦售濩擭又奴雋穫獲攫健怪燮崔筵庭夜鍵錐護腱進馭椎涎淮梃
蠟	蛔淄臘鵲鬣繅蟲錙邋輜蝠昔惜蠔瑙蜻蛉蝓蟆螺措蟠獵蛇蟬惱蛤借錯蚣蝶蟀蝸蜈腦緇
今	令含泠貪涔稔聆拎羚念捻吟玲俯代伏筏俊鈴苓唸鈐妗俟黔昤岑冷伐伶
飢	飭餞餾飴餃餚餉飯凱饑饉譏餌飲餵飪蝕餓飼餡餿幾餅肌餽飽飾餒餘飩
漕	嘈槽遭糟濃澧曹曲撙儂樽噥遵膿漠澗禮穠蹲體蛐
玳	玲班玫代珍瑜斑玨琺王琴琳瑯瑚玥琅球玖瑰瑭璞琉佺璀弄
窺	規攪見筧莧覓覜峴覦覲蜆硯視鈇現覺靦覬觀窮窕竊窟
櫚	閭欄呂營嫻鋁侶問莒宮擱燜澗僩闆瀾攔爛潤憫捫們簡闡
絹	緝綏綵結縲絲綬紹糸絨絡給緩絃縞繃組細納繩綱綢
羹	羔窯善美糕恙姜羲義羨對膳送朕墨焦黑擲鄭薰蕉艾繕燻曦犧鎂躑樣鱔
厭	壓魘靨饜盟瘓百明奧奐厚煥噢喚懊換澳渙燠襖
莫	慕芭募漠墓昔惜膜厝糢措摹草蕞摸萌模借錯寞幕暮驀音蔓葛
挎	誇垮跨胯污
孃	壤嚷攘鑲瓖禳曩讓釀襄婷嬋偯喪囊鎬槁搞娛瓤
可	何呵坷奇河柯苛阿倚寄崎荷椅畸錡啊婀蚵犄琦軻
全	佺荃痊玨拴栓銓王匡汪旺枉皇閏餘弄狂玥詮合丘佰仁班斑
湃	牯牢件牛牟牡犁活牲拜泊牧沃牠牝豐看泖湩派洎洫物沂汎汁犄添眸浩
僩	們閒嫻澗燜捫門憫潤櫚攔瀾欄爛簡閃擱倩倡佾但斕閥悶閑間問閂藺蘭
冶	始怡擡治胎迨冷殆飴冰貽跆颱凜次凍準冽凋臺苔笞
料	科糉粹糖籽斟魁粳鬥糙米糠粒抖蚪粕糊敉斜粗斛枓
蹶	獗鱖蕨蹉跳足躇蹬蹺蹲蹟蹣蹦躊踱踐踏踩踡跪跎跆躪蹼跚趺趴
歧	鼓扯肯企址技豉啃山枝吱祉肢趾支妓芷芰止岐歲武
噪	噤咯保燥樞闆奩譟躁棠澡葆區操吋褓咖呆嫗藻嶇橾喳品嘔癌嚷唔
芒	罔虻盲薺魍茫肓慌忙妄忘芳莘惘芷荒蓄杗亡蓑
獻	獸器敵哭睿離獎默畎狀吠帝伏龍戾突啻旁臭現犬莽猷
蠶	蚤蠹概慨蟲螻僭潛蛋蠢虺溉蠱搔濁蝕晁蠡獨暨強繈蜴既簪蝨
第	弟阡弔梯陴涕陞悌娣銻阪幾隍陲降剃邶邪引筵
斷	斬斧祈訢繼斫聽昕新沂斤析掀圻所段芹斯折近匠
佗	跎沱陀蛇舵駝鴕仳它能化什妣批沘枇毗屁庇昆花
費	貴買員弗責貫貨賈貢賢贊鋇賀貿貸資貲賃質廁測惻側狽
扛	江槓肛釭紅缸虹訌工築槓汞攻功佐鴻巧貢項打折扯拓蚩
甸	心思慣佃慮勻苗田旬勺句匈膚鈿慍匐勾腮盧冀
煥	觼澳湧襖瓊喚噢邂懊瘓懈焰踴炊勇奐渙燠燃換
慇	怒疫芟毀殿穀殼殷般段股役投瘢骰搬鍛槃擊忝忽廄發毅毆澱殺燬設沒
快	塊悚心袂怯訣弛鴃筷迆缺也愧忖怕池地悄怏忸她惟忙柒抉拖他恢牠恨決
他	地她弛池迆拖迤也牠施佝訑馳休忖快悚柒付代仔仙仕僕什夥伐仲佃人
便	埂鞭儉僵仁佰哽粳儈價倆倫全氤偷由命佐伸合更餘俺伍偭硬佺何甦梗
竇	贖犢櫝瀆續黷牘讀賣窯窖窠簾窩窟窘窒窄突空穹究窪
筒	胴桐銅洞恫峒磊答壹同石硼言喊減脰洽拾恰哈
璦	曖噯琛玥瑤琿愛珊玨斑班璃瓔瑁珪現瑚王璩環璜璣璟璿璋璀瓊瓖瑞瑛
帶	帚婦掃滯帝啻蒂啼歸布慕巾帑吊常希老鈽怖佈締瞞蹄匝
取	耳恥耿陬聶洱耶趣弭耽聒茸娶最撮聰職支蕞聆揖楫聘聯聊叢聞
縮	繽繪緯絹佰繒糸綻縵線緩絨縉綿緒給縲蓿綵縯織綰緝緹綏綺綸綜絲繚宿縝
茴	苗迴嗇茵薔稟曲徊蛔回萬描錨曹菌檣若苦苟芯昔艾躉廿瞄牆穡
肇	肄建筆邀健肆腱鍵倣津律放僱聿毽敖竅嗷僱遨敷傲激檄族佈
碗	砍碳磋磷礫磊蜿磴宛碎碾磧砥磕砝矽婉硫碣腕碟惋磚詰硿歌豌砭石磁
暍	遏揭愒渴喝褐碣竭羯葛謁曷晶暘曝昌娼唱倡猖鯧
權	樺善橫構勸莒櫺糢萼樸又樣桔棋棺穫模檬吐歡樽械槁柑橾杈灌槌楛樞槽檯
暨	既概慨溉疸簪查僭潛晝蠶袒怛坦但三靼晅瘍竺旦晶暘
幸	圉倖悻報睪擇澤鐸卅繹釋譯驛辛畢坩芾芰弄苦
匝	砸巾布吊簾帛帝帥刷帑啻央市庸佈希帖帕怖帟席帷涮鈽幣滿
嫦	常膛噹擋檔襠鏜鐺瞠償儻尚撐螳讜當掌棠堂銷硝稍梢逍哨峭悄捎消俏
卹	血恤洫印卯叩卸即卻迎抑仰孵昂盆節泖柳唧啣腳鉚冊皿茆盪
擭	濩獲穫護攫搽搭雙隻摸描措摧蕉掖投推舊攜搓搆撲挫扳撒攤挺
哺	博捕敷莆誧蒲輔傅搏補甫賻圃鋪溥膊脯縛匍浦埔
爾	捎哨撈邇銷甭勞屑你敞悄瀰獼硝燼嘮不梢盃肖峭癆宵敝逍消璽盡儘然彌燃
鎂	美鉼鉗窯錨錯羔恙姜錐鋅銼鋰鉸對鈸鈿鈕鈑釦釵釙針鎰金羹善苒
肱	汰太宏肋胰閎雄叉篡朋央奐然奧肚肘胭朕釵醃月筋
倥	崆控腔硿空邃潸窒挖搾搾仁什穿麻痲佇但穹傢佗低弒儐估仗午窄窕突
蜀	濁燭鐲獨觸躅髑歜甲署睪罷鉀鴨胛柙押呷匣閘賣曼狎
屬	犀囑矚汴遲墀卞屝匪迨箋育母屍遮率悲棄屋尿每充痱扉菲玆舟戈職熾
蟯	鐃饒燒橈曉澆撓嬈僥繞蛙蟲蹺驍蟲螳蝗蜿蜷蛇蚣蛀
峽	卒俎巫愜疾崤坐山匈頰來陝莢狹崎挾兇夾浹俠
折	斬斧拆祈訢斫聽晰哲昕新浙斤沂析逝掀圻所芹斯近匠撕
洪	異巽寨暴拱鎰鬨港洋搴供潠哄共寒烘溢恭塞基
咀	組俎娟捐砠涓姐助且疽齟同誼亙鋤詛狙蛆祖沮租阻粗宜勗
脅	荔劻加男另勒茄努幼助劬勢伽肋叻勰功迦劣劫蘇辦痂咖力勇觔協
約	組釣細絀趵絢繡糸維紐絨紗紉勺紋灼紀糾的縲絃紆絆紂縐紙絰納絲喲紲紱純
隹	售集焦隻淮推惟崔堆唯仕進椎錐雙坐雀準帷雄僱雋雉雊稚碓睢匯催榫
藥	葉牀約吆似礫茶麼爍以窈孳樂機茲鑠玄關奚嘰畜拗幻滋蓄慈菜璣姒磁
撈	捎擋湧嶸勞爾榮熒螢肋撇營撚瑩嘮鶯縈癆拗拋捲勇澇塋犖筋燃換
雩	震雲雪雨雯霄霍霽霓霤霑霖霜霎靂霆霏霞霪霰霹露霾靄零黴靈
骰	股投殿骼殼般殷段穀毆毀設殺役疫芟骯毅沒髒體髑骷骸髁肌髓冗
穢	秒科稿稻稈程禾穗稼稱秤租祕秩秋秈和私番疵香委秀
檸	稼獰嚀糉植棕楮末搾檳楠梡榫枝枯杖榕寧棲濘榆棺擰
普	並碰踫並共井譜異基恭屏昌昔暴烘胼迸鉼拼拱洪姘哄銲供併曝
硯	莧攪靦碉砠窺覲覺蜆覬觀砟筧硝見砂規覜覓硼現峴磊覦視
叼	刁伺叩叨呎喔虐彗侵浸慧婦掃長雪詞嗎呢歸司匡帚
蝓	蛤偷褕逾瑜榆渝愉喻蟲蛉諭輸蚯瘉蜻蠕蜘蟲蝠蝸蝗蝙蜿蜢螟蜈蟀螳蠔
齊	卜齋霽文儕擠薺撲臍卞六樸主佔丹鬥下釙肅劑僕臼立濟亡躋上
圯	巳祀起吉巷僎撰潠選拮桔包周巽癌乩叱咄告袁售喜臺
嶔	撳崁嵌欽闕久歉簌羨茨嶝欺歟峪柩疚灸嗽漱掀炊坎吹
操	噪扣捐保驅燥揉闆奩攘櫺譟躁澡區軀嫗藻嶇橾採品嘔樞
係	孫縣鯀遜系蓀仰糸細傀低潔似累懸俄紂紀約紆依紗紋純紐納糾作伯絆
臨	宦器鑒賢藍堅臣籃險褕嬋臟蟬區除簞褓臧囂儼憚緊監彈贓囊嚴單豎鑑腎襄藏臥
餮	餐飧饗饕癢食養疹良琅狼浪娘瘡蒼殤傖珍饜筏鎗殮槍滄搶愴嗆趁診殊
嗾	鏃簇倣族淤瘀菸漩訪放枋肪坊妨仿房芳遊防於旁
悴	淬碎粹萃瘁誶醉翠卒傘惇懍懷摔掖液腋憧憶悼忙愜午
僅	瑾饉謹勤鄞覲佯備併供倩健僕債借聿津佰傭位伴仲件伕靖偌儀儂蹣筆
鵬	鶯鴻鶸鵑鳥鵲鶴鴣鴨鴆鴃鳴鳩鴦鳶鵠鵝鴿鷂鷓鴕鷹
臥	臨臣宦臧藏贓堅腎臟鑒緊豎賢鹽叩卯除褕附仰袱爪滌褓篠
攪	覺窺覓見筧硯視現規峴學莧覲覬覦靦蜆覜鱟黌
趨	越趙純趣趁起趟沌陡盹囤噸徒鈍赳超縐芻走肫趕飩赴
羊	芙磋達翔鮮搓羚詳洋樣咩羯羶癬徉羣氧祥烊差嗟嵯羋庠羞佯
育	唷撤朗徹月脊背澈迨肓梳流母舟幟職朋硫識胃姆琉疏織膊脯每拇有轍熾毓堉
褂	掛卦街畦桂掛娃哇佳奎鞋蛙閨堯鮭封涯捱崖圭
獐	瘴蟑子彰漳狡憶噫猖草幛億璋鏡暗樟章障臆笠音黯境
甘	芋垂廿墟嵌某煤苛甜甚黃疳芸虛芣一蚶鉗噓柑媒其華箝酣蕾坩廣
裙	咿洛吝佑烙窘路咯珞癡恪尹伊胳羣郡君右初襤鉻蜘知格略吞
榷	確椎鶴柄杵枚內肚榫樵栓鈉林杜吶榆檯稚樸梢桂雜柵柿柱相枕枉傭樸
鴃	鳥鴕鳴鴣鴨鳩鵑鵲鵬鳶鴆鴿鵝鵠鶴鷓鴦鶯鷹鴉鴒鶉鵡鵪鷂鷗鸛鴻鶸鴛
企	芷趾武址扯祉啃止肯歷歧歲步正僕遣症焉怔涉逃賦
簌	漱嗽籟掀梨欣利嶔羨痢嵌莉茨崁秉獺嫩喇速悚柩俐
潔	騾細鏍累吉絹漯絕紹繡糸嫘線維螺絨結桔紛纂嗉濰縲縈絃綵素綏絲嗦挈系
蛭	蟲蚵虹蛙蛀蚶蛆蚯蚜姪蝠蟲蛔蛐絰蚱蛄蛾蚊蚪蚌虻蚣屋室
認	誌誡試詔訟記詫詩詰詼談諍諜謂謬識詢詞詐討訑訕託計訃
砝	磕磊嗑石矽法怯碓砧砠砟砂研砍硝歌確磯去泵
峙	待寸詩博狩恃寺褥痔撙持奪將傅搏耨咐傳等特樽溥遵對塒膊侍時磚封 
鋼	鋇益脊剛鎰魍胼厥皿岡鑪鍰盆逆闕錳銅惘隘溯鍋綱崗冊溢朕鑑錚鏑朔
窿	薩穹隆竅窕郝窺窮蔭窪癮竊窈窒窄突空簾究窖窘橢猜都除耶郊邦
禁	夢噤碳杯棕宗票焚隸楚滅婪林耘祭不襟竺三示奈礬梵二祟禦
賦	武賠賒貯賑貝賤賜賊賂購貽貶贈贍贓贖賬貼則
瘸	痂肉架賀希駕腐袈吶加餚爻癖茄奩迦咖伽瘺瘟療癆脅痍病努
鑷	聶攝懾囁躡輒洱弭茸鋸椰陬聾聱聞爺輯餌耿恥取趣耳聲聳
冊	皿刪姍柵盅血侖孟盂扁珊盃益盍盔盞盟監岡朕胼
勉	攙免幼助劬饞逸冕肋叻輓劣菟劫兔晚娩勇觔挽冤脅
兼	金廿簾羊謙井歉甘並曲六齊廉肅嫌皿典臼鐮濂立賺共只世升縑羋冊
匠	所聽圻折沂昕析芹近斧斫祈斬斯斤掀新訢欣浙淅逝晰
槽	漕撙遭儂曲禮曹蛐模膿蹲樽遵濃澧嘈糟穠噥體
孕	乃孱奶扔仍字孚李秀季遊遊存氖孝孛學莠仔好囝透
泠	伶拎鈴玲冷羚聆蛉苓齡零滄令吟鈐侈汽海涔渝昤岑
疾	癡矣效嫉矢畋枚敉敝敖啟敕故知玫牧敞敢散傚敬改收敵數
復	待御徠很徵履後行徬彼徇覆複彷役徐從腹徒彿微得愎徨馥
填	慎滇闐植埔顛堵直鎮壙墳睿且真癲值壹巔宜瞋縝
禺	愚偶寓遇隅耦邁癘藕萬禹甲巾厲匣匝胛柙押呷吊鉀布躉
罟	置罩眾買罵罹罰苦居罪羅羈寰固遝澴還夢蛄枯沽姑咕鈷估環
網	綱惘魍綢輞綵綏絲綬縲組緩絹絃糸綑細紲紋納糾縴罔緲
過	寸守猾迥滑萵骼骨窩迨亂週遣禍襯討朋膏迢對啻蹦造時鍋高村蝸付媧炯堝渦撾
巍	魏機委嘰幾痿萎鬼饑譏璣魄槐逶倭蒐魅瑰魁塊愧矮傀峨
汲	洛扳閣板阪各伋沒殼鈑吸返浚及冬岌反級圾波極
狗	拘狄枸佝鉤狎狙狂狠狸猓犯狷苟狐狡狼狹狽夠猶駒猖猿獰
繳	檄激竅緻邀線倣絲縲綿縱緞紡編縫紕綞紋紙放繙總緹絡絳絃終族
淵	沖津沸油瀟肅洩泱沈嘯鏽蕭簫淒淦漢汨沂沐沁江汕澠汝汁濟潰洮水
嗯	咽恩胭姻茵傯喟氤喂舔嘿添哽哩呷因噹憾總嗶忝
蝗	遑煌隍湟惶徨蟲韹篁凰蟠蚱蝙蜂蟋蛾蛛蛞蟲皇
檢	儉檜僉險橙洽籤榆撿閤瞼驗哈簽拾槍給蛤梅臉鹼殮合恰鑰答栓
蚓	蟲蜓蟲螂蛹蜢蜊蜥蜘蝴蝦蚪蚌蚊蛀蚶蛄蚵蛆蚱蚯虻虹蛙蛔蛐蚣蟾
領	頻顧顆頂令齡頃頒題頓拎頡頤頌玲頭顯頰鄰碩項鈴頊頑頫憐預煩須冷嶺伶頷頗類頜
帳	脹張悵倀賬萇長漲巾帷帖帕帆幅幀帽幃幌幟幡幗
足	趴趺距跚跆跟踐踝踏踩躋趾跎跋跑跌跺跤跦跼踫踟踞踱蹂蹉蹈蹣蹦蹕
授	綬受採探掙援朋揮搖棚崩愛撚噯靜曖璦硼胴骨
緻	絰繳絲致縉縲紜紆緬紅姪絃糸緲綁繈紕倒維緒絞蛭組紱細紋紐納紂紉
歷	政科厲徵扯曆肯勵穢企瀝址遣啃祉趾歪靂賦壢步焉嫣芷怔止武歲歧症徙正
妞	忸扭鈕醜紐好奴羞妳奶妤娩妊如娃姨娌娛婿疆女姦
禳	瓖攘孃壤嚷鑲讓釀曩縞襄禪祉禧縴禍福絃禎祐祀
劓	鼾鼻川劃順州剷剽釧訓剋剌圳襪亞馴劃爪啞袖褲逸斤篾蔑箋蜇惡菟堊
植	慎滇棕楮直填鎮脤檳檸且楠矗梡真值枝棋具檬枯置杖殖桐棲宜俱
卅	辛幸畢芰芾苦南圉倖宰悻梓莘華嗶鋅廿十薴萋著楛葫蕙
雌	此疵齜毗枇沘批妣仳北比齒髭紕邶能昆庇屁摧詣璀催暹上
羲	曦犧義羔恙美姜對羨羹善墦儀窯禾糕膳蟻議琍
舫	航舢舶舨舷舟舵船肪艋艘艙艦艇枋妨坊仿房紡訪防彷旁芳
搾	搾窄柞榕潸硿腔控崆倥挖窖邃乍戶痲窮窗麻竅竊
濱	嬪檳臏儐殯繽鬢渲淙賓瀋瀉溶沱濘滓演汁湯潸滇
逶	倭矮透諉萎委潘播墦禾悸幡蟠繙穌揪愀啾鍬裒稟裹秦審蕃
漓	璃魑濠涼沆澶淳液淬禽擒噙流滾滂濬涪瀘滴濟泣沾注汴汶漣溯淑
鄴	郭鄭邢橢鄱鄞郵部郎鬱耶邱祁邪那邦弔鄰鄧鄙鄘鄒鄗郾都郡郝郢郊郃
悍	捍桿焊銲稈怛趕旱旬惺幹惕愒幹慢憬岸袒坦但桿肝奸汗竿旦
句	苟叵抱拘怡心苞泡炮胞旬回煦勺枸甸佝咆鉋包狗袍憚勾鉤庖雊品口
蚱	蝙蟲蛛蛞蛾蟲蚶蛄蛆蚯蛀蚊蛙蛔蛐蚌蚪虻蝗蟋蟠蜊蝌
倒	冽例側琍室咧致洌屋蛭到窒侄蜊握輊俐至喔耋絰渥姪緻
癬	鮮蘚烊祥蘇你為羋羊氧差庠羣洋咩佯痛痍羞疚羼瘓穌磋搓嵯嗟徉
揀	楝煉鍊練闌諫攔柬瀾欄爛蘭籣斕抹抉東播耒棟耦披
帝	匝幣簾敵獻吊啼離締帛帟帥啻旁巾蒂帑蹄布諦
胯	雩垮捺圬佞脤萼朽匏挎巧膿瓠愕醃奈誇污鍔跨
轂	鍛燬澱緞搬瘢發廄段殼股投擊疫芟穀骰毀殿殺般殷役繫
嗅	溴臭唳侃唬捩淚吠媳熄讚兄咯瓚臢鑽況袱克兌犬虎
久	灸欠吹坎炊疚癸欽孓之次玖柩砍飛崁畝登歌嶔撳
啞	氬亞堊惡哽嗤呸聽籲叮唔片蜇啄師哂呵呀啃喘啡喇串慄要
宵	屑鞘肖峭哨悄捎消俏梢逍銷尚硝稍霄廠蔽撇趙膛噹擋檔襠鏜鐺
曜	櫂擢濯耀躍褶穋膠摺嘐僇翟謬繆廖寥榻遢塌蹋
銜	術街衍衙衛衝衡衢桁行御徹微徵徘徙徊律徇徉很往徵彿彼徨得徑徐役
祺	琪棋淇箕麒其簸欺期祥祖旗祕祐祠祚祆祉祈社祁祀禮
能	庇比紕毗枇沘批妣仳昆屁脂罷熊態指沱怩妮呢佗擺襬牝皁
萇	脹悵張倀帳長賬漲茸苣刁芽畏莖嗣叼萋華彗辱苛苯苗虐芯芣芷芳芹昔
洎	咱鎳自臬洫湄澳癟邊首省眉算泊沈沃道媚楣湘目戛篡
慚	漸嶄斬晰淅逝浙撕嘶蜥斤塹廝暫鏨昕析近折沂圻聽薪芹匠
溝	耕講井冉構拼購姘並迸稱苒遘鉼胼併媾阱搆勾鉤屏
螳	膛鏜瞠蟲蝸蜷蟲堂蟋螺螟蟯蟬蝠蝙蝗蝓蠔蜻蜢蜈蛤蚣蛙蛔蛀蛄蛆蜩
眾	罟聚買罩罹置罵羅罪罰樅羈寰遝澴縱還蹤夢從環
彗	慧豐虐刁叼雪掃伺邦婦浸侵帚長梆烽峯蚌鋒歸
搏	博捕敷莆撙哺蒲持輔傅補甫賻圃鋪溥膊脯縛匍浦埔
婪	夢噤痳棟森焚淋爨逶楚萎妥林材痿禁姦委襟礎麓村礬梵安倭裹
覬	硯峴莧凱現覦覲靦覜蜆視規筧覓觀剴覺見攪窺
倫	侖掄喻儉淪輪逾褕儈渝儒傷傖侮偷綸愉論佺伶崙榆俞
耍	湍環而需瑞還耑揣燸要女寰儒妥澴耐嚅端懦踹濡惴妻喘
吃	屹迄訖紇疙乞吟喉哈唸喻噙乙挖嗆咻咐咿儉吶唯
管	狩箄恬菅古闊倌甜舐箸刮括耜聒官舔箠千蛞箇簞琯篙綰活宮笞舌棺館
榜	膀坊滂鎊攏龐肪枋楞徬嚨妨傍謗房磅芳方旁螃愣籠朧仿寵
販	賂鈑敗財賄返板扳貶鉻鋒貝貼皈叛賭阪胳則舨賅賬賺逢略貯貽烙格峯
敕	嫩收枚束敉畋數攸敝敖教啟敘敔赦敞敦敢散故政敬牧玫敵改攻矢疾矣
賞	圓隕損當棠掌常韻嘗黨員尚償裳賁嘖賡實賽簣貧賸臢
炳	柄病陋丙內煩仄吶鈉燸炊納竈訥傭煙燃巫肉光丕火炎蒙
皚	愷嶝澄燈澧橙瞪磴壹禮證蹬醴體豈皁皓豉白皇巖
綸	侖掄淪縊繪輪絹緯糸綻維緩絨結倫締編綿給縲綵綬緹綏綺納綜紇絲論崙
嘻	嬉僖譆禧喜熹噎吐桔拮嘉嗑結黠哎品周吉嘩嘈噪遠嗟檯嚥培鼓哄哇咩
繆	櫂羿僇擢廖穋褶翁戳翟習嘐寥膠耀縲戮曜謬濯絲摺躍
村	寸守寺專榭棟森尉射忖過辱襯林討吋材樽對紂時付肘尊封
緣	喙篆絲綠縲糾維組紗紐納紆紉紀紹紛蠡練緘緬綞緙綽緒縑縝縷縯絞絢
庠	戒弁羋羊咩洋烊佯祥差氧嵯搓嗟鮮度庶羼徉羣磋
骸	核垓咳賅駭該孩閡骯氦髓骷髁髏劾骼骰刻髒體髑
猾	猜獰猙滑狩獐骨猿猥獲過禍猖獷獗狄狼狷狙狹猓鍋蝸獨媧狽渦堝猩猛
裟	娑裘裁依裝製袈袋褽裴裂襞襲鯊衣裳裔沙莎嬝迎
惰	隋怖佐恢工貢情槓懦釭槓肛扛江汞愉捺恆怔攻功貴肯
幅	富擋檔蝠脰幌幃同帖鐺幟逼膈輻襠副幔幢帽巾帳噹幡福
貿	留買質瘤溜遛榴費賀貴賃賈貢員賢贊貸資貲貨貫責贅狽鋇餾
雉	奮雞矢奪雄進椎淮推惟堆唯錐知雊稚碓睢雒帷矩準離雜難仃隹崔
簫	蕭肅鏽嘯筆笛繡爪瀟簍麼竹淵姊簾策筍笠笨第笮笑笆竽竿簣禹臼抓八
皿	侖盞益盟珊血扁柵鹽盂胼岡盆盒盃監刪盍孟冊盔朕盅猛姍
暑	裏諸署堵屠楮曙渚睹箸嘟理豬狸埋童者賭緒都赭煮褚奢著
賭	諸貝貼賄署堵屠楮賊渚敗睹箸財者暑緒都貯販躇赭煮褚奢著
骷	髁骸髏骯骼髖髓骰體鈷枯沽姑咕估髒髑蛄牯骨苦居固
道	首導自遁逆洎咱算臬眉省送迸楣湄媚鎳邊篡遂備狽遘目筧戛苜纂
鈍	肫沌芻屯囤盹縐趨釣鉋鉤鉍純飩鈞噸恭匈釦鈿頓針釙胸洶金
早	草卓章覃昧晏掉悼棹漳樟撢潭瘴蕈日曰十暑幛獐障璋
庖	苞抱咆泡炮胞袍鉋砲飽雹包跑鮑皰劬刨匏巳弋夠句
雞	谿雉奮離維睢雄帷準奪奚雜雕錐雊稚碓進椎淮推惟堆唯瞿截
弒	殺拭軾試式膩代腔控崆倥朮貳硿述怵弋麻突空
逐	楊墜場豢豚迂遽豬劇豭邃揚篆啄煬迢璩琢腸據鍚豳瘍暘豕噱喙隊毅
旨	匕比指脂昆尼它庇屁仳批沘妣叱枇化切毗詣白紕能
侖	掄盞會藍媼篇偏淪仁輪籃塭拿溫倫皿盆闔慍愈偷盒命綸合盧冊瘟論盡崙蓋俞
慷	糠康慵勾勺怵憾怡勻棣逮慢惦匍愧悽釣悚怏怯怫忱杓灼忖妁慘懺州劃
捎	哨趙俏擋銷撐屑撇鞘悄稍拌硝睄梢抄峭肖尚宵逍消誚帩
臘	淄鵲鬣媼繅錙邋輜巡昔惜瑙剿措獵勦妥惱借錯巢姦災邕腦蠟緇
夜	迄掖液腋候健遐葭又侵假寢沒般暇煆瑕霞隻雙芟疫股返投段迤殷浸奴
淪	侖掄喻泠輪汽逾洽滄褕溫渝倫偷綸灞愉海論崙榆
飄	漂鰾楓飈縹颯颱票瘋佩剽標颳嫖珮諷瓢膘嵐鏢風瞟
港	溢洪潠烘拱哄供共異暴隘鎰巽寒塞搴寨鬨賽流縊瀑譜撕嘶基恭廝巷
蹺	僥鐃燒橈曉澆撓嬈蟯饒繞躊驍足蹶蹦踐踏踩踡跪跆跎
謗	磅諦鎊膀榜滂傍螃訪徬諺諳諒識謫註詐訃謂誼談諄請諉諂諍誶誌認誡
性	猜拜姓旌醒笙牲腥甥愧情怕生牛產隆惺星猩甦鏟
絃	縴炫縲絲縞鉉弦織絨眩綏締統絞紡紋綽縫糸終舷結紜絹綵纏細紂約糾
輯	轟輒楫揖車輻輾緝軛軒軋轄轅轉轎軾輔軸軻軟軔軏軌
澧	禮醴體濃澄漕愷燈橙皚磴嶝壹瞪證蹬噥膿儂槽遭穠嘈豉
餅	飭餞飴餃餚餉拼飯並迸饉餌飲餵飪蝕餓飼餡餿餽飽飾餒餘飢飩
曬	欐灑儷驪麗邐鹿鑣麒鏖麓麋塵麂昆毗麝麟錕棍焜混能比枇批沘妣仳崑
舅	虜甥臼鼠男擄舀舂裒閻舊力滔焰稻陷潟樁啗茵恩劣另筋脅竄臾身諂動
祟	宗奈票祭禁禦示岸出三碳炭崇竺二不滅些茁芣屈否齋淙捺棕杯拙咄壞
鐫	錐樵憔榫進椎淮推惟堆唯隹崔醮礁瞧離雜雊雉稚碓睢雄帷準瞿蕉奮截
樞	噪驅闆奩櫺歐框櫃區操軀毆嫗鷗甌嶇橾品柩嘔
筮	噬巫誣雁竽竿仄竺靈箴笨笙乏麼築簇蒙簪卒來夾坐竹戌後斥丙斤從俎
康	慷糠棣逮庸唐允庚劃州叟曼搪塘傭慵充戈水中強班蚤鄉搜嫂洲肆慢漫
鯛	鯖鱷綢鯧鯨鰓鱔鯉鮭鮪週惆啁鰭鱸鮑稠碉凋鰥鰻鰾鱗鱖鮫魷鰍蜩
結	絡細繞纏絹吉潔綾紹糸維紐絨桔繕給縲絃綵緝綏絲續綢
跛	踩陂破跡跦彼跤玻趴疲跋皺被詖跺跚披躋踵鈹跌皴波坡距趺踝足跟皮 
淮	推惟堆唯椎進錐匯隹崔帷準雄睢碓稚雉雊離雜
驪	欐曬灑儷驃駝麗騵駿驢驥驟驛驗驕驍騾騷騎騁駱駁駟馱馬
倖	悻圉睪幸仕擇澤鐸報佳繹釋卅譯驛隹什侍催僖僻
白	迫鉑箔皋皈皁滄怕搶啪帕皓倉帛傖槍腺的柏魄粕皇泊拍泉伯皎珀
摘	滴嫡嘀適鏑謫撲商擠拉拈拄抖抆六掉扯搞掠接抗撤撾攏
毆	殿設殷股投穀骰毀殼般段役毅殺疫芟歐鷗甌咒
疚	久炊坎吹欽灸痍玖砍畝次歌欠葵夷九欣欲軟揆歉歎
叨	初拐枴吩詔刀分切招沼昭炤迢召叩叼呎貂岔券忿
噗	撲僕樸璞蹼哄濮嘶嘆咩共哎烘拱洪供噶嘈嗟譜巽基異恭谷豆
芽	呀穿蚜牙訝琊邪雅鴉芋辱芣萇莖撐褥苛華葬才耨
謬	櫂請詔譙謀僇擢廖談穋諧謂譏認褶診戳誼諺嘐寥膠耀識戮曜繆濯譎諮躍摺
納	組約細絀絢繪絹繡糸維紐紗紋糾紀給縲紆絆綵紂綏綸內紇絲吶柄紲純
綁	統細綠綽幫績絢梆邦緲纖緞繡糸維紐絨紕緙糾縫緒縲絆緬紼綞絲縱繈緻
箝	甘籀疳某鉗墟噓柑坩籍箕箠虛笙生牛煤媒甜嵌簸挈簧垂搓酣描捶蚶措
堠	喉猴篌侯玳堆儔天壽夜燾健你伋仔揆瑜跪玲濤迄吃屹檮疇鑄葵癸昊疙
臭	溴嗅息戾哭突犬畎吠伏贊莽獻獎鼻器狀兔猷默獸
譜	諳識詣謨譁講謊諾謀誡訟謙詳議護諜謁謂談誌詰詼謹諶詢訕計訃
革	勒靶靼鞍鞋鞘靴鞅鞠鞣鞦韃韁韉鞭緙霸韆鞏蕭羈壩
拘	抱枸佝鉤苟狗駒夠齣句扣雊包掬拈拓泡咆找炮胞託撲袍扎鉋掏手庖苞
渾	漣軸陣軏鏈運軌軍輝庫揮葷暈鰱轟褲輦攆載蓮軋連車軟暉輞琿軒
霾	貍霪霰霜霖霑霆霍霄雪雨霹露霞霏霽霤霓雯雩霎黴雲
瓤	呱弧狐孤瓢瓠瓣瓜菰襄攘孃壤嚷鑲曩以禳瓖姒
孺	嚅懦濡儒燸糯蠕需孑孔孫孩孤孜擂鐳灞優擾壩蕾
繞	澆橈嬈纏撓絹綾蹺絕糸維絨結曉繕僥饒縲絃燒堯繃綵縐蟯綏紇絲續驍鐃
跑	抱砲刨苞泡炮跼胞趴跆咆鉋包跚踞袍庖飽距趺踝足跟躋 
吟	喻泠貪稔琴聆拎羚念捻玲矜嗆吃哈鈴苓唸鈐妗黔岑冷伶今
躪	躇蹣蹲蹉蹼蹶蹬踱蹂踏跺踫躑足躊躍躁蹺蹦蹈蹊蹄踴踐踢踩踡跪跆跎
亥	氦甕孩劾骸擁賅巡垓卞扒雍玄閡牽臃畜駭叭八該壅核咳亡逐刻
哆	多侈移夠
搔	騷蟲蚤蝨強蠡蟲蜜螢蝕樑蚣蛙蛔蛐蛀蚶蛄蛆蚱蚯蚌蚊蚪虺虻蚓閩蠱
瘓	煥渙換喚奐湧勇踴癆希痍疚爻懈邂觼奧痛厭夷友九澳懊噢燠瓊襖
甬	誦令育桶湧俑泓甭傭外涌蛹弘名宛舛矽桀恿歹捅甩夕用痛侈爹汐凡多丸通
纂	篡算縲縈系鏍緲漯嫘嗦絲紮省眉糸潔嗉累索騾螺細
那	鄒郎邸邵郃鬱哪邢邦耶郝弔祁鄴邪鄞郊邱鄰郾都郡鄗部郢挪郭鄭郵娜
砧	磊硫石玷沾拈佔碎圖砝砠砟砲站砂研砍硝矽帖碓歌磅佔泵店
飼	餌飽飩飲飪餅餉蝕飢餽飴飯餃餓餚餿饉飭餘餒餞餵
惺	腥猩醒星性鏟旌生隆怛牲姓笙惕悍產愒慢憬甥旬
寒	異巽寨暴拱鎰鬨港卉釙搴供哄嘶廝共騫隘烘賽溢恭塞基洪撕
域	國埃壙或惑胎迨始怡擡治摑臺冶塘幗去笞苔貽跆殆路飴埔城蟈怠
潺	漏渥遊孱浮李淳瀾浸涊沼籽季潯濫淨悸沒洱泥氾澱涮柩子遊孕
芬	汾吩扮盼刀氛棻粉岔砌紛貧枴盆忿剪叨份召拐分初寡
祠	飼嗣詞祖祝祚祐祉祈祀社福祕神祥祆祇祁祺祿禍司
言	磊這訾訃信唁詹計訕三答二石訂記訐討訊託訏訑訣訥許訟註詁詛詐詰
鑾	言譙訾謙蠻礫謄灤巒譏繒謎鸞灣紛變訟攣孿絃絮識謫縲織燮彎絲譜戀
大	夫文父尖太史疢尢矢尹因爻疝艾又夷灰力右左兇丈有夭九犬天
絨	縿纏縲絲縛絃糸結絹綏綻綰綜綵紜緝縮織繽細紱紂約緘
叟	陷鼠與嫂身康裒舂舀瘦萸滔棣躬艘庾臼颼焰腴淵啗餿搜臾舅逮曼潟兒
兄	況兗祝兌克侃競悅脫嗅銳剋息稅閱呂叭吒呈吮咋咱蛻兢
梅	嗨毒檜梳敏母槍侮姆莓檢每海拇毓黴悔誨晦榆栓
醫	酒醬酉醜醋酣酥酗配酌酊醣醮醺酴酷酩醞醒醴醇醉醃酵酸酬酪釀釅
遝	還鰥邏澴環寰楞愣夢儸玀囉鑼蔑薨篾甍爵罟蘿籮
壓	魘靨饜厭痣百豁然堅圭奭痔佰明墮塑塗奧盟堊型奎奐冒萌宿勗周墓爾
籲	顧頻顆宇貳迂頒頓頡蘋頤擷癲頌頭澦顯傾頰贛碩噸於頊巔鬚煩瀕頁嶺頷籥頜
濯	櫂瀚羿僇煽擢廖穋塌褶翁翌翠翟習嘐寥膠耀蓊嗡曜繆謬遢翼躍摺翰 榻
所	匠昕析近折沂圻聽斫祈斬斯芹新斧訢掀斤欣斷殷浙淅逝晰乍戶房
完	富院崇棕遠宗仁玩梡莞兀阮沅宸元竺宣三皖淙寇二園
剁	利刺刮制剌劃列刎刖釗刈剩剿刻刷到別判刪刨剎剃削剋則刑剖剜剔剛
罔	惘魍網輞芒荒岡亡皿冊肓胼朕慌蓄杗忘茫忙妄腆膜臃膿
釩	汎帆梵凡鈑鉻鉑銘鋒夕幾鈹銖弘殿釵販銑舛肌汐錘鍾外鎢移梭浚峻唆
瑕	霞王夜珞班蝦玫瑚玖璨假玻遐玨葭豭斑琳煆玷玟候暇
旌	旅於族旎施旋旗旖鏟放方惺猩腥隆醒倣產牲仿淤生笙菸瘀
堪	墟湛垮辰諶農圬琪佞甚儂斟芸勘膿戡濃其坩噥
頹	頑頓頻頤顆煩頃頰頭穎頜頡頫頗碩頊頒頌類願項須顧頂顯
希	佈怖鈽布唏晞烯爻稀席帑餚巾常蒂瘺癘幣滿滯
眉	湄媚楣省冒算篡看苜纂盲眷自目相臬督瞥首洎咱
隸	棣逮噤襟禁示棕宗奈標糉淙捺剽齋禦祭票崇祟
棚	朋硼崩受桐胴愛骨鵬柵相榣舜滑授稱棘亂猾稻噯曖稠棗策
砰	評磊枰抨坪秤研平硬碩碳砠硃砂斫硝碑硎石萍
鷂	鴆鵪鵑鴣鳴鶴鷓鵲鵝鵠鴿鴨鴒鳩鴛鷗鵡鶉鴉鸚鸛鷹鴦鳶
鑪	臚爐瀘驢鱸蘆廬盧膚濾擄墟噓顱慮琥唬瘧虜鑑鎰遽璩錳據噱號虛
蚣	蟲蟲蛻蛇蛉蛤蜿蜻蝶蝠蝸螟蟒蟆螺蟀蟠蚪蚌蚊蚶蛄蛀蛆蚱蚯虻蛟蛙蛭
愾	氣掬氮愉恰璨粥氧氨氤憐燦氟氛氖憔憮汽邱瞇謎米氳氯氬氫氦
擅	擁撻提撲攘抗澶顫嬗氈掠羶撞揚搞掖壇檀撾捍摔撢
酌	酉配酗酊酣酥醣醜酴酩醋酷醮醺酬酪酵酸醇醉醃醒醞醴釀釅
它	尼比佗沱屁庇昆匕叱化仳妣批沘枇陀毗皁紕能蛇跎
幗	摑蟈國惑帖幡巾帳帷帕帆幟幅幀幛幔幌幢帽幃域或
講	遘構溝搆媾購謀諾謨譁譜謊謂誌誡議護謙詳謠謐諦諜諭諳諼誼諒談請
動	劻邊勳重男勒衝勵幼勸助董肋腫叻湩慟劣劫力鍾踵種觔歷懂協脅
佃	俚偎儡個人每偶侮田仲夥伐休仙仕什僕鈿嗇位住伴估伸佔傭作你伯佝
醒	醋腥惺猩酉酷酪酩醮醺醜酣酥酊醇醉醃醞酵酸醴釀釅醣酴酗配酌
懊	澳噢燠襖奧恤筋向煥換渙喚惚恪愧怏怕制必瘓
谷	鎔鉛保熔溶俗鈉釦銓豁欲裕容鈴卻錐峪蓉榕鈐鎗鑰浴
帛	匝幣簾吊幫錦皋皁帕綿帝映的棉白魄帟帥皇巾帑泉布
變	敔敷疾敵跡蠻礫鑾灤數巒譏敬敞鸞斂矣灣緻奕徽給繳攣孿絃敢敝彎亦蜘戀敦弈
忱	沈枕耽怏鴆懵慵怖滯目巾怫懼相帽慣憤惻吊布匝冒苜買
羨	嵌茨崁漱嶔簌闕羔恙美姜澄義羲善羹久對嗽撳柩坎
披	扳陂破板皰彼玻菠疲皮皺跛被詖鈹皴波坡簸格頗 
嗟	磋嵯搓蹉咩差羣詳烊洋佯羋羊庠祥鮮哎徉菁氧羼
鼙	瞽鼕箄痺埤啤裨碑脾婢俾顰鼓睥牌陴卑豉芰彭
腸	楊颺場怛坦冥暢腥湯袒觴殤脆傷揚煬鍚瘍陽暘豕但逐豚
蟈	摑幗蟲螺蛔蟲蜩蛐蛆蚯蛄蚶蟠蚣螻蠅蛾蛻蛹蛙蛭蛞蛀蚵蚱蚊蚪蚜蚌虹
乒	丘乓嶽卸邱兵全餘合仁佰啣蚯少答御氖捨癸原氣氧氦氤塗宿侖氛俞拿
喳	渣桓呆晅垣查桿宣喧楊噪杳稈保噤吋旦喋唔檀糧根杷棠架
褒	衷袞袁堡哀旅迎葆褓遠保卒途躁迤柢仰裹裒襄享昂夜衣遜進起依迄抑
葛	暍竭遏渴揭愒喝褐羯碣曷謁噶意莫慕募幕墓蔓暮摹蕞昔藹
卜	迫文迥亢迷京迂送撲迨迆卞六樸齊主佔補下丹釙鬥僕玄迅迪立退迴亡上
軸	轟軋車軟軒軏軌軻軼較輊軔輔輛輥輻宙輓軾軛輜輯輾輒
杏	和枴楫木口桔橾杳傑吉臺品森林枯枸程李吝吞吾否呆君告尚名哉召問
謙	訏訥諛歉諶謹詢訣許託記詳廉詐嫌誰訃討謊詁計謫詛賺課訊訂訐註訕誚兼詨譜訑
吊	帥布常巾匝簾帛帝帑啻啼帟幣嘯希席央市庸佈帖帕怖唏砸帷鈽嫦滿
古	咕錮牯葫湖居估鈷故姑涸苦枯箇辜個固沽胡舌楛
減	箴後槭喊緘磊洽滅威哈蛤給拾茂鹹恰戌筒洞答
瀟	滿蕭漠湔漢肅灌濛濩滋鏽嘯淵灘簫漕港洪洋懣
勸	歡觀鸛罐觔劻叻脅動劫肋另勵勳勤勛勒勘劾劬助功幼咖伽荔茄男
龔	壟襲聾龍籠龐寵朧攏嚨異矓瓏隴鬨巽烘洪拱哄供
煨	喂偎猥餵畏佞簑衰娉辱聘耨褥燭縲鰓細表長畫
齲	齦齟齣齪齜齷齬齡齒齧此兆雌逃禹疵跳眺桃洮挑姚佻巾兀上窕晁
廠	蔽撇敞敝弊彆撒撤澈矣敵散挨埃唉俟藪霰幣氅瞥屑宵鱉銷徹螳轍梢逍
婚	昏柢胝抵泜低衹砥祗牴紙祇底舐氏詆氐娼湣媳
汪	玨枉旺王匡全狂涯汗汙玥汀湟潤弄皇閏班斑玖河江玟玫洹玷珊珀理瑰
綵	綏綬緩絹縲絲組綱綢網綑糸結絨絃繃繙細納紂紆緲
孓	久了欠坎吹灸炊疚欽闋孑之承閃次亨玖柩癸砍崁畝歌嶔撳
遢	榻塌蹋煽嗡翰翁瀚蓊曜羿翠翟翌習摺褶濯擢櫂躍翼
鳴	鴣鷓鵠鵲鵝島鵑鳩鴒鷺鶴鳶鶉鴉鳥鴦鷂鴨鴆鶯鴿鷗鷹鵪鸛
儲	藷諸佔嘟曙躇者薯褚楮堵渚箸暑煮著奢屠睹都署
寅	演夤宇縯家室定鏨賓士宸穴富宣宗完官宜宙宋安卉寇薴寡斤工十順佇
姥	佬老耄耋妹姑妓丈杖仗姣姨姻妖婢她如奸妁奴婉嫁嬪嬸者女姦宥怒忝
唆	峻浚俊梭竣酸駿痠咯唉咚鈑嘛鉻凌喀吭賂鋒販吸反菱各
聳	攝取聶躡趣傘聘陬聾弭倨餌聯懾椰職爺鑷耳聲洱聞慫恥耿聱囁茸輒
漳	樟獐幛障璋蟑瘴涪章潼泣潭暗億憶噫臆境鏡黯草音
朦	矇脰膜且腆同湔胼肝臟膈岡濛檬膿膳冪塚蒙胴朕菜豚
凹	兕巨已己氾厄妃忌杞拒炬苣鉅凸局尼屆屈卮犯危呃扼改卷範矩
侑	洧餚囿宥脩仇賄鮪佑佈矢有俠鬱崤枚知畋俟伽攸矣疽疾瞥
爍	牀吆後藥似礫煤麼饑譏以窈炫樂機茲鑠玄關奚嘰畜絃綵幻拗黝絲璣姒
筆	聿津笛肇簫律建肄肆爪簍腱毽健鍵麼竹策筍笠笨第笙笮笆笑竽竿篤簣
肋	勇叻助脅筋勵力男另勞幼劫觔湧劬功加肱劻勃胰勒勛勣協勝伽咖迦劣
戒	弁度庶庠席廣拚械廉蔗戈廿渡摭遮鍍牀戎臺卉棄蓆
戈	弁臺戎戒牀勾勺公弘麼伐找太犬戊弋寸夕去鬼
湮	煙曬迺哂酒西涅鋰酉醫涯潼潭浬甄汪溧漂酷潛醋濬沅污醮醺湎湩酣酥
姑	咕妹牯葫古湖居瑚罟估蛄鈷苦骷枯詁妓固糊沽胡做
暱	匿慝若偌惹昭右朕送碾諾摒最展屏君艾樞嶇嫗嘔愜鄭羣祐郡昨知撮暗
搞	犒矯蒿擁稿撲嬌鎬攘抗嵩轎拈掠嚎縞掖僑膏濠篙槁擅驕高婷橋摔停壕
簞	闡憚彈嬋蟬禪單戰襄囊器萼巖毋追囂靈鎚鍔槌儼愕
陛	階偕揩楷諧琵毚陞陸混焜棍錕皆崑陀琨媲鹿罷篦
引	弔弓中弘仲阡沖邢邦那阱祁邱阻耶郎鬱限陌陳鄭鄴川剃蚓弟第
嵐	瘋楓颯諷飄風颱颳颶颺颼咒冗亢肌疫芟凰珮佩幾凱殼殿跺躲峯殷般飢
傻	稷稜陵凌綾菱後鈑鉻俊瀲廈憂傯賂鋒販反偺略皈板返扳處疼各冬
倀	張悵脹帳萇賬長伺漲侵伊偎佞刁倨侷仞偃叼倔僭儂畏
 	撲璞凳橙樸蹬登蹼僕澄
柞	昨炸咋妒作乍戶笮枋砟祚柏材蚱槐搾怎窄肩詐淚捩唳偏遍僱褊邀才篇
戕	狀妝壯將牆莊鏘寐寢蔣強蟲蚣姚寤虻虺蚊蚪蚌蛀蛄蛆蚱蚯蚶蛙蛔蛐蚓
玆	舷玄畜炫弦鉉眩絃虻亡毓蓄杗忘肓育芒忙妄吆樂以幻
卦	掛褂封佳哇娃掛桂畦奎圭赴捱涯崖堯閨垃蛙鞋鮭坑走窪
遴	燐憐璘磷轔鱗麟迷舜粥鄰桀傑籽瞇咪舛粱屎栘謎米糜粟氣
搴	寨塞寒賽騫拱暴異共烘洪哄供巽鬨卉撕港基恭廝溢嘶隘鎰
瀑	濕混澗暴港湯漫潠濮曝鑤涅共渴潤溢汨爆洪湄
碣	謁暍竭羯褐遏渴揭愒葛曷磊藹碟碾磴礁礫歌碓砍石靄
蓀	遜菰孫孤係縣鯀吼孑系孔蘊孩孜茲懸糸潔孺蔬蔭蕩薊苑蘇蘿紫累素茅
得	徐待很徨行徇從徑復徬後德役徙徠徊律徉往徵彼御衍銜
鎗	傖槍滄搶愴嗆瘡蒼艙倉鈐鈴鑰銓谷飧創食鎔餘飾飭伶
訌	訐訏訂証訕訝訢計訃評詛訶誣記討訊託訑訣訥許註詞詁詐訴詳詢詬誚
榻	櫂瀚羿煽擢塌褶翁翌翠翟習蹋蓊嗡遢曜濯翼摺翰
壕	濠蠔壤豪壇鎬槁搞婷停坑壞稿犒瓖篙蒿嵩高亭
霽	雯雨霍霄雪霎霓霑霖震雩霜霞黴雲霤霹霰靄霪霏霆靈零
身	陷鼠與窮倪睨躺裒舂姊射叟舀萸滔躬庾臼霓躲鑿焰腴稻軀樁啗臾舅潟兒
輥	轟軋車軸軟軒軏軌輔輓較輊軻軼軔軾輛輻輯輾軛輒
遠	迎嬉猿吉玩黠袁週結呱桔轅袞元拮逵哀造嘻僖園逞褒稟衷完周檯
撐	擋捎撇膛嫦噹瞠檔償螳襠鏜鐺儻呀讜牙掌棠尚
嬌	奏矯犒蒿祆稿沃鎬添妖嵩轎笑吞舔搞縞僑篙喬槁驕橋 
暝	瞑螟冥暉暖曖明暗暈晾曝皎鵬六晶萌昱冒暘暍腸腥晴肥景勗昌曩
淅	晰浙蜥漸析逝沂薪慚撕嘶斤嶄廝淋新昕近折圻聽芹匠
倆	輛魎兩便佩帷師偶偭佰傭倫偷佈儉雨何伍佺佐價儈仁巾俞盒侖命餘
縷	組統細絀樓履髏綠屢螻絢數簍僂繡糸維摟婁紋緙嘍糾褸鏤縲絆紳緬縯紼絲蔞紲練
燬	毀鍛澱緞搬瘢發廄轂殼殷般段股投聲磬疫芟穀骰殿役罄慇馨
蹋	櫂瀚羿踢僇煽擢塌褶翁翌翠翟習嘐蓊嗡遢曜濯翼躍摺翰榻
訃	註諒謎計訕訪詨謫諄誶讓該諳識譴訂記訐討訌訊託訏訑訥許訢訣詠評
鄱	鄙鄴郢邵瀋嬸翻藩鄭鄘郵郾郭都部郡郊郎鬱郃耶邸邱祁邢邪邦那番
琊	邪呀芽瑯訝蚜穿玨牙班斑邶雅玻鴉琍梆琳娜瑕椰榔琢頊玩珮王
頁	頻穎顆頂貳頃頹頒頓頡順頤頌頭顯傾頰碩噸頊頑頫領預煩須寡頷項頗頜
榆	掄喻檜瘉淪輸蝓癒逾褕諭渝倫瑜槍梅愈偷檢愉栓俞
褐	隄藹曷竭謁歇蠍揭袒噶羯暍惕碣渴錫愒遏葛 喝
太	宏汰肱雄叉閎釵篡戈大疣丸倏夭天兇文尹父犬夕寸尢右史去弋戊丈矢
罈	潭撢譚蕈缸缶覃缽缺罐瞟蟑璋樟漳遙榣搖淘掏啕萄
馱	馭騾驅駁駙媽駝嗎馳騎驗馬罵駟駱駒騵駭馴駛騙駢驕駐驍駿
驚	擎馭騖駁晾警京駕涼馱瑪馮駙媽駝嗎馳掠駑螞罵馬駟駒騫篤騰馴駛駢駐諒檠景闖碼
苣	巨炬拒鉅茸矩荔距萇局凹凸苗芯昔艾渠蔚藍廿侷
土	圭吉志仕吐杜竈肚壬醜王去冉主裡隹地圯圩寺坍坎壞垃坩坦垠埋堆塊
勾	釣慷怡心杓構怯勻愧旬妁忖慵勺戈句甸鈞慘灼憾的昀芍鉤怵均匍忪惦溝
烯	晞唏稀希幕鈽怖佈布駁尖爻崤帑幣淹掩醃俺燎巾餚冪
監	盈盞益盟藍籃姍扁柵忍鹽盂艦嗑皿檻濫盃盛盍襤孟冊尷盔盅鑑溘蓋
鯖	精晴清情倩鯛靖睛猜鯧鰓蜻鮪菁鯨鰭鰾鱗鱖請鱸鯉鮭鱷
愉	掄喻瘉淪輸蝓癒逾褕諭渝倫瑜愾愈偷愎恰悔愴榆俞
冷	冽令零準凍泠齡聆拎蛉羚捻吟玲矜鄰次鈴苓領侈唸憐鈐冶黔昤岑嶺伶冰今多凌
涪	培焙倍陪漳潼泣賠菩競接暗噫拉垃位立笠昱獐幛境僮障樟璋撞憧幢億
崙	倫掄淪綸輪論侖瘉岑癟偷俞癒愉喻渝榆逾褕愈籥瑜屹儒瞼
恍	洸胱晃光幌輝悄兀耀元恆性悵忱掬沅憐丕心嶽完
曄	樺嘩譁華荊曠曝蕨厝橫醋楛卅葬璜磺暗暘躇曦髒妍甘蕈暴廣厲簧開莘
脈	藐淫脾肪旅彤股永脹泳射冗腫邈胝舀滔派胳朋腺彫腴杉肚肌詠狐貌衫沉鵬彩
駁	馱騎馬駝駱馳駟駛駒駐馭駢騁駿騷騵驃騾驕驍驛驗驟驢馴駙
癡	礙擬凝疑疵痛痍疚丸癬疝瘓爹汍癮痢昆庇屁笑疣契奏忝吞旨多名尼它
怯	法去砝恃溘嗑蓋劫悻瞌磕丟玉盍闔豔琺勾勺忸忖惟愧心
喊	箴後吮恫減緘峒磊滅威哈茂銅桐鹹胴戌筒洞答
皰	皮頗炮胞袍泡抱咆鉋砲被波披坡鈹鮑疲苞庖破玻匏跑陂飽菠
迂	芋言訏這宇迺邇竽某逗盂圩汙柴荼逼除五於紆途籲卡餘逐上
妨	坊防舫肪旅枋菸彷漩簇倣房遊鏃訪芳紡方旁嗾淤仿瘀
鵰	雕碉凋
逃	誹眺佻扯跳洮肯潰址桃遺遣窕挑排俳姚北兆覜匱頫步晁啡芷止腓邶正
贖	櫝瀆犢竇讀續牘黷貝贈購賤賊貽則贓贍賻賠賦賜賒賂貯貶賺賄貼敗財
莞	梡院皖薴萱完寇蓿玩崇菅蓉元冠宗淙棕頑沅芸宸糉阮
此	庇雌屁叱枇化比柴妣仳疵北髭紫批能毗齒邶些沘齜上昆
臟	藏臧贓朦膜臣臥宦臨冪腎膿膠腸脆馮卸腳堅茨羿
緒	組諸細絀縮綽署堵楮絢渚睹繡糸維紐紗紋緙者暑賭紀都絞縲絆躇縯煮褚納絲縝紲紱純
嘖	磧漬債積蹟績責損潰遺槓隕匱圓簣嗉賸韻賞員
儻	讜償鐺襠檔噹擋俏黨儅倘當鏜膛瞠嫦趙尚螳撐掌棠堂
昊	旦天癸旱旺是查疸怛坦但袒暖昌晨勗量葵闋嚴曬晅揆暘
烊	祥鮮洋咩佯羋羊庠癬烘徉羣搓嵯嗟差蘚詳磋氧羼
蚪	蟲蚊虻蛀蝌蚌蛄蛟蟲蚶蛆蚱蚯蛙蛔蛛蛐蛞蟑蟀蠔
淬	悴碎粹萃瘁誶醉翠液卒傘濠涼淳漓沆澶漣淘漳摔
曼	鏝饅鉀呷柙狎甲慢澤曙胛薯縵漫押閘濁幔匣鰻賣蔓
銼	挫雁座坐錐鈉難鐫隹仕銓灘攤谷癱雉進椎淮推惟堆唯催鈐集焦崔售
忠	患中袍心芯思志燕乖乘川忝忍急怎忘忌盅恙恕恭恩息悶惠感罹沁陶兒
粥	氣籽憐燐遴弼迷咪璘磷鱗米屎愾轔粱粟糜粗粕粒料敉掬妳燦麟
泓	汐弘漲湧瀰汛汍汎沒夕淺洌溺澦舛涵外泠渙殘漁歹凡丸名
舂	樁秦奏舀泰春奉臼湊揍榛裒潟瘦臻輳竄捧啗焰棒俸滔艘
覲	蜆硯規現峴莧覬覦靦鄞覜勤視筧覓觀覺見僅瑾窺
繡	組約細絀繩誘絢秀紅糸維紐透紗紋縷緙糾紀縲紆絆紳紂紼縑納絲鏽紲純
到	刊釗室刈致屋列窒臻倒侄握副喔刖渥劃姪至刑
竅	檄激繳邀倣族放窄窮竊遨敷窿窗竄窖搾嗷搾傲
贓	藏臧賤賊貽賻贖贈賠賦賒貯貶則貝臣贍臟購賜賂賺賬賭賑賄貼販敗財
壑	鎔夜堅熔溶俗豁欲谷裕痣容卻怪峪壓塾蓉榕堡慾浴
縛	博紜繙纏緘絹糸傅搏絨縉薄縲賻縿絃繃溥綵綬織緝紂膊綏絲礴紱
堝	媧渦過鍋禍蝸萵窩滑猾培亂撾骨骼朋坍炯迥冉
蕾	擂鐳雷電濡懦嚅燸儒蕃菁黃孺蠕糯灞薑蕈葬芸需芣芋甘優擾壩
亨	烹享哼京亭亮高豪了亳毫膏吼惇淳逞襄佔郭哀廓圖孑孓吹孰敦遐槨
俎	齟咀姐沮狙砠祖租阻粗且宜疽組蛆詛俱鋤勗助內卒
憩	舔想舐咱息自舌恬臬省眉忌算克噢括活洎盹態宮怨篡首鎳楣媚湄聒甜
嘯	鏽肅蕭簫繡吊呻瀟嘍淵呷姊吐叩叫口品亮嘆啞唯哨哩哽哇咽咪哄咩咦
劈	襞貂僻韶癖蘗檗霹券譬辜避迢叨壁闢璧臂分初薜擘
尖	火烯炎爻大艾少祐馱駁燎灰契奐疢美奧痰因竈恢煥燃燠
謁	碣喝遏暍褐竭渴揭愒藹諳羯誌詣譜識謀諜諾謂諭誼諒談請諉諂論諍誶
袱	伏褓偽犬倏獄畎吠伐淚溴捩唳嗅複附攸爪跋狀獻褕筏莽臭哭突戾
霄	雨霍雯雪霽霖霜震霓雩霑霪霰霎雲霤霆霏霞霹霾黴零靈
飧	餐餮食癢饗多饕良養侈浪娘傖栘琅狼夕移滄搶愴嗆槍夥殤艙鎗舛外爹
殯	檳臏濱嬪儐繽鬢殖歹殮殤殘殆死殲殊殉列殃歿
滌	篠條濮附攸褓脩咻滄渝淪海洽泠汽袱倏咐灘漢淮休仲除悠茶
駢	馬駐駟駛駒馳馱馭騙駁駭駝駙馴駱駿騁騎騷騵驃騾驕驍驛驗驟驢驥驅
扔	奶仍秀乃氖揉孕透莠扭乍戶挽捩搾誘抒妒作咋昨柞炸拯換挺肩怎柔笮
既	唧節畏概慨褥即曠僭佞猥潛蠶煨溉偎卿喂餵蚜廄昀鯽暨表餒冰長飩簪
絡	洛終烙路咯珞各骼絳綾紹恪詻結賂胳駱酪鉻貉客格略
湟	惶煌遑徨隍蝗韹篁凰皇泊潤珀旺箔腺汪斑班棉嗥栓銓拴線佺錦鉑柏迫
狎	獨狸猓猥押呷狄柙胛鉀玀狗狙狂狠犯猶甲匣狐狡狼狹狽狷猖曼閘賣
家	稼富室厄宇十宋宗卉呎士嫁傢軛宸薴穴咫定宣尺寇安豕賓寡佇寅宜完
署	諸堵屠楮曙渚薯睹箸嘟豬者暑賭緒都躇赭煮褚奢著
臢	鑽瓚讚贊賸損積遺潰漬慣嘖隕債寶簣賞圓賁貧
壙	擴曠獷礦廣域埃墟坩械拚蚶鍍遮摭渡填堪甘戒弁
卓	瘴蟑覃撢綽獐暹漳蕈褪罩腿鬥草昧幛璋暑悼掉樟章障退早潭棹桌晏
唯	碓雊雕堆惟推淮椎進雒誰錐礁隹崔帷準雄睢稚雉離雜譙售
穋	膠嘐僇繆謬廖寥櫂濯擢曜褶摺耀躍翟煽榻遢塌習翌翁羿
哽	硬埂便梗粳更甦鞭啞咽哂啄呻聽嘍籲叮嗯師呵呸呀嗤唔喱由
匪	誹菲徘罪悲非排靡俳輩斐徊屝匱痱啡靠霏裴腓扉
移	橘夢利夠令稔禾舞秀外麥宛哆舛矽酩季茗夥穗栘夕杼侈爹苑汐多私銘秒
晃	胱恍洸幌光輝兀耀顯昌旦元晁星是冒昊杲嶽旱晶完丕日曰沅暸願
勘	荔劻劾勳脅湛勤勒動諶茄勵幼堪助劬甚斟肋勁叻勦功劫戡勛觔勉勃勣
呵	坷河何柯阿訶奇苛蚵軻叮啊可倚崎椅畸錡寄荷
遞	遑遁遍迫密邊虎褫唬彤追遽逅迆裒返號逶逸必透彪彥遛迭造逢琥祕近
睞	萊徠來睫睢目睹睥眼眠盼眇盹盯睬睜瞧瞼瞇睏瞿
函	涵乙乞疙迄吃屹挖水山弓紇訖門夷色鬥出永目兇醜屯巴弔支兀久夕子
稽	嵇嚐疣魷就私嘗穆尤稻稔穗穢稈程稀移秒秈禾香
銅	言金鏈碉恫針喊脰峒錢洞同洽鋼鍰壹哈拾鋤硼桐恰胴筒詹磊鍵答石
烈	陷冽例魚咧荊阪邸郃洌邢氟列隙汀弔打鬥鄞裂邱阿丁灸煎阬氮炎釘妳郵
尬	疥芥界尢介佛尷拋串仲劂尤疝患伸袖圳川釧弗疣耑崔
幻	幼以樂吆玄幾弦炫鉉爍鑠似拗姒糸奚畜茲藥始眩絃嘰機礫黝窈關
塔	儉荷褡郃堪搭洽拿撿閤荼搽荃哈蛤給拾臉瘩鴿檢合恰璜坩鑰磺答 頜磁
棄	遮戒弁充迨卞率述庠茉苯育玄庶度母卜械拚鄴
闌	蘭攔閒鍊諫欄爛嫻煉柬門閃閘揀間閂閑闈籣問斕悶瀾楝閉練
享	亨烹遊惇淳京亭亮厚高豪子郭敦亳毫荸孳膏孽俘哼浮游諄醇
蚤	蟲蝨搔蠡閩蝕騷蛋虺強蜇蜃蟲螫蟹融樑蠻蚌蚣蚓蚊蚪蛀蚶蛄蛆蚱蚯虻
痳	森林淋霖琳棟彬村材孱梱焚婪檠楝橾癩槃疲杲採牀宋呆爻桑木大沐困
梟	鳥島裊白皎鳴鴃柏泉迫鉑鳩泊拍怕鳶伯嬝鴣鴨鵑鵲鵬
電	雷蕾擂鐳需霸憂儒濡懦嚅燸彙頁亙孺蠕糯灞青奄而頓頊頌腮煩醃碩頡
鱟	學黌覺鱉鯊漁魚魯攪櫓嚕餚鰍鮪淆崤鬱痰鰓鯧鯈鯉鮭
悽	淒棲萋妻慎懷慚悻悵悼悚恬恨怏怵慷慵怫忱數忙惋悖憤吏心宙
掌	棠當常黨尚嘗裳賞堂肖擋噹韋炯膛檔襠鏜鐺敞敝淌捎嫦哨倘削瞠儻
楞	愣榜遝澴還枋滂徬膀傍磅螃環鎊鰥防蔑寰篾謗儸玀囉邏鑼彷方罩夢甍
釵	叉鍵閎鈕鈑欽太又鈹銘釩肱銻汰奴鉻鋒宏釦釣鈞釘針釙雄鈸鈿建鉸鋪
頡	碩頜擷頻頭頤頷頊頌頓顆煩額頂頃顯頰頒頑項須顥顧囂
躁	踩噪跎跦燥踟踐蹈跼譟跆跑澡蹂操蹲蹬跺踞跚藻踏蹦踱蹉蹣距趺踝足跟躋
瞄	矇貓眨睽瞑苗瞠目睜睢瞧瞎瞼眼睬睏睛描眩瞞眸眇瞳瞌矚瞪算睡睦錨瞟
鐘	潼撞憧僮瞳幢童鏡賠鋰鋅黯臆憶噫樟億漳暗焙喱陪涪接培倍泣拉垃位
機	嘰璣譏饑幾爍礫鑠槐後磯魂吆戍藥巍茲玄餽魏拗姒似鬼樂關畜奚
翅	瀚羿翻翔翩扇翎塌翹翱翁翌翳翟習翮遢栩濯羽翡翰榻
顱	頭顯顫顆頻頤頡碩頌頓頊煩頂頃顥顧願顛類顓顏題頰頷頹穎頫頜頗領
埋	裏黑墨貍鯉理浬圭嘿壎狸童暑黛俚量娌鋰喱裡哩著
緙	絲縑繡紲細糾縲糸綽維緒絢絆紼紳組絀紋純紐納紗紀約紆紂紅縊繕絨
羅	囉眾累罹罟玀紮維羈罪罰濰罵縲絮置蘊緊蘿籮索鑼紫紊絲買儸邏系
鹼	殮儉臉檢撿瞼險鹵驗簽鹹滷蛤給洽拾恰哈答鑰諭餘論蝓誨詮診訖佺斂
掀	折欣撳昕析近沂圻聽芹匠逝浙撕斬斯斫祈所斧
耒	耕耙耘耗耜抉抹耦耨藉籍木手桀揀藕披捆採傑
胡	咕娟錮鴣牯捐舌葫古湖涓居瑚估鈷故姑涸苦鬍枯箇辜個固糊沽蝴硼楛
丕	呸胚不示否壞杯芣歪平光炭奈宗甭盃痞蒜爾二坪抨恍枰洸炳晃祟胱票
妾	立音接章童昱笠竟意霎垃拉泣位站茹靖竭菩辛倍培啦涪粒焙竣暗煜端
酒	醮酥醞酊酵醒醉醺醇配醬酴醣湮酩酗醫酉醋酪釀酷醃醜酣酬酌
烙	咯格胳洛略恪絡鉻駱珞烽賂路骼客詻貉酪閣終絳咚各
序	抒妤杼野予舒澦預豫多令墅侈栘爹矛歿移夥茅廊苓夕了伶拎泠弘昤矜
巡	邋淄錙惱腦緇輜臘災瑙繅獵巢逕蠟邕鬣妄姦涇亡玄莖痙
兕	凹禿亮巨已己屈忌苣厄允拒杞炬妃氾鉅兒卷危充卮尼屁範苑圈窟屆羌
孳	慈荸茲滋磁藥孽厚享遊浮俘幽子游悸脖悖郎好
濰	羅維絲累系喲漯絮紮索素紊辮灘納縲給紇糸蘊紫
磨	痲麻糜魔麼拓蘑磐巖嘛述靡麾摩碧朮銅嬤怵硿磊磬司石
臼	舀身臾舂啗焰舅裒滔鼠潟兒叟與躬陷庾腴萸稻樁寫閻舊
瑩	玥撈球班勞榮熒螢玉營嘮鶯煖縈瑭癆璧祖蒙胴璽塋犖琅嶸
雛	鄒皺睢崔瞿芻雊惟瞧離雜錐雉稚碓雄進椎淮推帷堆唯準懼憔摧催
峭	捎哨膛趙俏擋檔銷屑蔽瞠撇鞘悄稍鐺廠硝睄鏜襠梢肖尚宵逍消誚噹帩
湊	奏春俸輳矯秦沃泰舂添妖捧笑臻漪榛樁奉忝夭棒吞揍
叭	扒趴吒咋佾八咳呈聽呼呱咱哦啤喙唾嗚鳴咯噱噬噢啾兄呂兮筏
緬	組靦細麵綠綽縹紜面絢緘紅繡糸維靨紋縷緙糾絞縲紆紳縯絰綞絲偭湎縝練
蹦	踹踩足蹣蹈繃蹄踏踐跎跆跚蹟蹉蹊蹶蹺踱踴蹂躁踡跪跺踝躋跟距跑趺
瀾	蘭攔澗鍊們櫚欄爛嫻煉柬簡漁揀燜閑籣憫僩捫斕潤楝閉闌練
椅	坷寄荷琦苛犄錡騎婀河呵啊柯奇可倚崎畸綺何
噹	擋檔襠鐺哨儻讜當黨膛鏜硝尚瞠嚐嫦儅掌棠償螳福幅誚堂常
陘	勁頸陌阿徑阮限阻涇陋逕莖痙陣陡陝陳陴隊陲防阱阪阡院隔經輕弔氫
浴	鎔汾谿鉛熔溶俗鈉洽豁沿欲谷濮裕腳容卻錐峪蓉榕壑淦慾
佯	咩洋烊蹉羋羊庠祥鮮併供徉羣嗟嵯搓差氧詳借磋羼
矯	短奏犒蒿稿沃嬌鎬矢添妖嵩轎笑矮吞搞縞僑篙喬槁驕橋知 
甲	匣押呷柙胛鉀申狎曼睪署蜀閘賣鴨禺伸坤呻萬罷
荷	倚何苛寄崎椅畸錡可婀啊琦犄奇荼荃柯綺河坷呵
尉	蔚紂慰熨村肘吋忖付射封對寸寺守討耐專尊辱屎褽
泰	春奉秦奏舂俸捧湊棒蠢揍榛樁尿臻輳泉泵爰水挾湲援
列	冽刊例釗咧殆刈歿洌殃到殘裂殤夙殲殯歹副烈殮殊殖剜刖劃死殉剁刑
釦	鉛沿鋁金鈷鉤銳口谷針釙鈿扣如兌袞巷品釣鈔鈕鈉鈍鈇釘欽鉗鈾鉋鉀
門	澗閔閒們闊闆嫻閨閏閻閤簡閩閘間燜關開閂閑閎問僩閭捫悶閥聞闖閉闌閃
閩	蟲蝨蛋蚤蠡虺蜇蜃螫蟹蟲蝕閂融強閘閏開閑間閒閎悶問閃蠻門蛙蛔蛐
茗	銘苑苔名爹多舞酩栘移侈夥夢茅夕汐麥宛矽苓笞菩萵臺舛外
髑	鐲觸燭獨濁躅蜀髁髏體髒骼骯骰髖骸骷胛髓歜
朋	胖肥滑育玥月脊胛肺骨曖背亂肓棚舜肱肝肢受覓膊脯肚崩胡胴肘噯肫鵬明授硼朔愛
抖	科斡扯擠抆撲拄斟抗魁鬥拈掠接掉拉摘蚪料斜摔斛枓
蕪	撫憮嫵無蕉庶燕蔗蒸薰茶煎荼荃蘸蒼舊莽莓苓芥蓓舞葆荻荏花借
鮑	炮鉋袍胞泡抱咆魷鮪鮭鯉砲鱷鰓苞庖鮫跑皰鯨鯧鯛鰭
啗	焰陷諂餡閻滔蹈臼樁稻韜吸燄舀舊喚潟躬吹舂裒
堡	褒葆保褓杜塗呆桔壑圭藻容谷裕峪桂浴俗噪橈澡燥吐吋檮檯仕櫝躁
掬	愾憐米掏燦菊璨迷咪瞇屎粒粗粕敉料籽拘鞠粥謎悉粱
躋	踩跡儕跦擠跤踐蹈跼趴齊跑跆跋劑蹕趾踫跚踞濟踏跌躂蹄距趺踝足跟蹼
案	安晏按銨寨杗宋宴氨寰姦森寐十鞍茶菜審藥辱妻妥宇守字穴卉痳寢寤
揍	奏春俸輳矯秦沃泰舂妖捧笑臻榛樁湊忝夭棒吞奉
郎	榔廊瑯螂祁朗鬱耶邱邦那邢鄘鄭鄴弔郊郃郡郝郢邵邸部郭都邪郵郾鄒
瘋	凰芟颺殺楓亢飈颱颯颶殿殼飄凱殷冗佩躲颼跺處颳珮諷幾肌咒嵐疼風疫
垢	逅詬後坼圻塊減喊石鹹箴埤塢埠坷拓緘壎塔墦泵巖壹筒答司碧磊
漾	樣泳永儀糕膳蟻曦繕議犧鱔對詠窯羨漠滿漕溝溘港湔滋濩涔瀟泛泠灌
觴	楊觼颺場暢觸複嘴殤瑜傷揚腹煬腸解鍚愎瘍陽觔暘但珍角斛
齪	齦齟齣齲齜齬齡齷促捉蹙齒足齧踟跳躋蹼蹕踵踫踝踞跼跡跟跤跦距跋
蚌	蟲蚪蛄蜂蟲蚊蛀蚶蛆蚱蚯虻蛙蛔蛛蛐蛞蛾蜻蚵虹蛟蛭蛹螞蠅蚣蛇蚓蝴
來	萊睞徠坐夾巫杵枚椎卒俎佺俠峽座挾挫敉栓浹莢傘雁黍稚筮榷榫漆膝
收	敕枚畋數攸嫩攻改牧玫故政敉敝敖啟赦敞敢散敬敵矢矣疾
藪	擻數蔽廠撒嫩嫉攸霰矢邀橄遨撇嗷傲做挨埃唉俟
委	科魏黍利香秋秈禾諉秀逶禿番婪矮萎稍稚稞季痿租倭祕和私秣秒
柿	匝吊枋櫬市樸梳椒梓林帝棉榜柱楨杭槁核校枕鬧巾棹布枓
檄	激繳竅邀倣放族橄遨嗷傲敷澈撤徹嫩微傚攸柏枋枚簇
龜	乙澠弓山齊肅鬥門函色臼夷目出弔巴屯兇醜己已巳尢小子夕兀久又匕
氫	莖痙逕涇徑經輕氨氬氮氛氯氣氧氦氤氟氳氖陘勁
崢	睜掙淨錚猙靜箏諍爭崩睬峒崗朔瞑崛崤採探深浮峙俘輝嶸瞬峴脹朋溯
恙	羔姜美志義羲善對羨羹芯應痣苒窯地糕膳恭思忠羌漾樣儀鎂繕曦犧鱔
錨	錯描瞄苗貓鉼鉗曲錙鐘鐳鈿茵茴鎰鎂菌曹邁鏍懵鉛襪金厲萬弈
峰	蜂鋒
喘	湍喻碳而啼需瑞耑揣燸啃儒耍耐噸嚅顓端懦踹啞濡惴嗤
蔭	陰薩邢癮芸鄧窿藝鄭鄞鄴橢郵部婀啊耶鬱郎邱祁那邦
掃	掄靈而啼彗掘刁浸擂揣帚伺叼摒歸虐帝握婦啻尋雪慧侵蒂帶招
賠	倍貼貝賄陪賅購焙賊敗則財賂菩培賦貯賺賤貽涪贈贍
洩	拽油曳沖津由沸泱沈淵濾思柚迪抽岫妯沁袖鈾淹溧胄冑宙笛
焦	隹集售蕉憔樵瞧礁隻雙黑崔雋羔椎進淮推惟堆唯錐譙醮
深	探琛淨浮淫滔沉渾湲溪滑洞渦沮清渭涓潸測濺
持	待寸詩博狩恃寺褥痔撙撓奪將傅搏耨峙傳等特拮樽溥遵對膊侍時磚封 
滓	辨辦辮宰瓣辯僻避辛薜薛癖梓鋅辜莘闢闢辣辭霹
剿	勦利巢剁釗剌刺刖劃刈繅剽剩劃副劊劑剝剖剛剎削則刻刷刮制到判刪
簇	鏃嗾族倣瘀菸房淤芳肪枋放妨坊仿旁漩舫於防彷
弔	引阡阱阻限陌陳邢邦那防阮阪阬祁邱陀阿附耶郎鬱陣陡陝除陞陪陸陴
癮	急蔭郎際薩鬱邢邦耶穩鄴祁婀郊邱啊隱那都窿郡橢阻鄭
丹	坍彤臍舟雨月卜帖肪腿舢旁泊船雪腋雯漏幟霄瘺霖霍龍臆臃壟辭霽
慵	傭庸慷鄘勾勺怏忱怖巾怵憾怡匍勻殃惦席吊布匝
觀	莧靦勸硯覲覺蜆覬筧見罐規覜覓鸛現峴覦歡視
涇	淄涯巡潛經勁痙頸沅輕莖沍姦災氫溼徑污陘逕
棣	逮柚隸束枕康速悚樓林秉慷柙枝杜糠樸札桃叟木森
穴	鎔痲金麻簾窮窄窘十宋空崆卉窈窕述潸究倥穹朮容腔突窠怵安控
臉	儉膾僉險洽籤撿閤瞼驗哈簽拾給蛤鹼檢殮合恰鑰答
鉤	苟抱釣拘齣金夠鉛構針泡炮釦胞鈷釙枸句鈞佝咆鉋包狗鈿鉍駒袍鈍勾雊恭溝
祚	炸祆祈祇編祕柞昨社咋妒作祗祐祠祖祝砟祥蚱祁祀視乍戶笮
袖	軸笛岫胄慄要冑川婁迪鈾妯柚褸油由鼬裸廟抽釉裡郵串宙
蛻	脫銳悅蟲稅說閱蚣蛔蛄蚱蠅蟲蛾蜆蛟蛙蛛蛐蛞蛀蚶蚵蛆蚯蚊蚪蚌蚜虻
付	寸守寺專腐尉駙符射忖俯辱咐傳吋附對紂侍府村肘休尊封
裡	鋰浬娌埋哩俚裡理狸裸袖鯉嘿童黑貍由喱量墨黛
境	瘴倍蟑競獐意焙漳垃憶噫諳幛億接鏡璋暗培樟章障竟臆音涪黯
媲	篦棍焜琨混錕餛崑罷鹿妣楷揩偕陛皆腦惱階比毗琵
嗽	漱簌喇掀嫩吹撳速悚欣柩懶瀨獺蠍辣束久嶔羨嵌崁茨
患	拂芥忠思德而芯聽罹亞惡釧疥事川沸訓圳姬廳界馴竄袖介憲怫弗片志串
咼	媧禍剮鍋渦
瓚	臢鑽讚贊寶磧積遺潰漬槓嘖損債琥瓔韻蹟績賸價慣隕瑣頊簣匱圓賁貧
楚	夢噤橡痳婿李棟森焚蛋淋爨胥漩陡婪旋林材禁嚏襟礎麓村礬梵走足疋進
年	伕手人俸倩件伴傭佯趺羊耒聿半用丘矢尺夫午內牛豐羋隹久入囚扣伐
哈	喻儉喊石險搭籥磴洽吟撿閤瞼嗆吃蛤給拾簽臉檢合塔恰鑰磊答 
開	闋闐閔閒刑型閱闆閨門閏閤閩閘閡間閂閑闕闈閎問閭悶潤閥聞妍闖閉闌形閃
奠	酋猷猶醃酉共酗酒曾基異恭美艾醫爻天斯酣酥鈿烘配酌哄拱洪醋酊供
設	訴殺穀訢誘骰殿殼沒詼託股諉殷誤話誥詻役詐投詖毀誕般護殳毆諷段詆毅
陵	凌稜綾菱陸降阪隆傻稷後鉻鈑陂阬鋒販瀲反廈憂
屍	斃死屁庇夙昆歹咧洌例毗妮呢怩枇紕能妣批沘仳
煩	頻顆頂願頃頒頓頡順頤頌頭顯頰顥碩頊頑領須頁項類頜
愁	傑鰍香悉秋願揪秈禾懸鞦愀您慼番啾稍鍬懋委穗憑祕和私秒
泊	遑迫鉑湟沃錦箔線怕篁帕陌腺棉白柏煌粕葩嗥拍泉伯源惶舶 珀
萃	卒芒粹蒿薺蓬醉傘碎萄瘁翠菩蓮莢萊莘淬荒悴蒂午蓄誶摔蓑
娓	尾毛妮毯撬橇耗毬耄屘牝氈毽髦麾氅妃嫗挈解娥姓媽娜牛毫
稟	迴懍凜啾茴菌逶嗇蘇禾蛔榛諉透徊穡裹番香委誘臻秈和私
朔	玥朗月剛瞑峒瞬輝漓茁棚睜朝厥鋼睬岡塑朋逆闕胃溯崩綱期崗胡崢明
